//MAP CONVERTED BY dmm2tgm.py THIS HEADER COMMENT PREVENTS RECONVERSION, DO NOT REMOVE
"a" = (
/turf/unsimulated/wall/grey_planet,
/area/awaymission/deep_caves)
"g" = (
/turf/unsimulated/floor/acid_lake{
	icon_state = "acid_tile_9"
	},
/area/awaymission/deep_caves)
"j" = (
/turf/unsimulated/floor/acid_lake{
	icon_state = "acid_tile_15"
	},
/area/awaymission/deep_caves)
"l" = (
/turf/unsimulated/floor/acid_lake{
	icon_state = "acid_tile_7"
	},
/area/awaymission/deep_caves)
"q" = (
/turf/unsimulated/floor/acid_lake{
	icon_state = "acid_tile_37"
	},
/area/awaymission/deep_caves)
"B" = (
/turf/unsimulated/floor/acid_lake{
	icon_state = "acid_tile_27"
	},
/area/awaymission/deep_caves)
"D" = (
/turf/unsimulated/floor/acid_lake{
	icon_state = "acid_tile_5"
	},
/area/awaymission/deep_caves)
"E" = (
/turf/unsimulated/floor/acid_lake,
/area/awaymission/deep_caves)
"H" = (
/turf/unsimulated/floor/acid_lake{
	icon_state = "acid_tile_2"
	},
/area/awaymission/deep_caves)
"R" = (
/turf/unsimulated/floor/acid_lake{
	icon_state = "acid_tile_4"
	},
/area/awaymission/deep_caves)
"T" = (
/turf/unsimulated/floor/acid_lake{
	icon_state = "acid_tile_3"
	},
/area/awaymission/deep_caves)
"U" = (
/turf/unsimulated/floor/acid_lake{
	icon_state = "acid_tile_31"
	},
/area/awaymission/deep_caves)
"V" = (
/turf/unsimulated/floor/grey_cave_deep,
/area/awaymission/deep_caves)
"X" = (
/turf/unsimulated/floor/acid_lake{
	icon_state = "acid_tile_11"
	},
/area/awaymission/deep_caves)
"Y" = (
/turf/unsimulated/floor/acid_lake{
	icon_state = "acid_tile_6"
	},
/area/awaymission/deep_caves)
"Z" = (
/turf/unsimulated/floor/acid_lake{
	icon_state = "acid_tile_23"
	},
/area/awaymission/deep_caves)

(1,1,1) = {"
a
a
a
a
a
a
a
a
a
a
a
a
a
a
a
a
a
a
a
a
a
a
a
a
a
a
a
a
a
a
a
a
a
a
a
a
a
a
a
a
a
a
a
a
a
a
a
a
a
a
a
a
a
a
a
a
a
a
a
a
a
a
a
a
a
a
a
a
a
a
a
a
a
a
a
a
a
a
a
a
"}
(2,1,1) = {"
a
a
a
a
a
a
a
a
a
a
a
a
a
a
a
a
a
a
a
a
a
a
a
a
a
a
a
a
a
a
a
a
a
a
a
a
a
a
a
a
a
a
a
a
a
a
a
a
a
a
a
a
a
a
a
a
a
a
a
a
a
a
a
a
a
a
a
a
a
a
a
a
a
a
a
a
a
a
a
a
"}
(3,1,1) = {"
a
a
a
a
a
a
a
a
a
a
a
a
a
a
a
a
a
a
a
a
a
a
a
a
a
a
a
a
a
a
a
a
a
a
a
a
a
a
a
a
a
a
a
a
a
a
a
a
a
a
a
a
a
a
a
a
a
a
a
a
a
a
a
a
a
a
a
a
a
a
a
a
a
a
a
a
a
a
a
a
"}
(4,1,1) = {"
a
a
a
a
a
a
a
a
a
a
a
a
a
a
a
a
a
a
a
a
a
a
a
a
a
a
a
a
a
a
a
a
a
a
a
a
a
a
a
a
a
a
a
a
a
a
a
a
a
a
a
a
a
a
a
a
a
a
a
a
a
a
a
a
a
a
a
a
a
a
a
a
a
a
a
a
a
a
a
a
"}
(5,1,1) = {"
a
a
a
a
a
a
a
a
a
a
a
a
a
a
a
a
a
a
a
a
a
a
a
a
a
a
a
a
a
a
a
a
a
a
a
a
a
a
a
a
a
a
a
a
a
a
a
a
a
a
a
a
a
a
a
a
a
a
a
a
a
a
a
a
a
a
a
a
a
a
a
a
a
a
a
a
a
a
a
a
"}
(6,1,1) = {"
a
a
a
a
a
a
a
a
a
a
a
a
a
a
a
a
a
a
a
a
a
a
a
a
a
a
a
a
a
a
a
a
a
a
a
a
a
a
a
a
a
a
a
a
a
a
a
a
a
a
a
a
a
a
a
a
a
a
a
a
a
a
a
a
a
a
a
a
a
a
a
a
a
a
a
a
a
a
a
a
"}
(7,1,1) = {"
a
a
a
a
a
a
a
a
a
a
a
a
V
V
V
V
a
a
a
a
a
a
a
a
a
a
a
a
a
a
a
a
a
V
V
V
V
V
V
a
a
a
a
a
a
a
a
a
V
a
V
V
V
a
a
a
a
a
a
a
a
a
a
a
V
V
V
V
a
a
a
a
a
a
a
a
a
a
a
a
"}
(8,1,1) = {"
a
a
a
a
a
a
a
a
a
a
V
V
V
V
V
V
V
V
V
a
a
a
a
a
a
a
a
a
a
a
a
a
V
V
V
V
V
V
V
V
a
a
a
a
a
a
V
V
V
V
V
V
V
V
a
a
a
a
a
a
a
a
a
V
V
V
V
V
V
a
a
a
a
a
a
a
a
a
a
a
"}
(9,1,1) = {"
a
a
a
a
a
a
a
a
a
V
V
V
V
V
V
V
V
V
V
V
a
a
a
V
V
V
a
V
a
a
a
a
V
V
V
V
V
V
V
V
V
a
a
a
a
V
V
V
V
V
V
V
V
V
V
V
a
a
a
a
a
a
V
V
V
V
V
V
V
V
a
a
a
a
a
a
a
a
a
a
"}
(10,1,1) = {"
a
a
a
a
a
a
a
V
V
V
V
V
V
V
V
V
V
V
V
V
V
V
V
V
V
V
V
V
a
a
a
V
V
V
V
V
V
V
V
V
V
a
a
V
V
V
V
V
V
V
V
V
V
V
V
V
a
a
a
a
a
V
V
V
V
V
V
V
V
V
V
a
a
a
a
a
a
a
a
a
"}
(11,1,1) = {"
a
a
a
a
a
a
V
V
V
V
V
V
V
V
V
V
V
V
V
V
V
V
V
V
V
V
V
V
V
a
a
V
V
V
V
V
V
V
V
V
V
a
V
V
V
V
V
V
V
V
V
V
V
V
V
V
V
a
a
a
a
V
V
V
V
V
V
V
V
V
V
V
a
a
a
a
a
a
a
a
"}
(12,1,1) = {"
a
a
a
a
a
a
V
V
V
V
V
V
V
V
V
V
V
V
V
V
V
V
V
V
V
V
V
V
V
V
a
V
V
V
V
V
V
V
V
V
V
V
V
V
V
V
V
V
V
V
V
V
V
V
V
V
V
a
a
a
V
V
V
V
V
V
V
V
V
V
V
V
a
a
a
a
a
a
a
a
"}
(13,1,1) = {"
a
a
a
a
a
a
V
V
V
V
V
V
V
V
V
V
V
V
V
V
V
V
V
V
V
V
V
V
V
V
V
V
V
V
V
V
V
V
V
V
V
V
V
V
V
V
V
V
V
V
V
V
V
V
V
V
V
V
a
a
V
V
V
V
V
V
V
V
V
V
V
V
V
a
a
a
a
a
a
a
"}
(14,1,1) = {"
a
a
a
a
a
a
V
V
V
V
V
V
V
V
V
V
V
V
V
V
V
V
V
V
V
V
V
V
V
V
V
V
V
V
V
V
V
V
V
V
V
V
V
V
V
V
V
V
V
V
V
V
V
V
V
V
V
V
a
a
V
V
V
V
V
V
V
V
V
V
V
V
V
a
a
a
a
a
a
a
"}
(15,1,1) = {"
a
a
a
a
a
a
V
V
V
V
V
V
V
V
V
V
V
V
V
V
V
V
V
V
V
V
V
V
V
V
V
V
V
V
V
V
V
V
V
V
V
V
V
V
V
V
V
V
V
V
V
V
V
V
V
V
V
V
V
a
a
V
V
V
V
V
V
V
V
V
V
V
V
a
a
a
a
a
a
a
"}
(16,1,1) = {"
a
a
a
a
a
a
V
V
V
V
V
V
V
V
V
V
V
V
V
V
V
V
V
V
V
V
V
V
V
V
a
V
V
V
V
V
V
V
V
V
V
V
a
V
V
V
V
V
V
V
V
V
V
V
V
V
V
V
V
V
a
V
V
V
V
V
V
V
V
V
V
V
a
a
a
a
a
a
a
a
"}
(17,1,1) = {"
a
a
a
a
a
a
V
V
V
V
V
V
V
V
V
V
V
V
V
V
V
V
V
V
V
V
V
V
V
V
a
V
V
V
V
V
V
V
V
V
V
V
a
a
V
V
V
V
V
V
V
V
V
V
V
V
V
V
V
V
V
V
V
V
V
V
V
V
V
V
V
a
a
V
a
a
a
a
a
a
"}
(18,1,1) = {"
a
a
a
a
a
a
V
V
V
V
V
V
V
V
V
V
V
V
V
V
V
V
V
V
V
V
V
V
V
V
a
a
V
V
V
V
V
V
V
V
V
V
V
a
V
V
V
V
V
V
V
V
V
V
V
V
V
V
V
V
V
V
V
V
V
V
V
V
V
V
a
a
V
V
a
a
a
a
a
a
"}
(19,1,1) = {"
a
a
a
a
a
a
V
V
V
V
V
V
V
V
V
V
V
V
V
V
V
a
a
V
V
V
V
V
V
V
V
a
V
V
V
V
V
V
V
V
V
V
V
a
V
V
V
V
V
V
V
V
V
V
V
V
V
V
V
V
V
V
V
V
V
V
V
V
V
V
a
V
V
V
a
a
a
a
a
a
"}
(20,1,1) = {"
a
a
a
a
a
a
a
V
V
V
V
V
V
V
V
V
V
V
V
a
a
V
V
V
V
V
V
V
V
V
V
a
a
V
V
V
V
V
V
V
V
V
V
a
a
V
V
V
V
V
V
V
V
V
V
V
V
V
V
V
V
V
V
V
V
V
V
V
V
V
a
V
V
V
a
a
a
a
a
a
"}
(21,1,1) = {"
a
a
a
a
a
a
a
V
V
V
V
V
V
V
V
V
V
V
a
a
V
V
V
V
V
V
V
V
V
V
V
V
a
V
V
V
V
V
V
V
V
V
V
V
a
V
V
V
V
V
V
V
V
V
V
V
V
V
V
V
V
V
V
V
V
V
V
V
V
V
V
V
V
V
a
a
a
a
a
a
"}
(22,1,1) = {"
a
a
a
a
a
a
a
V
V
V
V
V
V
V
V
V
V
a
a
V
V
V
V
V
V
V
V
V
V
V
V
V
V
V
V
V
V
V
V
V
V
V
V
V
a
a
V
V
V
V
V
V
V
V
V
V
V
V
V
V
V
V
V
V
V
V
V
V
V
V
V
V
V
V
a
a
a
a
a
a
"}
(23,1,1) = {"
a
a
a
a
a
a
a
a
V
V
V
V
V
V
V
a
a
a
V
V
V
V
V
V
V
V
V
V
V
V
V
V
V
V
V
V
V
V
V
V
V
V
V
V
V
V
a
V
V
V
V
V
V
V
V
V
V
V
V
a
V
V
V
V
V
V
V
V
V
V
V
V
V
V
a
a
a
a
a
a
"}
(24,1,1) = {"
a
a
a
a
a
a
a
a
V
V
V
V
a
a
V
a
V
V
V
V
V
V
V
V
V
V
V
V
V
V
V
V
V
V
V
V
V
V
V
V
V
V
V
V
V
V
V
V
a
a
V
V
V
V
V
V
V
a
a
a
V
V
V
V
V
V
V
V
V
V
V
V
V
V
a
a
a
a
a
a
"}
(25,1,1) = {"
a
a
a
a
a
a
a
a
a
V
V
V
V
V
V
V
V
V
V
V
V
V
V
V
V
V
V
V
V
V
V
V
V
V
a
a
V
V
V
V
V
V
V
V
V
V
V
V
V
a
V
V
V
V
V
V
a
a
V
V
V
V
V
V
V
V
V
V
V
V
V
V
V
V
a
a
a
a
a
a
"}
(26,1,1) = {"
a
a
a
a
a
a
a
a
a
V
V
V
V
V
V
V
V
V
V
V
V
V
V
V
V
V
V
V
V
V
V
V
V
a
a
V
V
V
V
V
V
V
V
V
V
V
V
V
V
V
V
V
V
V
a
a
V
V
V
V
V
V
V
V
V
V
V
V
V
V
V
V
V
V
a
a
a
a
a
a
"}
(27,1,1) = {"
a
a
a
a
a
a
a
V
V
V
V
V
V
V
V
V
V
V
V
V
V
V
V
V
V
V
V
V
V
V
V
V
a
V
V
V
V
V
V
V
V
V
V
V
V
V
V
V
V
V
V
V
V
a
a
V
V
V
V
V
V
V
V
V
V
V
V
V
V
V
V
V
V
a
a
a
a
a
a
a
"}
(28,1,1) = {"
a
a
a
a
a
a
a
V
V
V
V
V
V
V
V
V
V
V
V
V
V
V
V
V
V
V
V
V
V
V
V
a
V
V
V
V
V
V
V
V
V
V
V
V
V
V
V
V
V
V
V
V
a
a
V
V
V
V
V
V
V
V
V
V
V
V
V
V
V
V
V
V
V
a
a
a
a
a
a
a
"}
(29,1,1) = {"
a
a
a
a
a
a
a
V
V
V
V
V
V
V
V
V
V
V
V
V
V
V
V
V
V
V
V
V
V
V
a
V
V
V
V
V
V
V
V
V
V
V
V
V
V
V
V
V
V
V
V
V
V
V
V
V
V
V
V
V
V
V
V
V
V
V
V
V
V
V
V
V
V
a
a
a
a
a
a
a
"}
(30,1,1) = {"
a
a
a
a
a
a
a
V
V
V
V
V
V
V
V
V
V
V
V
V
V
V
V
V
V
V
V
V
V
a
a
V
V
V
V
V
V
V
V
V
V
V
V
V
V
V
V
V
V
V
V
a
a
V
V
V
V
V
V
V
V
V
V
V
V
V
V
V
V
V
V
V
a
a
a
a
a
a
a
a
"}
(31,1,1) = {"
a
a
a
a
a
a
V
V
V
V
V
V
V
V
V
V
V
V
V
V
V
V
V
V
V
V
V
V
V
a
V
V
V
V
V
V
V
V
V
V
V
V
V
V
V
V
V
V
V
V
V
a
V
V
V
V
V
V
V
V
V
V
V
V
V
V
V
V
V
V
V
a
a
a
a
a
a
a
a
a
"}
(32,1,1) = {"
a
a
a
a
a
a
V
V
V
V
V
V
V
V
V
V
V
V
V
V
V
V
V
V
V
V
V
V
a
V
V
V
V
V
V
V
V
V
V
V
V
V
V
V
V
V
V
V
V
V
V
a
V
V
V
V
V
V
V
V
V
V
V
V
V
V
V
V
V
V
a
a
a
a
a
a
a
a
a
a
"}
(33,1,1) = {"
a
a
a
a
a
a
V
V
V
V
V
V
V
V
V
V
V
V
V
V
V
V
V
V
V
V
V
V
a
V
V
V
V
V
V
V
V
V
V
V
V
V
V
V
V
V
V
V
V
V
a
V
V
V
V
V
V
V
V
V
V
V
V
a
a
a
a
V
V
V
V
V
a
a
a
a
a
a
a
a
"}
(34,1,1) = {"
a
a
a
a
a
a
V
V
V
V
V
V
V
V
V
V
V
V
V
V
V
V
V
V
V
V
V
V
a
V
V
V
V
V
V
V
V
V
V
V
V
V
V
V
V
V
V
V
V
V
a
V
V
V
V
V
V
V
V
V
V
a
a
a
V
V
V
V
V
V
V
V
V
a
a
a
a
a
a
a
"}
(35,1,1) = {"
a
a
a
a
a
a
V
V
V
V
V
V
V
V
V
V
V
V
V
V
V
V
V
V
V
V
V
a
V
V
V
V
V
V
V
V
V
V
V
V
V
V
V
V
V
V
V
V
V
V
a
V
V
V
V
V
V
V
V
V
a
a
V
V
V
V
V
V
V
V
V
V
V
V
a
a
a
a
a
a
"}
(36,1,1) = {"
a
a
a
a
a
a
V
V
V
V
V
V
V
V
V
V
V
V
V
V
V
V
V
V
V
V
V
V
V
V
V
V
V
V
V
V
V
V
V
V
V
V
V
V
V
V
V
V
V
a
V
V
V
V
V
V
V
V
V
a
V
V
V
V
V
V
V
V
V
V
V
V
V
V
a
a
a
a
a
a
"}
(37,1,1) = {"
a
a
a
a
a
a
V
V
V
V
V
V
V
V
V
V
V
V
V
V
V
V
V
V
V
V
V
V
V
V
a
a
a
a
a
V
V
V
V
V
V
V
V
V
V
V
V
V
V
a
V
V
V
V
V
V
V
V
a
V
V
V
V
V
V
V
V
V
V
V
V
V
V
a
a
a
a
a
a
a
"}
(38,1,1) = {"
a
a
a
a
a
a
V
V
V
V
V
V
V
V
V
V
V
V
V
V
V
V
V
V
V
V
V
V
a
a
a
a
a
a
a
a
a
V
V
V
V
V
V
V
V
V
V
V
V
a
V
V
V
V
V
V
V
a
a
V
V
V
V
V
V
V
V
V
V
V
V
V
V
V
a
a
a
a
a
a
"}
(39,1,1) = {"
a
a
a
a
a
a
V
V
V
V
V
V
V
V
V
V
V
V
V
V
V
V
V
V
V
V
V
a
a
a
a
V
V
a
a
a
a
a
a
V
V
V
V
V
V
V
V
V
V
a
V
V
V
V
V
V
V
a
V
V
V
V
V
V
V
V
V
V
V
V
V
V
a
a
a
a
a
a
a
a
"}
(40,1,1) = {"
a
a
a
a
a
a
a
V
V
a
a
V
V
V
a
a
V
V
V
V
V
V
V
V
V
V
a
a
a
a
V
V
V
V
V
V
a
a
a
a
V
V
V
V
V
V
V
V
V
a
V
V
V
V
V
V
a
a
V
V
V
V
V
V
V
V
V
V
V
V
V
a
a
a
a
a
a
a
a
a
"}
(41,1,1) = {"
a
a
a
a
a
a
a
V
a
a
V
V
V
V
V
V
a
a
V
V
V
V
V
V
V
a
a
a
V
V
V
V
V
V
V
V
V
V
a
a
a
V
V
V
V
V
V
V
V
V
V
V
V
V
V
V
a
V
V
V
V
V
V
V
V
V
V
V
V
a
a
a
a
a
a
a
a
a
a
a
"}
(42,1,1) = {"
a
a
a
a
a
a
a
a
a
V
V
V
V
V
V
V
V
a
V
V
V
V
V
V
a
a
a
V
V
V
V
V
V
X
V
V
V
V
V
a
a
a
V
V
V
V
V
V
V
V
V
V
V
V
V
V
V
V
V
V
V
V
V
V
V
V
V
V
a
a
a
a
a
V
a
a
a
a
a
a
"}
(43,1,1) = {"
a
a
a
a
a
a
a
a
a
V
V
V
V
V
V
V
V
a
a
V
a
a
V
V
a
a
V
V
V
V
V
B
T
Y
Z
V
V
V
V
V
V
V
V
V
V
V
V
V
V
V
V
V
V
V
V
V
V
V
V
V
V
V
V
V
V
V
a
a
a
a
a
a
V
V
a
a
a
a
a
a
"}
(44,1,1) = {"
a
a
a
a
a
a
a
a
V
V
V
V
V
V
V
V
V
V
V
V
V
a
a
a
a
a
V
V
V
B
T
E
E
E
D
V
V
V
V
V
V
V
V
V
V
V
V
V
V
V
V
V
V
V
V
V
V
V
V
V
V
V
V
V
a
a
a
a
a
a
a
V
V
V
a
a
a
a
a
a
"}
(45,1,1) = {"
a
a
a
a
a
a
a
a
a
V
V
V
V
V
V
V
V
V
V
V
V
V
a
a
a
V
V
V
V
H
E
E
E
E
Y
T
Z
V
V
V
V
V
V
a
a
V
V
V
V
V
V
V
V
V
V
V
V
V
V
V
V
V
a
a
a
a
a
a
a
V
V
V
V
V
a
B
Z
a
a
a
"}
(46,1,1) = {"
a
a
a
a
a
a
a
a
a
V
V
V
V
V
V
V
V
V
V
V
V
V
a
a
a
V
V
V
B
E
E
E
E
E
E
E
Y
Z
V
V
V
V
a
a
a
V
V
V
V
V
V
V
V
V
V
a
a
V
V
V
a
a
a
a
a
a
a
V
V
V
V
V
V
V
B
E
E
Z
a
a
"}
(47,1,1) = {"
a
a
a
a
a
a
a
a
a
V
V
V
V
V
V
V
V
V
V
V
V
a
a
a
V
V
V
B
E
E
E
E
E
E
E
E
E
Y
Z
V
V
V
V
a
a
a
V
V
V
V
V
V
V
a
a
a
a
V
V
V
a
a
a
a
V
V
V
V
V
V
V
V
V
B
E
E
E
D
a
a
"}
(48,1,1) = {"
a
a
a
a
a
a
a
a
a
V
V
V
V
V
V
V
V
V
V
V
V
a
a
V
V
V
V
H
E
E
E
E
E
E
E
E
E
E
Y
Z
V
V
V
V
a
a
a
V
V
V
V
V
a
a
a
a
a
V
V
a
a
a
V
V
V
V
V
V
V
V
V
B
T
E
E
E
l
q
a
a
"}
(49,1,1) = {"
a
a
a
a
a
a
a
a
V
V
V
V
V
V
V
V
V
V
V
V
a
a
a
V
V
V
B
E
E
E
E
E
E
E
E
E
E
E
E
Y
Z
V
V
V
a
a
a
a
V
V
a
a
a
a
V
V
V
V
V
V
V
V
V
V
V
V
V
V
V
B
T
E
E
E
E
l
q
a
a
a
"}
(50,1,1) = {"
a
a
a
a
a
a
a
a
V
V
V
V
V
V
V
V
V
V
V
a
a
a
V
V
V
V
H
E
E
E
l
R
R
R
R
R
g
E
E
E
Y
Z
V
V
V
a
a
a
a
a
a
a
a
V
V
V
V
V
V
V
V
V
V
V
V
V
V
V
B
E
E
E
E
l
R
q
a
a
a
a
"}
(51,1,1) = {"
a
a
a
a
a
a
a
a
V
V
V
V
V
V
V
V
V
V
V
a
a
V
V
V
V
B
E
E
E
l
q
V
V
V
V
V
U
g
E
E
E
Y
Z
V
V
V
a
a
a
a
a
V
V
V
V
V
V
V
V
V
V
V
V
V
V
V
B
T
E
E
E
E
l
q
a
a
a
a
a
a
"}
(52,1,1) = {"
a
a
a
a
a
a
a
a
V
V
V
V
V
V
V
V
V
V
a
a
a
V
V
V
V
H
E
E
l
q
V
V
V
V
V
V
V
H
E
E
E
E
D
V
V
V
a
a
a
V
V
V
V
V
V
V
V
V
V
V
V
V
V
V
B
T
E
E
E
E
E
l
q
V
a
a
a
a
a
a
"}
(53,1,1) = {"
a
a
a
a
a
a
a
a
V
V
V
V
V
V
V
V
a
a
a
a
V
V
V
V
B
E
E
l
q
V
V
V
V
V
V
V
V
U
g
E
E
E
Y
Z
V
V
V
V
V
V
V
V
V
V
V
V
V
V
V
V
B
T
T
T
E
E
E
E
E
l
R
q
V
V
a
a
a
a
a
a
"}
(54,1,1) = {"
a
a
a
a
a
a
a
a
V
V
V
V
V
V
V
a
a
a
a
V
V
V
V
V
H
E
E
D
V
V
V
V
V
V
V
V
V
V
H
E
E
E
E
D
V
V
V
V
V
V
V
V
V
V
B
T
T
T
T
T
E
E
E
E
E
E
l
R
R
q
V
V
V
V
a
a
a
a
a
a
"}
(55,1,1) = {"
a
a
a
a
a
a
a
a
V
V
V
V
V
V
a
a
a
V
V
V
V
V
V
B
E
E
E
D
V
V
V
V
V
V
V
V
V
V
H
E
E
E
E
D
V
V
V
V
V
V
V
B
T
T
E
E
E
E
E
E
E
E
E
E
l
R
q
V
V
V
V
V
V
a
a
a
a
a
a
a
"}
(56,1,1) = {"
a
a
a
a
a
a
a
a
V
V
V
V
V
a
a
a
V
V
V
V
V
V
V
H
E
E
l
q
V
V
V
V
V
V
V
V
V
V
U
g
E
E
E
D
V
V
V
V
B
T
T
E
E
E
E
E
E
E
E
E
E
E
l
R
q
V
V
V
V
V
V
a
a
a
a
a
a
a
a
a
"}
(57,1,1) = {"
a
a
a
a
a
a
a
V
V
V
V
V
a
a
a
V
V
V
V
V
B
T
T
E
E
E
D
V
V
V
V
V
V
V
V
V
V
V
V
H
E
E
E
Y
Z
V
B
T
E
E
E
E
E
E
E
l
R
R
R
R
R
R
q
V
V
V
V
V
V
V
V
V
a
a
a
a
a
a
a
a
"}
(58,1,1) = {"
a
a
a
a
a
a
a
V
V
V
V
a
a
a
V
V
V
V
B
T
E
E
E
E
E
E
D
V
V
V
V
V
V
V
V
V
V
V
V
H
E
E
E
E
Y
T
E
E
E
E
E
E
E
E
E
D
V
V
V
V
V
V
V
V
V
V
V
V
V
V
V
V
V
a
a
a
a
a
a
a
"}
(59,1,1) = {"
a
a
a
a
a
a
a
V
V
V
a
a
a
a
V
V
V
B
E
E
E
E
E
E
E
E
D
V
V
V
V
V
V
V
V
V
V
V
V
H
E
E
E
E
E
E
E
E
E
E
E
E
E
E
E
Y
Z
V
V
V
V
V
V
V
V
V
V
V
V
V
V
a
a
a
a
a
a
a
a
a
"}
(60,1,1) = {"
a
a
a
a
a
a
a
V
V
a
a
a
a
V
V
V
B
E
E
E
E
E
E
E
E
E
D
V
V
V
V
V
V
V
V
V
V
V
V
H
E
E
E
E
E
E
E
E
E
l
R
R
R
g
E
E
Y
Z
V
V
V
V
V
V
V
V
V
V
V
a
a
a
a
a
a
a
a
a
a
a
"}
(61,1,1) = {"
a
a
a
a
a
a
a
V
a
a
a
a
V
V
V
B
E
E
E
E
l
R
R
g
E
E
D
V
V
V
V
V
V
V
V
V
V
V
V
H
E
E
E
E
E
E
l
R
R
q
V
V
V
U
R
g
E
Y
Z
V
V
V
V
V
V
V
V
a
a
a
a
a
a
a
a
a
a
a
a
a
"}
(62,1,1) = {"
a
a
a
a
a
a
a
V
a
a
a
V
V
V
B
E
E
E
l
R
q
V
V
H
E
E
D
V
V
V
V
V
V
V
V
V
V
V
B
E
E
E
E
E
l
R
q
V
V
V
V
V
V
V
V
U
g
E
Y
T
Z
V
V
V
V
V
V
V
V
a
a
a
a
a
a
a
a
a
a
a
"}
(63,1,1) = {"
a
a
a
a
a
a
a
a
a
a
V
V
V
B
E
E
E
l
q
V
V
V
V
U
g
E
D
V
V
V
V
V
V
V
V
V
V
V
H
E
E
E
E
E
D
V
V
V
V
V
V
V
V
V
V
V
U
g
E
E
Y
Z
V
V
V
V
V
V
V
V
a
a
a
V
V
a
a
a
a
a
"}
(64,1,1) = {"
a
a
a
a
a
a
a
a
a
V
V
V
V
H
E
E
l
q
V
V
V
V
V
V
H
E
Y
Z
V
V
V
V
V
V
V
V
V
V
H
E
E
E
E
E
D
V
V
V
V
V
V
V
V
V
V
V
V
U
g
E
E
Y
T
Z
V
V
V
V
V
V
V
a
V
V
a
a
a
a
a
a
"}
(65,1,1) = {"
a
a
a
a
a
a
a
a
a
V
V
V
B
E
E
l
q
V
V
V
V
V
V
V
H
E
E
D
V
V
V
V
V
V
V
V
V
B
E
E
E
E
E
E
D
V
V
V
V
V
V
V
V
V
V
V
V
V
U
g
E
E
E
Y
Z
V
V
V
V
V
V
V
V
V
a
a
a
a
a
a
"}
(66,1,1) = {"
a
a
a
a
a
a
a
a
V
V
V
B
E
E
l
q
V
V
V
V
V
V
V
V
H
E
E
Y
Z
V
V
V
V
V
V
V
V
H
E
E
E
E
E
l
q
V
V
V
V
a
a
a
V
V
V
V
V
V
V
U
R
g
E
E
Y
Z
V
V
V
V
V
V
V
V
a
a
a
a
a
a
"}
(67,1,1) = {"
a
a
a
a
a
a
a
a
V
V
V
H
E
E
D
V
V
V
V
V
V
V
V
V
U
g
E
E
Y
T
Z
V
V
V
V
V
B
E
E
E
E
E
E
D
V
V
V
V
V
a
a
a
a
V
V
V
V
V
V
V
V
U
R
g
E
Y
T
Z
V
V
V
V
V
a
a
a
a
a
a
a
"}
(68,1,1) = {"
a
a
a
a
a
a
a
V
V
V
B
E
E
l
q
V
V
V
V
V
V
V
V
V
V
U
g
E
E
E
Y
Z
V
V
V
V
H
E
E
E
E
E
l
q
V
V
V
V
a
a
a
a
a
a
a
V
V
V
V
V
V
V
V
U
g
E
E
Y
Z
V
V
V
V
V
a
a
a
a
a
a
"}
(69,1,1) = {"
a
a
a
a
a
a
a
V
V
B
E
E
E
D
V
V
V
V
V
V
a
V
V
V
V
V
U
g
E
E
E
Y
Z
V
B
T
E
E
E
E
E
l
q
V
V
V
V
V
a
a
V
V
a
a
a
a
a
a
V
V
V
V
V
V
U
R
g
E
Y
Z
V
V
V
V
a
a
a
a
a
a
"}
(70,1,1) = {"
a
a
a
a
a
a
V
V
B
E
E
E
l
q
V
V
V
V
V
a
a
a
V
V
V
V
V
U
g
E
E
E
Y
T
E
E
E
E
E
l
R
q
V
V
V
V
V
a
a
a
V
V
V
V
V
a
a
a
a
a
V
V
V
V
V
V
U
R
g
Y
T
Z
V
V
a
a
a
a
a
a
"}
(71,1,1) = {"
a
a
a
a
a
a
V
B
E
E
E
l
q
V
V
V
V
V
a
a
a
a
V
V
V
V
V
V
U
g
E
E
E
E
E
E
E
E
l
q
V
V
V
V
V
V
a
a
a
V
V
V
V
V
V
a
a
a
a
a
a
a
V
V
V
V
V
V
U
g
E
Y
T
Z
a
a
a
a
a
a
"}
(72,1,1) = {"
a
a
a
a
a
a
B
E
E
E
l
q
V
V
V
V
V
a
a
a
V
a
a
a
V
V
V
V
V
U
R
g
E
E
E
E
E
E
D
V
V
V
V
V
V
a
a
a
V
V
V
V
V
V
a
a
V
V
V
a
a
a
a
V
V
V
V
V
V
U
g
E
E
Y
Z
a
a
a
a
a
"}
(73,1,1) = {"
a
a
a
a
a
B
E
E
E
l
q
V
V
V
V
V
a
a
a
V
V
V
a
a
a
V
V
V
V
V
V
U
R
g
E
E
E
E
D
V
V
V
V
V
V
a
a
V
V
V
V
V
V
V
a
V
V
V
V
V
a
a
a
a
V
V
V
V
V
V
U
R
g
E
Y
Z
a
a
a
a
"}
(74,1,1) = {"
a
a
a
a
B
E
E
E
l
q
V
V
V
V
V
a
a
a
V
V
V
V
a
a
a
a
V
V
V
V
V
V
V
U
R
g
E
E
Y
Z
V
V
V
V
V
a
a
V
V
V
V
V
V
a
a
V
V
V
V
V
V
a
a
a
a
a
V
V
V
V
V
V
U
g
E
Y
T
Z
a
a
"}
(75,1,1) = {"
a
a
a
B
E
E
E
l
q
V
V
V
V
V
a
a
a
V
V
V
V
V
V
V
a
a
a
V
V
V
V
V
V
V
V
H
E
E
E
D
V
V
V
V
V
V
V
V
V
V
V
V
a
a
V
V
V
V
V
V
V
V
a
a
a
a
a
V
V
V
V
V
V
U
R
g
E
D
a
a
"}
(76,1,1) = {"
a
a
B
E
E
E
l
q
V
V
V
V
V
V
a
a
V
V
V
V
V
V
V
V
V
a
a
a
V
V
V
V
V
V
V
U
g
E
E
D
V
V
V
V
V
V
V
V
V
V
V
V
a
V
V
V
V
V
V
V
V
V
V
V
a
a
a
V
V
V
V
V
V
V
a
U
g
q
a
a
"}
(77,1,1) = {"
a
a
U
E
l
R
q
V
V
V
V
V
V
a
a
V
V
V
V
V
V
V
V
V
V
V
a
a
a
a
V
V
V
V
V
V
H
E
E
Y
Z
V
V
V
V
a
V
V
V
V
V
V
a
V
V
V
V
V
V
V
V
V
V
V
V
a
a
a
V
V
V
V
V
V
a
a
j
a
a
a
"}
(78,1,1) = {"
a
a
a
U
q
a
V
V
V
V
V
V
a
a
a
V
V
V
V
V
V
V
V
V
V
V
V
a
a
a
a
V
V
V
V
V
H
E
E
E
D
V
V
V
V
a
a
a
V
V
V
V
V
V
V
V
V
V
V
V
V
V
V
V
V
a
a
a
a
a
V
V
V
V
a
a
a
a
a
a
"}
(79,1,1) = {"
a
a
a
a
a
a
V
V
V
V
V
V
a
a
a
V
V
V
V
V
V
V
V
V
V
V
V
V
a
a
a
a
V
V
V
V
U
g
E
E
D
V
V
V
V
a
a
a
V
V
V
V
V
V
V
V
V
V
V
V
V
V
V
V
V
V
V
a
a
a
a
a
V
V
a
a
a
a
a
a
"}
(80,1,1) = {"
a
a
a
a
a
a
V
V
V
V
V
a
a
a
V
V
V
V
V
V
V
V
V
V
V
V
V
V
V
a
a
V
V
V
V
V
V
H
E
E
Y
Z
V
V
V
a
a
a
V
V
V
V
V
V
V
V
V
V
V
V
V
V
V
V
V
V
V
V
V
a
a
a
a
a
a
a
a
a
a
a
"}
(81,1,1) = {"
a
a
a
a
a
a
V
V
V
V
V
a
a
V
V
V
V
V
V
V
V
V
V
V
V
V
V
V
V
V
V
V
V
V
V
V
V
H
E
E
E
D
V
V
V
V
a
a
a
V
V
V
V
V
V
V
V
V
V
V
V
V
V
V
V
V
V
V
V
V
V
a
a
a
a
a
a
a
a
a
"}
(82,1,1) = {"
a
a
a
a
a
a
V
a
V
V
V
a
V
V
V
V
V
V
V
V
V
V
V
V
V
V
V
V
V
V
V
V
V
V
V
V
V
H
E
E
E
Y
Z
V
V
V
a
a
a
V
V
V
V
V
V
V
V
V
V
V
V
V
V
V
V
V
V
V
V
V
V
V
a
a
a
a
a
a
a
a
"}
(83,1,1) = {"
a
a
a
a
a
a
a
a
V
V
V
V
V
V
V
V
V
V
V
V
V
V
V
V
V
V
V
V
V
V
V
V
V
V
V
V
V
U
g
E
E
E
D
V
V
V
V
a
a
V
V
V
V
V
a
V
V
V
V
V
V
V
V
V
V
V
V
V
V
V
V
V
V
a
a
a
a
a
a
a
"}
(84,1,1) = {"
a
a
a
a
a
a
a
a
a
V
V
V
V
V
V
V
V
V
V
V
a
V
V
V
V
V
V
V
V
V
V
a
V
V
V
V
V
V
U
g
E
E
Y
Z
V
V
V
a
a
a
V
V
V
V
a
a
V
V
V
V
V
V
V
V
V
V
V
V
V
V
V
V
V
V
a
a
a
a
a
a
"}
(85,1,1) = {"
a
a
a
a
a
a
a
V
V
V
V
V
V
V
V
V
V
V
V
V
a
V
V
V
V
V
V
V
V
V
V
V
a
a
V
V
V
V
V
H
E
E
E
D
V
V
V
V
a
a
V
V
V
V
V
a
a
V
V
V
V
V
V
V
V
V
V
V
V
V
V
V
V
a
a
a
a
a
a
a
"}
(86,1,1) = {"
a
a
a
a
a
a
V
V
V
V
V
V
V
V
V
V
V
V
V
a
a
V
V
V
V
V
V
V
V
V
V
V
a
a
a
V
V
V
V
U
g
E
E
Y
Z
V
V
V
a
a
V
V
V
V
V
V
a
a
V
V
V
V
V
V
V
V
V
V
V
V
V
V
V
a
a
a
a
a
a
a
"}
(87,1,1) = {"
a
a
a
a
a
a
V
V
V
V
V
V
V
V
V
V
V
V
V
a
V
V
V
V
V
V
V
V
V
V
V
V
a
a
a
V
V
V
V
V
H
E
E
E
Y
Z
V
V
V
a
a
V
V
V
V
V
V
a
a
V
V
V
V
V
V
V
V
V
V
V
V
a
a
a
a
a
a
a
a
a
"}
(88,1,1) = {"
a
a
a
a
a
a
V
V
V
V
V
V
V
V
V
V
V
V
a
a
V
V
V
V
a
V
V
V
V
V
V
V
V
a
a
V
V
V
V
V
U
E
E
E
E
D
V
V
V
a
a
a
V
V
V
V
V
V
V
a
a
a
a
a
a
a
V
V
V
a
a
a
a
a
a
a
a
a
a
a
"}
(89,1,1) = {"
a
a
a
a
a
a
a
a
V
V
V
V
V
V
V
V
V
V
a
V
V
V
V
V
a
a
V
V
V
V
V
V
V
a
a
a
V
V
V
V
V
H
E
E
E
D
V
V
V
V
a
a
V
V
V
V
V
V
V
V
V
V
V
V
V
V
V
V
V
V
a
a
a
a
a
a
a
a
a
a
"}
(90,1,1) = {"
a
a
a
a
a
a
a
a
V
V
V
V
V
V
V
V
V
a
V
V
V
V
V
V
V
a
a
V
V
V
V
V
V
V
a
a
V
V
V
V
V
U
g
E
E
Y
Z
V
V
V
a
a
a
V
V
V
V
V
V
V
V
V
V
V
V
V
V
V
V
V
V
a
a
a
a
a
a
a
a
a
"}
(91,1,1) = {"
a
a
a
a
a
a
a
V
V
V
V
V
V
V
V
V
a
a
V
V
V
V
V
V
V
V
a
V
V
V
V
V
V
V
a
a
a
V
V
V
V
V
H
E
E
E
D
V
V
V
V
a
a
V
V
V
V
V
V
V
V
V
V
V
V
V
V
V
V
V
V
V
a
a
a
a
a
a
a
a
"}
(92,1,1) = {"
a
a
a
a
a
a
a
V
V
V
V
V
V
V
V
V
a
V
V
V
V
V
V
V
V
V
a
a
V
V
V
V
V
V
V
a
a
V
V
V
V
V
H
E
E
E
Y
Z
V
V
V
a
a
a
V
V
V
V
V
V
V
V
V
V
V
V
V
V
V
V
V
V
V
a
a
a
a
a
a
a
"}
(93,1,1) = {"
a
a
a
a
a
a
V
V
V
V
V
V
V
V
V
a
a
V
V
V
V
V
V
V
V
V
V
a
a
V
V
V
V
V
V
a
a
a
V
V
V
V
U
g
E
E
E
D
V
V
V
V
a
a
V
V
V
V
V
V
V
V
V
V
V
V
V
V
V
V
V
V
V
a
a
a
a
a
a
a
"}
(94,1,1) = {"
a
a
a
a
a
a
V
V
V
V
V
V
V
V
a
a
V
V
V
V
V
V
V
V
V
V
V
V
a
V
V
V
a
V
V
V
a
a
V
V
V
V
V
H
E
E
E
Y
Z
V
V
V
a
a
a
V
V
V
V
a
V
V
V
V
V
V
V
V
V
V
V
V
a
a
a
a
a
a
a
a
"}
(95,1,1) = {"
a
a
a
a
a
a
a
V
V
V
V
V
a
a
V
V
V
V
V
V
V
V
V
V
V
V
V
V
V
V
V
a
a
V
V
V
a
a
a
V
V
V
V
U
g
E
E
E
D
V
V
V
V
a
a
V
V
V
V
a
V
V
V
V
V
V
V
V
V
V
V
V
a
a
a
a
a
a
a
a
"}
(96,1,1) = {"
a
a
a
a
a
a
a
V
V
V
V
V
V
V
V
V
V
V
V
V
V
V
V
V
V
V
V
V
V
V
V
a
V
V
V
V
a
a
a
V
V
V
V
V
H
E
E
E
Y
Z
V
V
V
a
a
a
V
V
V
V
a
V
V
V
V
V
V
V
V
V
V
V
a
a
a
a
a
a
a
a
"}
(97,1,1) = {"
a
a
a
a
a
a
a
a
a
a
V
V
V
V
V
V
V
V
V
V
V
V
V
V
V
V
V
V
V
V
V
a
V
V
V
V
V
a
a
V
V
V
V
V
U
g
E
E
E
D
V
V
V
V
a
a
V
V
V
V
a
a
V
V
V
V
V
V
V
V
V
V
a
a
a
a
a
a
a
a
"}
(98,1,1) = {"
a
a
a
a
a
a
a
a
V
V
V
V
V
V
V
V
V
V
V
V
V
V
V
V
V
V
V
V
V
V
a
V
V
V
V
V
V
a
a
a
V
V
V
V
V
H
E
E
E
Y
Z
V
V
V
a
a
a
V
V
V
V
a
V
V
V
V
V
V
V
V
V
a
a
a
a
a
a
a
a
a
"}
(99,1,1) = {"
a
a
a
a
a
a
a
V
V
V
V
V
V
V
a
V
V
V
V
V
V
V
V
V
V
V
V
V
V
V
a
V
V
V
V
V
V
a
a
a
V
V
V
V
V
U
g
E
E
E
D
V
V
V
V
a
a
V
V
V
V
V
V
V
V
V
V
V
V
V
V
a
a
a
a
a
a
a
a
a
"}
(100,1,1) = {"
a
a
a
a
a
a
a
V
V
V
V
V
V
V
V
a
V
V
V
V
V
V
V
V
V
V
V
V
V
V
a
V
V
V
V
V
V
V
a
a
V
V
V
V
V
V
H
E
E
E
Y
Z
V
V
V
V
a
a
V
V
V
V
V
V
V
V
V
V
a
a
V
a
a
a
a
a
a
a
a
a
"}
(101,1,1) = {"
a
a
a
a
a
a
V
V
V
V
V
V
V
V
V
a
V
V
V
V
V
V
V
V
V
V
V
V
V
V
a
V
V
V
V
V
V
V
a
a
a
V
V
V
V
V
U
g
E
E
E
D
V
V
V
V
a
a
V
V
V
V
V
V
V
V
V
a
a
V
V
V
a
a
a
a
a
a
a
a
"}
(102,1,1) = {"
a
a
a
a
a
a
a
V
V
V
V
V
V
V
V
a
V
V
V
V
V
V
V
V
V
V
V
V
V
V
a
V
V
V
V
V
V
V
V
a
a
V
V
V
V
V
V
U
g
E
E
Y
Z
V
V
V
V
a
a
V
V
V
V
V
V
a
a
V
V
V
V
V
V
a
a
a
a
a
a
a
"}
(103,1,1) = {"
a
a
a
a
a
a
a
V
V
V
V
V
V
V
V
a
V
V
V
V
V
V
V
V
V
V
V
V
V
V
a
V
V
V
V
V
V
V
V
a
a
a
V
V
V
V
V
V
H
E
E
E
D
V
V
V
V
a
a
V
V
V
V
V
a
a
V
V
V
V
V
V
V
a
a
a
a
a
a
a
"}
(104,1,1) = {"
a
a
a
a
a
a
V
V
V
V
V
V
V
V
V
V
V
V
V
V
V
V
V
V
V
V
V
V
V
V
a
V
V
V
V
V
V
V
V
V
a
a
a
V
V
V
V
V
U
g
E
E
Y
Z
V
V
V
a
a
a
V
V
V
a
V
V
V
V
V
V
V
V
V
a
a
a
a
a
a
a
"}
(105,1,1) = {"
a
a
a
a
a
a
V
V
V
V
V
V
V
V
V
V
a
V
V
V
V
V
V
V
V
V
V
V
V
V
a
V
V
V
V
V
V
V
V
V
V
a
a
V
V
V
V
V
V
H
E
E
E
D
V
V
V
V
a
a
a
V
V
a
V
V
V
V
V
V
V
V
V
V
a
a
a
a
a
a
"}
(106,1,1) = {"
a
a
a
a
a
a
a
V
V
V
V
V
V
V
V
V
a
V
V
V
V
V
V
V
V
V
V
V
V
V
V
V
V
V
V
V
V
V
V
V
V
a
a
a
V
V
V
V
V
U
g
E
E
Y
Z
V
V
V
V
a
a
V
a
V
V
V
V
V
V
V
V
V
V
V
a
a
a
a
a
a
"}
(107,1,1) = {"
a
a
a
a
a
a
a
V
V
V
V
V
V
V
V
V
a
V
V
V
V
V
V
V
V
V
V
V
V
V
V
V
V
V
V
V
V
V
V
V
V
V
a
a
a
V
V
V
V
V
H
E
E
E
Y
Z
V
V
V
a
a
V
V
V
V
V
V
V
V
V
V
V
V
V
a
a
a
a
a
a
"}
(108,1,1) = {"
a
a
a
a
a
a
V
V
V
V
V
V
V
V
V
V
V
V
V
V
V
V
V
V
V
V
V
V
V
V
V
a
V
V
V
V
V
V
V
V
V
V
V
a
a
a
V
V
V
V
U
g
E
E
E
Y
Z
V
V
a
a
a
V
V
V
V
V
V
V
V
V
V
V
V
a
a
a
a
a
a
"}
(109,1,1) = {"
a
a
a
a
a
a
V
V
V
V
V
V
V
V
V
V
V
V
V
V
V
V
V
V
V
V
V
V
V
V
V
a
a
V
V
V
V
V
V
V
V
V
V
V
a
a
a
V
V
V
V
H
E
E
E
E
D
V
V
V
a
V
V
V
V
V
V
V
V
V
V
V
V
V
a
a
a
a
a
a
"}
(110,1,1) = {"
a
a
a
a
a
a
V
V
V
V
V
V
V
V
V
V
V
V
V
V
V
V
V
V
V
V
V
V
V
V
V
a
a
V
V
V
V
V
V
V
V
V
V
V
a
a
a
a
V
V
V
U
g
E
E
E
Y
Z
V
V
V
V
V
V
V
V
V
V
a
a
V
V
V
V
a
a
a
a
a
a
"}
(111,1,1) = {"
a
a
a
a
a
a
a
V
V
V
V
V
V
V
V
V
a
V
V
V
V
V
V
V
V
V
V
V
V
V
V
a
a
a
V
V
V
V
V
V
V
V
V
V
V
a
a
a
V
V
V
V
U
g
E
E
E
D
V
V
V
V
V
V
V
V
V
V
a
a
V
V
V
V
a
a
a
a
a
a
"}
(112,1,1) = {"
a
a
a
a
a
a
a
V
V
V
V
V
V
V
V
a
a
a
V
V
V
V
V
V
V
V
V
V
V
V
a
a
a
a
a
V
V
V
V
V
V
V
V
V
V
V
a
a
a
V
V
V
V
U
g
E
E
Y
Z
V
V
a
V
a
V
V
V
a
a
V
V
V
V
V
a
a
a
a
a
a
"}
(113,1,1) = {"
a
a
a
a
a
a
a
a
V
V
V
V
V
V
V
a
a
a
V
V
V
V
V
V
V
V
V
V
V
V
a
a
a
a
a
a
a
V
V
V
V
V
V
V
V
V
a
a
a
a
V
V
V
V
H
E
E
E
D
V
V
a
a
a
V
V
V
a
a
V
V
V
V
a
a
a
a
a
a
a
"}
(114,1,1) = {"
a
a
a
a
a
a
a
a
a
V
V
V
V
V
a
a
a
a
a
V
V
V
V
V
V
a
a
a
V
V
a
a
a
a
a
a
a
a
a
a
a
V
V
V
V
V
V
a
a
a
a
V
V
V
U
g
E
E
Y
Z
V
V
a
a
a
a
a
a
a
a
a
a
a
a
a
a
a
a
a
a
"}
(115,1,1) = {"
a
a
a
a
a
a
a
a
a
a
a
a
a
a
a
a
a
a
a
a
a
a
a
a
a
a
a
a
a
a
a
a
a
a
a
a
a
a
a
a
a
a
a
a
a
a
a
a
a
a
a
a
a
a
a
H
E
E
E
D
a
a
a
a
a
a
a
a
a
a
a
a
a
a
a
a
a
a
a
a
"}
(116,1,1) = {"
a
a
a
a
a
a
a
a
a
a
a
a
a
a
a
a
a
a
a
a
a
a
a
a
a
a
a
a
a
a
a
a
a
a
a
a
a
a
a
a
a
a
a
a
a
a
a
a
a
a
a
a
a
a
a
U
g
E
E
D
a
a
a
a
a
a
a
a
a
a
a
a
a
a
a
a
a
a
a
a
"}
(117,1,1) = {"
a
a
a
a
a
a
a
a
a
a
a
a
a
a
a
a
a
a
a
a
a
a
a
a
a
a
a
a
a
a
a
a
a
a
a
a
a
a
a
a
a
a
a
a
a
a
a
a
a
a
a
a
a
a
a
a
U
g
E
q
a
a
a
a
a
a
a
a
a
a
a
a
a
a
a
a
a
a
a
a
"}
(118,1,1) = {"
a
a
a
a
a
a
a
a
a
a
a
a
a
a
a
a
a
a
a
a
a
a
a
a
a
a
a
a
a
a
a
a
a
a
a
a
a
a
a
a
a
a
a
a
a
a
a
a
a
a
a
a
a
a
a
a
a
U
q
a
a
a
a
a
a
a
a
a
a
a
a
a
a
a
a
a
a
a
a
a
"}
(119,1,1) = {"
a
a
a
a
a
a
a
a
a
a
a
a
a
a
a
a
a
a
a
a
a
a
a
a
a
a
a
a
a
a
a
a
a
a
a
a
a
a
a
a
a
a
a
a
a
a
a
a
a
a
a
a
a
a
a
a
a
a
a
a
a
a
a
a
a
a
a
a
a
a
a
a
a
a
a
a
a
a
a
a
"}
(120,1,1) = {"
a
a
a
a
a
a
a
a
a
a
a
a
a
a
a
a
a
a
a
a
a
a
a
a
a
a
a
a
a
a
a
a
a
a
a
a
a
a
a
a
a
a
a
a
a
a
a
a
a
a
a
a
a
a
a
a
a
a
a
a
a
a
a
a
a
a
a
a
a
a
a
a
a
a
a
a
a
a
a
a
"}
