//MAP CONVERTED BY dmm2tgm.py THIS HEADER COMMENT PREVENTS RECONVERSION, DO NOT REMOVE
"a" = (
/obj/structure/grille,
/turf/space,
/area)
"e" = (
/obj/structure/catwalk,
/turf/space,
/area)
"k" = (
/obj/effect/landmark/keycard/easy,
/obj/structure/catwalk,
/turf/space,
/area)
"o" = (
/obj/structure/lattice,
/turf/space,
/area)
"A" = (
/turf/space,
/area)

(1,1,1) = {"
A
A
A
A
A
a
a
a
a
A
A
A
A
A
a
"}
(2,1,1) = {"
A
o
A
A
A
A
A
A
A
A
o
o
o
A
a
"}
(3,1,1) = {"
A
A
o
o
o
o
o
A
e
A
A
A
o
o
a
"}
(4,1,1) = {"
a
A
A
A
o
o
o
A
e
e
e
A
A
A
a
"}
(5,1,1) = {"
a
A
A
A
A
e
o
o
A
A
A
A
A
A
A
"}
(6,1,1) = {"
A
o
A
A
A
e
A
e
e
e
A
A
o
o
o
"}
(7,1,1) = {"
A
o
A
A
A
e
e
e
e
e
A
o
o
A
o
"}
(8,1,1) = {"
A
A
A
A
A
o
e
k
e
e
o
A
A
o
o
"}
(9,1,1) = {"
A
A
A
o
o
e
o
e
e
e
A
A
A
o
A
"}
(10,1,1) = {"
A
A
e
o
o
e
o
e
o
o
A
A
A
o
A
"}
(11,1,1) = {"
A
A
e
A
o
e
e
e
e
o
o
o
o
o
a
"}
(12,1,1) = {"
A
A
A
A
o
o
A
A
A
A
A
o
o
A
A
"}
(13,1,1) = {"
a
A
A
A
o
o
A
A
A
A
A
e
A
a
a
"}
(14,1,1) = {"
a
A
A
A
A
A
o
o
o
e
e
A
A
a
A
"}
(15,1,1) = {"
A
A
a
a
a
a
A
A
A
A
A
A
A
a
A
"}
