//MAP CONVERTED BY dmm2tgm.py THIS HEADER COMMENT PREVENTS RECONVERSION, DO NOT REMOVE
"a" = (
/obj/effect/landmark/keycard/hard,
/turf/simulated/floor/plating/airless,
/area)

(1,1,1) = {"
a
"}
