"aa" = (/turf/space/transit/north,/area)
"ab" = (/turf/space/transit/east,/area)
"ac" = (/turf/space/transit/west,/area)
"ad" = (/turf/space,/area)
"ae" = (/turf/simulated/wall,/area/vault/mecha_graveyard)
"af" = (/turf/unsimulated/floor/asteroid,/area/vault/mecha_graveyard)
"ag" = (/turf/unsimulated/mineral/random,/area/vault/mecha_graveyard)
"ah" = (/turf/unsimulated/floor/airless{icon_state = "asteroidfloor"},/area/vault/mecha_graveyard)
"ai" = (/obj/item/stack/rods,/turf/unsimulated/floor/asteroid,/area/vault/mecha_graveyard)
"aj" = (/obj/effect/decal/cleanable/dirt,/turf/unsimulated/floor/airless{icon_state = "asteroidfloor"},/area/vault/mecha_graveyard)
"ak" = (/turf/unsimulated/floor/asteroid{icon_state = "asteroid_dug"},/area/vault/mecha_graveyard)
"al" = (/obj/effect/decal/cleanable/blood/gibs/robot,/turf/unsimulated/floor/asteroid,/area/vault/mecha_graveyard)
"am" = (/obj/structure/hanging_lantern{dir = 1},/turf/unsimulated/floor/asteroid,/area/vault/mecha_graveyard)
"an" = (/obj/effect/decal/cleanable/blood/gibs/robot/limb,/turf/unsimulated/floor/asteroid,/area/vault/mecha_graveyard)
"ao" = (/obj/item/weapon/ore/glass,/turf/unsimulated/floor/asteroid{icon_state = "asteroid_dug"},/area/vault/mecha_graveyard)
"ap" = (/obj/effect/decal/mecha_wreckage/graveyard_ripley,/turf/unsimulated/floor/asteroid{icon_state = "asteroid_dug"},/area/vault/mecha_graveyard)
"aq" = (/obj/effect/decal/cleanable/soot,/turf/unsimulated/floor/asteroid{icon_state = "asteroid_dug"},/area/vault/mecha_graveyard)
"ar" = (/obj/item/weapon/ore/iron,/turf/unsimulated/floor/asteroid{icon_state = "asteroid_dug"},/area/vault/mecha_graveyard)
"as" = (/obj/structure/hanging_lantern,/turf/unsimulated/floor/airless{icon_state = "asteroidfloor"},/area/vault/mecha_graveyard)
"at" = (/obj/effect/decal/mecha_wreckage/graveyard_ripley,/turf/unsimulated/floor/asteroid,/area/vault/mecha_graveyard)
"au" = (/obj/structure/girder,/turf/unsimulated/floor/asteroid,/area/vault/mecha_graveyard)
"av" = (/obj/structure/girder,/obj/item/stack/rods,/turf/unsimulated/floor/asteroid,/area/vault/mecha_graveyard)
"aw" = (/turf/unsimulated/floor/airless{icon_state = "asteroidwarning"; dir = 1},/area/vault/mecha_graveyard)
"ax" = (/turf/unsimulated/floor/airless{icon_state = "asteroidwarning"; dir = 5},/area/vault/mecha_graveyard)
"ay" = (/obj/effect/decal/cleanable/blood/gibs/robot/down,/turf/unsimulated/floor/asteroid,/area/vault/mecha_graveyard)
"az" = (/obj/effect/decal/cleanable/ash,/turf/unsimulated/floor/asteroid{icon_state = "asteroid_dug"},/area/vault/mecha_graveyard)
"aA" = (/obj/effect/decal/cleanable/blood/gibs/robot,/turf/unsimulated/floor/asteroid{icon_state = "asteroid_dug"},/area/vault/mecha_graveyard)
"aB" = (/obj/machinery/status_display{pixel_y = 32},/obj/effect/decal/mecha_wreckage/durand,/obj/effect/decal/cleanable/soot,/turf/unsimulated/floor/airless{icon_state = "asteroidfloor"},/area/vault/mecha_graveyard)
"aC" = (/turf/unsimulated/floor/airless{icon_state = "asteroidwarning"; dir = 4},/area/vault/mecha_graveyard)
"aD" = (/obj/item/stack/sheet/plasteel,/turf/unsimulated/floor/asteroid,/area/vault/mecha_graveyard)
"aE" = (/obj/effect/decal/mecha_wreckage/marauder,/turf/unsimulated/floor/asteroid,/area/vault/mecha_graveyard)
"aF" = (/obj/item/mecha_parts/mecha_equipment/repair_droid,/turf/unsimulated/floor/airless{icon_state = "asteroidfloor"},/area/vault/mecha_graveyard)
"aG" = (/obj/effect/decal/cleanable/blood/gibs/robot,/turf/unsimulated/floor/airless{icon_state = "asteroidfloor"},/area/vault/mecha_graveyard)
"aH" = (/obj/item/weapon/ore/slag,/turf/unsimulated/floor/asteroid,/area/vault/mecha_graveyard)
"aI" = (/obj/effect/decal/cleanable/soot,/turf/unsimulated/floor/asteroid,/area/vault/mecha_graveyard)
"aJ" = (/obj/effect/decal/mecha_wreckage/durand,/turf/unsimulated/floor/asteroid,/area/vault/mecha_graveyard)
"aK" = (/turf/unsimulated/floor/airless{icon_state = "asteroidwarning"; dir = 10},/area/vault/mecha_graveyard)
"aL" = (/obj/effect/decal/cleanable/dirt,/turf/unsimulated/floor/airless{icon_state = "asteroidwarning"},/area/vault/mecha_graveyard)
"aM" = (/obj/effect/decal/mecha_wreckage/gygax,/obj/effect/decal/cleanable/soot,/turf/unsimulated/floor/airless{icon_state = "asteroidfloor"},/area/vault/mecha_graveyard)
"aN" = (/obj/effect/decal/cleanable/ash,/turf/unsimulated/floor/asteroid,/area/vault/mecha_graveyard)
"aO" = (/obj/structure/grille/broken,/turf/unsimulated/floor/asteroid,/area/vault/mecha_graveyard)
"aP" = (/obj/structure/hanging_lantern{dir = 8},/turf/unsimulated/floor/airless{icon_state = "asteroidfloor"},/area/vault/mecha_graveyard)
"aQ" = (/obj/effect/decal/cleanable/blood/oil,/turf/unsimulated/floor/airless{icon_state = "asteroidfloor"},/area/vault/mecha_graveyard)
"aR" = (/obj/structure/disposalpipe/segment{dir = 4},/obj/item/weapon/broken_pipe_tomahawk,/turf/unsimulated/floor/airless{icon_state = "asteroidwarning"; dir = 4},/area/vault/mecha_graveyard)
"aS" = (/obj/structure/disposalpipe/segment{dir = 4},/turf/unsimulated/floor/asteroid/plating,/area/vault/mecha_graveyard)
"aT" = (/obj/effect/decal/cleanable/blood/gibs/robot/up,/turf/unsimulated/floor/asteroid,/area/vault/mecha_graveyard)
"aU" = (/obj/item/broken_device,/turf/unsimulated/floor/asteroid,/area/vault/mecha_graveyard)
"aV" = (/obj/structure/hanging_lantern{dir = 4},/turf/unsimulated/floor/airless{icon_state = "asteroidwarning"; dir = 9},/area/vault/mecha_graveyard)
"aW" = (/obj/structure/reagent_dispensers/fueltank,/turf/unsimulated/floor/asteroid,/area/vault/mecha_graveyard)
"aX" = (/obj/structure/ore_box,/turf/unsimulated/floor/airless{icon_state = "asteroidwarning"; dir = 8},/area/vault/mecha_graveyard)
"aY" = (/obj/structure/grille,/obj/structure/window/reinforced{dir = 1},/obj/structure/window/reinforced{dir = 4},/obj/structure/window/reinforced{dir = 8},/obj/structure/window/reinforced,/obj/structure/window/full/reinforced,/turf/simulated/floor/plating,/area/vault/mecha_graveyard)
"aZ" = (/obj/effect/decal/remains/human,/turf/simulated/floor/airless{icon_state = "damaged5"},/area/vault/mecha_graveyard)
"ba" = (/obj/effect/decal/mecha_wreckage/graveyard_clarke,/turf/unsimulated/floor/asteroid,/area/vault/mecha_graveyard)
"bb" = (/turf/unsimulated/floor/airless{icon_state = "asteroidplating"},/area/vault/mecha_graveyard)
"bc" = (/obj/effect/decal/cleanable/blood/gibs/robot/limb,/turf/unsimulated/floor/airless{icon_state = "asteroidfloor"},/area/vault/mecha_graveyard)
"bd" = (/obj/item/weapon/broken_bottle,/turf/unsimulated/floor/airless{icon_state = "asteroidwarning"; dir = 8},/area/vault/mecha_graveyard)
"be" = (/obj/machinery/door/airlock/external,/turf/unsimulated/floor/airless{icon_state = "asteroidfloor"},/area/vault/mecha_graveyard)
"bf" = (/obj/item/weapon/screwdriver,/turf/unsimulated/floor/airless{icon_state = "asteroidfloor"},/area/vault/mecha_graveyard)
"bg" = (/obj/machinery/mech_bay_recharge_port,/turf/unsimulated/floor/airless{icon_state = "asteroidfloor"},/area/vault/mecha_graveyard)
"bh" = (/obj/machinery/mech_bay_recharge_floor{icon_state = "recharge_floor_asteroid"},/turf/simulated/floor,/area/vault/mecha_graveyard)
"bi" = (/obj/machinery/computer/mech_bay_power_console,/turf/unsimulated/floor/airless{icon_state = "asteroidfloor"},/area/vault/mecha_graveyard)
"bj" = (/obj/item/clothing/glasses/scanner/meson,/turf/unsimulated/floor/asteroid,/area/vault/mecha_graveyard)
"bk" = (/obj/structure/girder/displaced,/turf/unsimulated/floor/asteroid,/area/vault/mecha_graveyard)
"bl" = (/obj/item/clothing/shoes/galoshes/broken,/turf/unsimulated/floor/airless{icon_state = "asteroidplating"},/area/vault/mecha_graveyard)
"bm" = (/obj/machinery/mineral/unloading_machine,/turf/unsimulated/floor/airless{icon_state = "asteroidfloor"},/area/vault/mecha_graveyard)
"bn" = (/obj/machinery/conveyor{dir = 4; id_tag = "mining_west"},/obj/item/stack/sheet/plasteel,/turf/unsimulated/floor/airless{icon_state = "asteroidfloor"},/area/vault/mecha_graveyard)
"bo" = (/obj/machinery/conveyor{dir = 4; id_tag = "mining_west"},/turf/unsimulated/floor/airless{icon_state = "asteroidfloor"},/area/vault/mecha_graveyard)
"bp" = (/turf/unsimulated/floor/airless{icon_state = "asteroidplating"},/area)
"bq" = (/obj/item/weapon/shard,/turf/unsimulated/floor/airless{icon_state = "asteroidplating"},/area)
"br" = (/obj/item/weapon/shard{icon_state = "small"},/turf/space,/area)
"bs" = (/obj/structure/lattice,/turf/space,/area)
"bt" = (/obj/docking_port/destination/vault/mecha_graveyard{dir = 2},/obj/machinery/door/airlock/external,/turf/unsimulated/floor/airless{icon_state = "asteroidfloor"},/area/vault/mecha_graveyard)
"bu" = (/obj/item/weapon/shard{icon_state = "medium"},/turf/space,/area)
"bv" = (/obj/item/weapon/shard{icon_state = "medium"},/obj/item/weapon/shard,/turf/space,/area)
"bw" = (/turf/space/transit/south,/area)
"bx" = (/obj/structure/lattice,/obj/structure/girder,/turf/space,/area)

(1,1,1) = {"
aaaaaaaaaaaaaaaaaaaaaaaaaaaaaaaaaaaaaaaaaaaaaaaaaaaaaaaaaaaaaaaaaaaaaaaaaaaaabab
aaaaaaaaaaaaaaaaaaaaaaaaaaaaaaaaaaaaaaaaaaaaaaaaaaaaaaaaaaaaaaaaaaaaaaaaaaaaabab
aaaaaaaaaaaaaaaaaaaaaaaaaaaaaaaaaaaaaaaaaaaaaaaaaaaaaaaaaaaaaaaaaaaaaaaaaaababab
acaaaaaaaaaaaaaaaaaaaaaaaaaaaaaaaaaaaaaaaaaaaaaaaaaaaaaaaaaaaaaaaaaaaaaaaaababab
acacaaaaaaaaaaaaaaaaaaaaaaaaaaaaaaaaaaaaaaaaaaaaaaaaaaaaaaaaaaaaaaaaaaababababab
acacacaaaaaaaaaaaaaaaaaaaaaaaaadadadadadadaaaaaaaaaaaaaaaaaaaaaaaaaaaaababababab
acacacaaaaaaaaaaaaaaaaaaaaaaaaadadadadadadadadadadadaaaaaaaaaaaaaaaaabababababab
acacacacacacaaaaadadadadadadadadadadadadadadadadadadadadadaaaaaaaaababababababab
acacacacacacadadadadadadadadadadadadadadadadadadadadadadadadadadadadadababababab
acacacacacadadadadadadadaeaeaeafafafafagagagagadadadadadadadadadadadadababababab
acacacadadadadadadadadadahahaeafafafafagagagagadadadadadadadadadadadabababababab
acacadadadadadadadadadaiafajaeafafafakagagagagagagagagadadadadadadadabababababab
acacadadadadadadadadafafafalamafafakakakakagagagagagagadadadadadadadabababababab
acacadadadadadadafafafanafafafafafaoaoakakakapagagagagagagagadadadadabababababab
acacadadadadadafafafafafafafaiafafakaoakaqakarakakakakakafafadadadadabababababab
acacadadadadadafafahafafafafafafagakararakaoaoakakakarakafafadadadadabababababab
acadadadadadafafafahasafafafafagagagagataraoaoakarakaoalafafadadadadabababababab
acadadadadadauafavaeaeaeawaxayafagagagagarakazakaAakakakakakadadadadabababababab
acadadadadafafawafaBahahahaCafafaDagagagakafakaoakakakakakakadadadadadadabababab
acadadadadaEafajaFahahaGajaCaiafahagagaHafafafaIafafafakagadadadadadadadabababab
acadadadadafaJaKaLahahaMahaCafafafafaNafafafafafafafafagagadadadadadadadabababab
acadadadadadafafaOaeaeaPaQaRaSafaTahaUafaVaeaeaeafafafadadadadadadadadadabababab
acadadadadadadauafaiaDauaWafafaiafahafahaXaYaZbaafadadadadadadadadadadababababab
acacadadadadadadafafafaebbbbbbbbafahafbcbdbeaQbfadadadadadadadadadadadababababab
acacacacadadadadadadadadbbbgbhbiafahafbjaKbkaialadadadadadadadadadadadababababab
acacacacadadadadadadadadbbblbbbbahaTafbmbnbobkafadadadadadadadadadadabababababab
acacacacacacadadadadadadadadaiafahafafafbpbqadbradadadadadadadadadadabababababab
acacacacacacadadadadadadadbsafaeaebtaeaubsbsbuadbvadadadadadadadadababababababab
acacacacacacacacadadadadadbsadadadadadadadbsadbradadadadadadabababababababababab
acacacacacacacacadadadadadbsadadadadadadadbsadadadadadadadadabababababababababab
acacacacacacacacbwbwadadadbsadadadadadadadbxadadadadadadbwbwabababababababababab
acacacacacacacacbwbwadadadbsadadadadadadadbsadadadadbwbwbwbwbwbwabababababababab
acacacacacacacacbwbwadadadbxadadadadadadadbsadadadadbwbwbwbwbwbwabababababababab
acacacacacbwbwbwbwbwadadadbsbsbsbxbsbsbsbsbsadadadadbwbwbwbwbwbwbwbwabababababab
acacacacbwbwbwbwbwbwadadadadadadadadadadadadadadadadbwbwbwbwbwbwbwbwabababababab
acacacacbwbwbwbwbwbwbwadadadadadadadadadadadadadadbwbwbwbwbwbwbwbwbwbwbwabababab
acacbwbwbwbwbwbwbwbwbwadadadadadadadadadadadadbwbwbwbwbwbwbwbwbwbwbwbwbwabababab
acacbwbwbwbwbwbwbwbwbwbwbwbwbwbwbwbwbwbwbwbwbwbwbwbwbwbwbwbwbwbwbwbwbwbwbwbwabab
acacbwbwbwbwbwbwbwbwbwbwbwbwbwbwbwbwbwbwbwbwbwbwbwbwbwbwbwbwbwbwbwbwbwbwbwbwbwab
bwbwbwbwbwbwbwbwbwbwbwbwbwbwbwbwbwbwbwbwbwbwbwbwbwbwbwbwbwbwbwbwbwbwbwbwbwbwbwbw
"}
