"aa" = (/turf/space/transit/east,/area)
"ab" = (/turf/unsimulated/wall/rock,/area/vault/spy_sat/deployment)
"ac" = (/turf/space/transit/south,/area)
"ad" = (/obj/structure/sign/chemtable,/turf/unsimulated/wall/rock,/area/vault/spy_sat/deployment)
"ae" = (/obj/machinery/power/magtape_deck,/obj/structure/cable{icon_state = "0-2"; pixel_y = 1; d2 = 2},/turf/simulated/floor,/area/vault/spy_sat/deployment)
"af" = (/turf/simulated/floor,/area/vault/spy_sat/deployment)
"ag" = (/obj/machinery/portable_atmospherics/canister/air,/turf/simulated/floor,/area/vault/spy_sat/deployment)
"ah" = (/obj/abstract/map/spawner/engi/machinery,/turf/simulated/floor,/area/vault/spy_sat/deployment)
"ai" = (/obj/machinery/vending/medical,/obj/machinery/light{dir = 1},/turf/simulated/floor{icon_state = "white"},/area/vault/spy_sat/deployment)
"aj" = (/obj/structure/bookcase/manuals/medical,/turf/simulated/floor{icon_state = "white"},/area/vault/spy_sat/deployment)
"ak" = (/turf/simulated/floor{icon_state = "white"},/area/vault/spy_sat/deployment)
"al" = (/obj/structure/table/glass,/obj/abstract/map/spawner/medical,/obj/abstract/map/spawner/medical,/obj/item/weapon/gun/syringe/rapidsyringe,/turf/simulated/floor{icon_state = "white"},/area/vault/spy_sat/deployment)
"am" = (/obj/structure/table/glass,/obj/abstract/map/spawner/medical,/obj/abstract/map/spawner/medical,/turf/simulated/floor{icon_state = "white"},/area/vault/spy_sat/deployment)
"an" = (/obj/structure/table/glass,/obj/item/weapon/storage/firstaid/adv,/obj/item/weapon/reagent_containers/glass/beaker/large,/turf/simulated/floor{icon_state = "white"},/area/vault/spy_sat/deployment)
"ao" = (/obj/structure/cable{d1 = 1; d2 = 4; icon_state = "1-4"},/obj/structure/cable{d1 = 2; d2 = 4; icon_state = "2-4"},/obj/machinery/light/small{tag = "icon-lbulb1 (WEST)"; icon_state = "lbulb1"; dir = 8},/turf/simulated/floor,/area/vault/spy_sat/deployment)
"ap" = (/obj/structure/cable{d1 = 4; d2 = 8; icon_state = "4-8"; pixel_x = 0; tag = ""},/obj/structure/cable{d1 = 1; d2 = 4; icon_state = "1-4"},/obj/structure/cable{d1 = 2; d2 = 4; icon_state = "2-4"},/turf/simulated/floor,/area/vault/spy_sat/deployment)
"aq" = (/obj/structure/cable{d1 = 4; d2 = 8; icon_state = "4-8"; pixel_x = 0; tag = ""},/turf/simulated/floor,/area/vault/spy_sat/deployment)
"ar" = (/obj/machinery/door/airlock/vault,/obj/structure/cable{d1 = 4; d2 = 8; icon_state = "4-8"; pixel_x = 0; tag = ""},/obj/structure/window/barricade/full/block,/turf/simulated/floor,/area/vault/spy_sat/deployment)
"as" = (/obj/abstract/map/spawner/engi/dispensers,/obj/structure/cable{d1 = 2; d2 = 8; icon_state = "2-8"; tag = ""},/turf/simulated/floor,/area/vault/spy_sat/deployment)
"at" = (/obj/machinery/vending/engineering,/turf/simulated/floor,/area/vault/spy_sat/deployment)
"au" = (/obj/structure/table/glass,/obj/abstract/map/spawner/medical/pills,/turf/simulated/floor{icon_state = "white"},/area/vault/spy_sat/deployment)
"av" = (/obj/machinery/chem_dispenser,/turf/simulated/floor{icon_state = "white"},/area/vault/spy_sat/deployment)
"aw" = (/obj/machinery/power/magtape_deck,/obj/structure/cable,/turf/simulated/floor,/area/vault/spy_sat/deployment)
"ax" = (/obj/structure/closet/crate/secure/plasma/prefilled,/obj/structure/cable{d1 = 1; d2 = 2; icon_state = "1-2"; tag = ""},/turf/simulated/floor,/area/vault/spy_sat/deployment)
"ay" = (/turf/simulated/floor/engine,/area/vault/spy_sat/deployment)
"az" = (/obj/machinery/vaporizer,/turf/simulated/floor,/area/vault/spy_sat/deployment)
"aA" = (/obj/structure/table/glass,/obj/item/weapon/storage/firstaid/toxin,/turf/simulated/floor{icon_state = "white"},/area/vault/spy_sat/deployment)
"aB" = (/obj/machinery/chem_master,/obj/machinery/light{dir = 4},/turf/simulated/floor{icon_state = "white"},/area/vault/spy_sat/deployment)
"aC" = (/obj/abstract/map/spawner/engi/dispensers,/obj/structure/cable{d1 = 1; d2 = 2; icon_state = "1-2"; tag = ""},/turf/simulated/floor,/area/vault/spy_sat/deployment)
"aD" = (/obj/structure/cable{d1 = 2; d2 = 4; icon_state = "2-4"},/turf/simulated/floor/engine,/area/vault/spy_sat/deployment)
"aE" = (/obj/machinery/power/port_gen/pacman,/obj/structure/cable{d2 = 8; icon_state = "0-8"},/turf/simulated/floor/engine,/area/vault/spy_sat/deployment)
"aF" = (/obj/machinery/light{dir = 4},/turf/simulated/floor,/area/vault/spy_sat/deployment)
"aG" = (/obj/structure/sign/nosmoking_2,/turf/unsimulated/wall/rock,/area/vault/spy_sat/deployment)
"aH" = (/obj/structure/closet/secure_closet/animal,/turf/simulated/floor{icon_state = "white"},/area/vault/spy_sat/deployment)
"aI" = (/obj/machinery/vending/discount,/turf/simulated/floor,/area/vault/spy_sat/deployment)
"aJ" = (/obj/machinery/light{dir = 1},/turf/simulated/floor,/area/vault/spy_sat/deployment)
"aK" = (/obj/machinery/vending/coffee,/turf/simulated/floor,/area/vault/spy_sat/deployment)
"aL" = (/obj/structure/cable{d1 = 1; d2 = 2; icon_state = "1-2"; tag = ""},/turf/simulated/floor,/area/vault/spy_sat/deployment)
"aM" = (/obj/structure/cable{d1 = 1; d2 = 2; icon_state = "1-2"; tag = ""},/obj/structure/cable{d1 = 2; d2 = 4; icon_state = "2-4"},/turf/simulated/floor/engine,/area/vault/spy_sat/deployment)
"aN" = (/obj/structure/sign/directions/medical{tag = "icon-direction_med (NORTH)"; icon_state = "direction_med"; dir = 1},/turf/unsimulated/wall/rock,/area/vault/spy_sat/deployment)
"aO" = (/obj/machinery/door/airlock/glass_medical{id_tag = "MedbayFoyerR"; name = "Medbay"; req_access_txt = "5"},/turf/simulated/floor{icon_state = "white"},/area/vault/spy_sat/deployment)
"aP" = (/obj/machinery/power/battery/smes/vault_listening,/obj/structure/cable{icon_state = "0-2"; pixel_y = 1; d2 = 2},/obj/structure/cable,/obj/machinery/light{dir = 8},/turf/simulated/floor,/area/vault/spy_sat/deployment)
"aQ" = (/obj/machinery/power/terminal{dir = 8},/obj/structure/cable{icon_state = "0-4"; d2 = 4},/turf/simulated/floor,/area/vault/spy_sat/deployment)
"aR" = (/obj/structure/cable{d1 = 1; d2 = 8; icon_state = "1-8"},/turf/simulated/floor,/area/vault/spy_sat/deployment)
"aS" = (/obj/machinery/vending/tool,/turf/simulated/floor,/area/vault/spy_sat/deployment)
"aT" = (/obj/structure/sign/vacuum,/turf/unsimulated/wall/rock,/area/vault/spy_sat/deployment)
"aU" = (/obj/machinery/access_button/satelite_deployment,/turf/unsimulated/wall/rock,/area/vault/spy_sat/deployment)
"aV" = (/obj/machinery/light/small{tag = "icon-lbulb1 (WEST)"; icon_state = "lbulb1"; dir = 8},/turf/simulated/floor,/area/vault/spy_sat/deployment)
"aW" = (/obj/machinery/door/airlock,/turf/simulated/floor,/area/vault/spy_sat/deployment)
"aX" = (/obj/machinery/power/apc{dir = 8; pixel_x = -24},/obj/machinery/power/terminal{dir = 8},/obj/structure/cable,/turf/simulated/floor,/area/vault/spy_sat/deployment)
"aY" = (/obj/effect/decal/cleanable/ash,/turf/simulated/floor,/area/vault/spy_sat/deployment)
"aZ" = (/obj/machinery/door/poddoor/preopen/satelite_deployment,/turf/simulated/floor/airless,/area/vault/spy_sat/deployment)
"ba" = (/obj/machinery/light{dir = 1},/turf/simulated/floor/airless,/area/vault/spy_sat/deployment)
"bb" = (/turf/simulated/floor/airless,/area/vault/spy_sat/deployment)
"bc" = (/obj/machinery/door/poddoor,/turf/simulated/floor,/area/vault/spy_sat/deployment)
"bd" = (/obj/structure/sign/directions/engineering{tag = "icon-direction_eng (EAST)"; icon_state = "direction_eng"; dir = 4},/turf/unsimulated/wall/rock,/area/vault/spy_sat/deployment)
"be" = (/obj/machinery/door/airlock/engineering,/turf/simulated/floor,/area/vault/spy_sat/deployment)
"bf" = (/obj/structure/table/reinforced,/obj/abstract/map/spawner/engi,/turf/simulated/floor,/area/vault/spy_sat/deployment)
"bg" = (/obj/structure/table/reinforced,/obj/abstract/map/spawner/engi,/obj/item/weapon/storage/toolbox/syndicate,/turf/simulated/floor,/area/vault/spy_sat/deployment)
"bh" = (/obj/structure/table/reinforced,/obj/abstract/map/spawner/engi/materials,/turf/simulated/floor,/area/vault/spy_sat/deployment)
"bi" = (/obj/structure/table/reinforced,/obj/abstract/map/spawner/engi/materials,/obj/item/weapon/storage/box/inflatables,/turf/simulated/floor,/area/vault/spy_sat/deployment)
"bj" = (/turf/space/transit/west,/area)
"bk" = (/obj/item/weapon/cigbutt,/turf/simulated/floor/airless,/area/vault/spy_sat/deployment)
"bl" = (/obj/structure/spacepod_frame/unarmored,/turf/simulated/floor/airless,/area/vault/spy_sat/deployment)
"bm" = (/obj/structure/painting/random,/turf/unsimulated/wall/rock,/area/vault/spy_sat/deployment)
"bn" = (/obj/machinery/light/small{tag = "icon-lbulb1 (EAST)"; icon_state = "lbulb1"; dir = 4},/turf/simulated/floor,/area/vault/spy_sat/deployment)
"bo" = (/obj/effect/landmark/corpse/engineer,/turf/simulated/floor/airless,/area/vault/spy_sat/deployment)
"bp" = (/turf/space/transit/north,/area)
"bq" = (/obj/item/weapon/storage/fancy/cigarettes,/turf/simulated/floor/airless,/area/vault/spy_sat/deployment)
"br" = (/obj/structure/punching_bag/captain,/obj/structure/window/reinforced{dir = 1},/turf/simulated/floor{icon_state = "dark vault stripe"; dir = 4},/area/vault/spy_sat/deployment)
"bs" = (/obj/structure/window/reinforced{dir = 1},/turf/simulated/floor{icon_state = "dark vault full"},/area/vault/spy_sat/deployment)
"bt" = (/obj/structure/window/reinforced{dir = 1},/turf/simulated/floor{dir = 8; icon_state = "barber"},/area/vault/spy_sat/deployment)
"bu" = (/obj/machinery/washing_machine,/obj/structure/window/reinforced{dir = 1},/turf/simulated/floor{dir = 8; icon_state = "barber"},/area/vault/spy_sat/deployment)
"bv" = (/obj/structure/mopbucket,/turf/simulated/floor,/area/vault/spy_sat/deployment)
"bw" = (/obj/machinery/light/small{tag = "icon-lbulb1 (NORTH)"; icon_state = "lbulb1"; dir = 1},/turf/simulated/floor,/area/vault/spy_sat/deployment)
"bx" = (/obj/structure/closet/l3closet/janitor,/obj/item/weapon/storage/box/nt_disguise_kit,/obj/item/weapon/storage/box/lights/mixed,/turf/simulated/floor,/area/vault/spy_sat/deployment)
"by" = (/obj/structure/punching_bag/clown,/turf/simulated/floor{icon_state = "dark vault stripe"; dir = 4},/area/vault/spy_sat/deployment)
"bz" = (/turf/simulated/floor{icon_state = "dark vault full"},/area/vault/spy_sat/deployment)
"bA" = (/turf/simulated/floor{dir = 8; icon_state = "barber"},/area/vault/spy_sat/deployment)
"bB" = (/obj/machinery/washing_machine,/turf/simulated/floor{dir = 8; icon_state = "barber"},/area/vault/spy_sat/deployment)
"bC" = (/obj/machinery/cooking/deepfryer,/turf/simulated/floor{icon_state = "freezerfloor"},/area/vault/spy_sat/deployment)
"bD" = (/obj/item/pod_parts/armor/taxi,/obj/structure/table/reinforced,/obj/machinery/light{dir = 8},/turf/simulated/floor,/area/vault/spy_sat/deployment)
"bE" = (/mob/living/simple_animal/hostile/humanoid/janitor,/turf/simulated/floor,/area/vault/spy_sat/deployment)
"bF" = (/obj/item/weapon/reagent_containers/glass/bucket,/obj/structure/table,/obj/item/weapon/mop,/turf/simulated/floor,/area/vault/spy_sat/deployment)
"bG" = (/obj/item/weapon/reagent_containers/food/snacks/stew,/turf/simulated/floor{icon_state = "freezerfloor"},/area/vault/spy_sat/deployment)
"bH" = (/turf/simulated/floor{icon_state = "freezerfloor"},/area/vault/spy_sat/deployment)
"bI" = (/obj/structure/table,/obj/item/weapon/reagent_containers/food/snacks/sliceable/meatbread,/turf/simulated/floor{icon_state = "freezerfloor"},/area/vault/spy_sat/deployment)
"bJ" = (/obj/item/pod_parts/core,/obj/structure/table/reinforced,/turf/simulated/floor,/area/vault/spy_sat/deployment)
"bK" = (/obj/structure/reagent_dispensers/watertank,/obj/item/weapon/paper_bin,/turf/simulated/floor,/area/vault/spy_sat/deployment)
"bL" = (/turf/simulated/floor/wood,/area/vault/spy_sat/deployment)
"bM" = (/obj/item/weapon/gun/projectile/pistol,/turf/simulated/floor/wood,/area/vault/spy_sat/deployment)
"bN" = (/obj/machinery/vending/autodrobe,/turf/simulated/floor/wood,/area/vault/spy_sat/deployment)
"bO" = (/obj/machinery/light{dir = 8},/turf/simulated/floor{icon_state = "freezerfloor"},/area/vault/spy_sat/deployment)
"bP" = (/obj/structure/table,/obj/item/weapon/reagent_containers/food/snacks/soylenviridians,/turf/simulated/floor{icon_state = "freezerfloor"},/area/vault/spy_sat/deployment)
"bQ" = (/obj/structure/table/reinforced,/obj/abstract/map/spawner/engi/materials,/obj/item/weapon/circuitboard/mecha/pod,/turf/simulated/floor,/area/vault/spy_sat/deployment)
"bR" = (/obj/machinery/r_n_d/fabricator/pod,/turf/simulated/floor,/area/vault/spy_sat/deployment)
"bS" = (/obj/structure/rack,/obj/item/weapon/storage/toolbox/electrical,/obj/item/weapon/storage/toolbox/syndicate,/obj/item/clothing/glasses/welding,/obj/machinery/light,/turf/simulated/floor,/area/vault/spy_sat/deployment)
"bT" = (/obj/item/weapon/reagent_containers/food/snacks/plumphelmetbiscuit,/turf/simulated/floor,/area/vault/spy_sat/deployment)
"bU" = (/obj/structure/noticeboard,/obj/item/weapon/paper/satelite_deployment/space_saving,/obj/item/weapon/paper/satelite_deployment/no_smoking,/obj/item/weapon/paper/satelite_deployment/complaints,/obj/item/weapon/paper/satelite_deployment/complaints_reply,/obj/item/weapon/paper/satelite_deployment/further_complaints,/turf/unsimulated/wall/rock,/area/vault/spy_sat/deployment)
"bV" = (/turf/simulated/floor/carpet,/area/vault/spy_sat/deployment)
"bW" = (/obj/machinery/door/airlock,/turf/simulated/floor{icon_state = "freezerfloor"},/area/vault/spy_sat/deployment)
"bX" = (/obj/structure/table,/obj/item/weapon/reagent_containers/food/snacks/sundae,/turf/simulated/floor{icon_state = "freezerfloor"},/area/vault/spy_sat/deployment)
"bY" = (/obj/machinery/vending/groans,/turf/simulated/floor,/area/vault/spy_sat/deployment)
"bZ" = (/obj/machinery/light{dir = 8},/turf/simulated/floor/wood,/area/vault/spy_sat/deployment)
"ca" = (/obj/structure/bed/chair{tag = "icon-chair (EAST)"; icon_state = "chair"; dir = 4},/mob/living/simple_animal/hostile/humanoid/pilot,/turf/simulated/floor/carpet,/area/vault/spy_sat/deployment)
"cb" = (/obj/structure/table/glass,/obj/item/weapon/reagent_containers/food/drinks/drinkingglass/cola,/turf/simulated/floor/carpet,/area/vault/spy_sat/deployment)
"cc" = (/obj/structure/table/glass,/obj/item/weapon/reagent_containers/food/snacks/poissoncru,/turf/simulated/floor/carpet,/area/vault/spy_sat/deployment)
"cd" = (/obj/structure/bed/chair{tag = "icon-chair (WEST)"; icon_state = "chair"; dir = 8},/turf/simulated/floor/carpet,/area/vault/spy_sat/deployment)
"ce" = (/obj/structure/table,/obj/item/weapon/storage/box/donkpockets/random_amount,/turf/simulated/floor{icon_state = "freezerfloor"},/area/vault/spy_sat/deployment)
"cf" = (/obj/structure/table,/obj/item/weapon/kitchen/utensil/knife/large/butch,/turf/simulated/floor{icon_state = "freezerfloor"},/area/vault/spy_sat/deployment)
"cg" = (/obj/machinery/chem_dispenser/soda_dispenser/mapping,/obj/structure/table/glass,/turf/simulated/floor,/area/vault/spy_sat/deployment)
"ch" = (/obj/structure/bed/chair{tag = "icon-chair (EAST)"; icon_state = "chair"; dir = 4},/turf/simulated/floor/carpet,/area/vault/spy_sat/deployment)
"ci" = (/obj/structure/table/glass,/turf/simulated/floor/carpet,/area/vault/spy_sat/deployment)
"cj" = (/obj/structure/table/glass,/obj/item/weapon/reagent_containers/food/snacks/syndicake,/turf/simulated/floor/carpet,/area/vault/spy_sat/deployment)
"ck" = (/obj/structure/table,/obj/machinery/microwave,/turf/simulated/floor{icon_state = "freezerfloor"},/area/vault/spy_sat/deployment)
"cl" = (/obj/structure/table,/obj/item/weapon/reagent_containers/food/snacks/sliceable/turkey,/turf/simulated/floor{icon_state = "freezerfloor"},/area/vault/spy_sat/deployment)
"cm" = (/obj/structure/table/glass,/obj/item/weapon/reagent_containers/food/drinks/drinkingglass,/obj/item/weapon/reagent_containers/food/drinks/drinkingglass,/turf/simulated/floor,/area/vault/spy_sat/deployment)
"cn" = (/obj/machinery/door/airlock,/turf/simulated/floor/wood,/area/vault/spy_sat/deployment)
"co" = (/obj/structure/table/glass,/obj/item/weapon/reagent_containers/food/snacks/risotto,/turf/simulated/floor/carpet,/area/vault/spy_sat/deployment)
"cp" = (/obj/structure/table,/turf/simulated/floor{icon_state = "freezerfloor"},/area/vault/spy_sat/deployment)
"cq" = (/obj/machinery/light{dir = 4},/turf/simulated/floor{icon_state = "freezerfloor"},/area/vault/spy_sat/deployment)
"cr" = (/obj/machinery/vending/cigarette,/turf/simulated/floor,/area/vault/spy_sat/deployment)
"cs" = (/obj/structure/table/glass,/obj/item/ashtray/plastic,/turf/simulated/floor/carpet,/area/vault/spy_sat/deployment)
"ct" = (/obj/structure/bed/chair{tag = "icon-chair (WEST)"; icon_state = "chair"; dir = 8},/mob/living/simple_animal/hostile/humanoid/pilot,/turf/simulated/floor/carpet,/area/vault/spy_sat/deployment)
"cu" = (/obj/machinery/vending/dinnerware,/turf/simulated/floor{icon_state = "freezerfloor"},/area/vault/spy_sat/deployment)
"cv" = (/obj/machinery/light,/turf/simulated/floor,/area/vault/spy_sat/deployment)
"cw" = (/obj/structure/window/reinforced{dir = 8},/obj/structure/dispenser/oxygen,/turf/simulated/floor,/area/vault/spy_sat/deployment)
"cx" = (/obj/structure/window/reinforced{dir = 4},/obj/machinery/suit_storage_unit,/turf/simulated/floor,/area/vault/spy_sat/deployment)
"cy" = (/obj/machinery/door/airlock/freezer,/turf/simulated/floor,/area/vault/spy_sat/deployment)
"cz" = (/obj/machinery/door/airlock/external,/turf/simulated/floor,/area/vault/spy_sat/deployment)
"cA" = (/obj/structure/reagent_dispensers/water_cooler,/turf/simulated/floor/wood,/area/vault/spy_sat/deployment)
"cB" = (/obj/structure/table,/obj/item/weapon/reagent_containers/food/snacks/sliceable/cheesewheel,/turf/simulated/floor,/area/vault/spy_sat/deployment)
"cC" = (/obj/structure/closet/secure_closet/freezer/meat,/turf/simulated/floor,/area/vault/spy_sat/deployment)
"cD" = (/obj/machinery/shower{dir = 4},/turf/simulated/floor,/area/vault/spy_sat/deployment)
"cE" = (/obj/structure/closet/walllocker/emerglocker/east,/obj/machinery/light{dir = 1},/turf/simulated/floor,/area/vault/spy_sat/deployment)
"cF" = (/obj/structure/table/holotable/wood,/obj/item/weapon/reagent_containers/glass/kettle/red,/turf/simulated/floor/wood,/area/vault/spy_sat/deployment)
"cG" = (/obj/structure/table/holotable/wood,/obj/machinery/chem_dispenser/brewer/mapping,/turf/simulated/floor/wood,/area/vault/spy_sat/deployment)
"cH" = (/obj/structure/table/holotable/wood,/obj/item/weapon/reagent_containers/food/drinks/tea,/obj/item/weapon/storage/box/mugs,/obj/machinery/light,/turf/simulated/floor/wood,/area/vault/spy_sat/deployment)
"cI" = (/obj/structure/table,/obj/item/weapon/reagent_containers/food/snacks/sliceable/fruitcake,/obj/machinery/light{dir = 8},/turf/simulated/floor,/area/vault/spy_sat/deployment)
"cJ" = (/mob/living/simple_animal/hostile/humanoid/chef,/turf/simulated/floor,/area/vault/spy_sat/deployment)
"cK" = (/obj/structure/closet/secure_closet/freezer/kitchen/mining,/turf/simulated/floor,/area/vault/spy_sat/deployment)
"cL" = (/obj/item/weapon/storage/firstaid/o2,/obj/structure/table/reinforced,/turf/simulated/floor,/area/vault/spy_sat/deployment)
"cM" = (/obj/structure/reagent_dispensers/beerkeg,/turf/simulated/floor,/area/vault/spy_sat/deployment)
"cN" = (/obj/item/weapon/reagent_containers/food/snacks/sweet/strange,/turf/simulated/floor,/area/vault/spy_sat/deployment)
"cO" = (/obj/structure/closet/secure_closet/freezer/fridge,/turf/simulated/floor,/area/vault/spy_sat/deployment)
"cP" = (/obj/docking_port/destination/vault/satelite_deployment{tag = "icon-docking_station"; icon_state = "docking_station"; dir = 2},/obj/machinery/door/airlock/external,/turf/simulated/floor,/area/vault/spy_sat/deployment)

(1,1,1) = {"
aaaaaaaaaaaaaaaaaaaaaaaaaaaaaaaaaaaaaaaaaaaaaaaaaaaaaaaaaaaaaaaaaaaaaaaaaaaaaaaa
aaaaaaaaaaaaaaaaaaaaaaaaaaaaaaaaaaaaaaaaaaaaaaaaaaaaaaaaaaaaaaaaaaaaaaaaaaaaaaaa
aaaaaaaaaaaaaaaaaaaaaaaaaaaaaaaaaaaaaaaaaaaaaaaaaaaaaaaaaaaaaaaaaaaaaaaaaaaaaaaa
aaaaaaaaaaaaaaaaaaaaaaaaaaaaaaaaaaaaaaaaaaaaaaaaaaaaaaaaaaaaaaaaaaaaaaaaaaaaaaaa
aaaaaaaaaaaaaaaaaaaaaaaaaaaaaaaaaaaaaaaaaaaaaaaaaaaaaaaaaaaaaaaaaaaaaaaaaaaaaaaa
aaaaaaaaaaaaaaaaaaaaaaaaaaaaaaaaaaaaaaaaaaaaaaaaaaaaaaaaabababababacaaaaaaaaaaaa
aaaaaaaaaaaaaaaaaaaaaaaaaaaaaaaaaaaaaaaaaaabababababababababababababacaaaaaaaaaa
aaaaaaaaaaaaaaaaaaaaaaaaaaaaaaaaaaaaaaababababababababababababababababacaaaaaaaa
aaaaaaaaaaaaaaaaaaaaaaaaaaabababababababababababababababababababababababacaaaaaa
aaaaaaaaaaaaaaaaaaaaabababababadababababababaeaeaeaeafababagagahahahababacaaaaaa
aaaaaaaaaaaaaaaaaaababababaiajakalamanabababaoapapapaqarasafafafafafatabacaaaaaa
aaaaaaaaaaaaaaaaaaabababauakakakakakakavababawawawawafabaxafafafayafazababacaaaa
aaaaaaaaaaaaaaaaababababaAakakakakakakaBababababababababaCafafaDaEayaFababacaaaa
aaaaaaaaaaabababababababaGakakakaHakakababaIaJafaKababaGaLafafaMaEayafabababacaa
aaaaaaaaabababababababababababababaNaOabafafafafafafababaPaQaqaRayafaSabababacaa
aaaaaaababaTabababababababaUaTababaVafaWafafafafafafababaXafafafafafaYabababacaa
aaaaaaaZaZbabbbbbbbbbabbbcafaJafaWafababafafafafafafbdabbeabafbfbgbhbiababbjacaa
aaaaaaaZaZbbbbbbbbbkblbbbcafafafabababbmafafafafafafbeafbnababababababababacaaaa
aaaaaaaZaZbbbbbbbbbbbobbbcabababababababafafafafafaFabababababababababababbpaaaa
aaaaaaaZaZbbbbbbbqbbbbbbaGababababaGabababbrbsafbtbuabababababababababababbjbpaa
aaaaaaababbcbcbcbcbcbcbcababababbvbwbxababbybzafbAbBababababbCbCababababababbpaa
aaaaabababbDafafafafafafaWaJafaWafbEbFababababaWababaGababbGbHbHbIabababababbpaa
aaaaabababbJafafafafafafabafabababbKababababbLbLbLbLbMbNabbObHbHbPaGababababbpaa
aaaaababababbQbRbSbRbTabaGaWabababababababbUbLbLbVbVbLbLbWbHbHbHbXabababababbpaa
aaaaababababababababababafafafaJafbYababababbZcacbcccdbLabcebHbHcfabababababbpaa
aaaaabababababababababcgafafafafafafafafafabbLchcicjcdbLabckbHbHclabababababbpaa
aaaaabababababababababcmafafafafafafafafafcnbLchcocicdbLabcpbHbHcqabababababbpaa
aaaaaaababababababababcrafafafafafafafafaFabbLchcicsctbLabckbHbHcuabababababbpaa
aaaaaaabababababababababafcvcwafcxafafabababbLbLbVbVbLbLabababcyabababababbpaaaa
aaaaaaababababababababababababczabababababaGbLbLbLbLbLcAabcBafafcCababababbpaaaa
aaaaaaabababababababababababcDafcEababababababcFcGcHabababcIafcJcKaGababbpaaaaaa
aaaaaaabababababababababababcDafcLababababababababababababcMcNcOabababbpaaaaaaaa
aaaaaaaaabababababababababababcPabababababababababababababababababbpaaaaaaaaaaaa
aaaaaaaaababbpaaaaaaaaaaaaaaaaaaaaaaaaaaaaaaaaabababbpaaaaaaaaaaaaaaaaaaaaaaaaaa
aaaaaaaaababbpaaaaaaaaaaaaaaaaaaaaaaaaaaaaaaaaababbpaaaaaaaaaaaaaaaaaaaaaaaaaaaa
aaaaaaaaaaabbpaaaaaaaaaaaaaaaaaaaaaaaaaaaaaaaaabbpaaaaaaaaaaaaaaaaaaaaaaaaaaaaaa
aaaaaaaaaaaaaaaaaaaaaaaaaaaaaaaaaaaaaaaaaaaaababbpaaaaaaaaaaaaaaaaaaaaaaaaaaaaaa
aaaaaaaaaaaaaaaaaaaaaaaaaaaaaaaaaaaaaaaaaaaaabbpaaaaaaaaaaaaaaaaaaaaaaaaaaaaaaaa
aaaaaaaaaaaaaaaaaaaaaaaaaaaaaaaaaaaaaaaaaaaaaaaaaaaaaaaaaaaaaaaaaaaaaaaaaaaaaaaa
aaaaaaaaaaaaaaaaaaaaaaaaaaaaaaaaaaaaaaaaaaaaaaaaaaaaaaaaaaaaaaaaaaaaaaaaaaaaaaaa
"}
