"a" = (/turf/unsimulated/wall,/area)
"b" = (/turf/simulated/floor{icon_state = "pattern_red"},/area)
"c" = (/obj/structure/sokoban_teleporter,/turf/simulated/floor{icon_state = "pattern_red"},/area)
"d" = (/obj/structure/closet/crate/sokoban,/turf/simulated/floor{icon_state = "pattern_red"},/area)
"e" = (/turf/space,/area)
"f" = (/obj/structure/lattice,/turf/unsimulated/wall,/area)
"g" = (/turf/unsimulated/wall/fakeglass{icon_state = "fakewindows"; dir = 1},/area)
"h" = (/turf/unsimulated/wall/fakeglass{icon_state = "fakewindows2"},/area)
"i" = (/turf/unsimulated/wall/fakeglass,/area)
"j" = (/obj/structure/ladder/sokoban/exit,/obj/machinery/light/small{icon_state = "lbulb1"; dir = 1},/turf/simulated/floor,/area)
"k" = (/obj/machinery/door/airlock/command{name = "Office"},/turf/simulated/floor{icon_state = "pattern_red"},/area)
"l" = (/turf/unsimulated/mineral,/area)
"m" = (/obj/structure/ladder/sokoban/entrance,/turf/simulated/floor{icon_state = "pattern_red"},/area)
"n" = (/obj/structure/ladder/sokoban/exit,/turf/simulated/floor{icon_state = "pattern_red"},/area)
"o" = (/turf/unsimulated/wall/bomberman,/area)
"p" = (/obj/structure/ladder/sokoban/entrance,/turf/simulated/floor,/area)
"q" = (/turf/simulated/floor,/area)
"r" = (/obj/structure/sokoban_teleporter,/turf/simulated/floor,/area)
"s" = (/turf/simulated/shuttle/wall{icon_state = "swall3"},/area)
"t" = (/obj/structure/closet/crate/sokoban,/turf/simulated/floor,/area)
"u" = (/obj/structure/sokoban_teleporter,/obj/machinery/light{icon_state = "ltube1"; dir = 8},/turf/simulated/floor,/area)
"v" = (/obj/machinery/light{icon_state = "ltube1"; dir = 8},/turf/simulated/floor,/area)
"w" = (/obj/structure/closet/crate/sokoban,/obj/machinery/light{icon_state = "ltube1"; dir = 4},/turf/simulated/floor,/area)
"x" = (/obj/machinery/light,/turf/simulated/floor,/area)
"y" = (/turf/unsimulated/wall/bomberman{color = "#FFCCCC"},/area)
"z" = (/turf/unsimulated/wall/bomberman{color = "#FFFFCC"},/area)
"A" = (/turf/unsimulated/wall/bomberman{color = "#DDDDFF"},/area)
"B" = (/turf/unsimulated/wall/bomberman{color = "#FFDDFF"},/area)
"C" = (/turf/simulated/floor{icon_state = "pattern_blue"},/area)
"D" = (/obj/structure/closet/crate/sokoban,/turf/simulated/floor{icon_state = "pattern_blue"},/area)
"E" = (/obj/structure/ladder/sokoban/exit,/turf/simulated/floor{icon_state = "pattern_blue"},/area)
"F" = (/obj/structure/ladder/sokoban/entrance,/turf/simulated/floor{icon_state = "pattern_blue"},/area)
"G" = (/obj/structure/sokoban_teleporter,/turf/simulated/floor{icon_state = "pattern_blue"},/area)
"H" = (/turf/simulated/floor{icon_state = "pattern_yellow"},/area)
"I" = (/obj/structure/closet/crate/sokoban,/turf/simulated/floor{icon_state = "pattern_yellow"},/area)
"J" = (/obj/structure/ladder/sokoban/entrance,/turf/simulated/floor{icon_state = "pattern_yellow"},/area)
"K" = (/obj/structure/ladder/sokoban/exit,/turf/simulated/floor{icon_state = "pattern_yellow"},/area)
"L" = (/obj/structure/sokoban_teleporter,/turf/simulated/floor{icon_state = "pattern_yellow"},/area)
"M" = (/turf/simulated/floor{icon_state = "whitebluefull"},/area)
"N" = (/obj/structure/sokoban_teleporter,/turf/simulated/floor{icon_state = "whitebluefull"},/area)
"O" = (/turf/unsimulated/wall/bomberman{color = "#CCFFFF"},/area)
"P" = (/obj/structure/closet/crate/sokoban,/turf/simulated/floor{icon_state = "whitebluefull"},/area)
"Q" = (/obj/structure/ladder/sokoban/entrance,/turf/simulated/floor{icon_state = "whitebluefull"},/area)

(1,1,1) = {"
aaaaaaaaaaaaaaaaaaaaaaaaaaaaaaaaaaaaaaaaaaaaaaaaaaaaaaaaaaaaaaaaaaaaaaaaaaaaaaaaaaaaaaaaaaaaaaaaaaaaaaaaaaaaaaaaeeeeeeee
aaaaaaaaaaaaaaaaaaaaaaaaaaaaaaaaaaaaaaaaaaaaaaaaaaaaaaaaaaaaaaaaaaaaaaaaaaaaaaaaaaaaaaaaaaaaaaaaaaaaaaaaaaaaaaaaeeeeeeee
aaaaaaaaaaaaaaaaaaaaaaaaaaaaaaaaaaaaaaaaaaaaaaaaaaaaaaaaaaaaaaaaaaaaaaaaaaaaaaaaaaaaaaaaaaaaaaaaaaaaaaaaaaaaaaaaeeeeeeee
aaaaazzzzzzzzzzzzzzzzzzzzzzzzzzzzzzaaaaaaaaaaaaaaaaaaaaaaaaaaaaaaaaaaaaaaaaaaaaaaaaaaaaaaaaaaaaaaaaaaaaaaaaaaaaaeeeeeeee
aaaaazHHHHzHHHHzzzzzzzzzzHHHHHHHHHzaaaaaaaaaaaaaayyyyyyyyyyyyyyyyyyyyaaaaaaaaaaaaaaaaaaaaaaaaaaaaaaaaaaaaaaaaaaaeeeeeeee
aaaaazHHIIzIIHHJzzzzzzzzzHHHHHHHHHzaaaaaaaaaaaaaaybbbbbbbbybbbybbbbbyaaaaaaaaaaaaaaaaaaaaaaaaaaaaaaaaaaaaaaaaaaaeeeeeeee
aaaaazHHHHHIHHHzzzzzzzzzzHHHHHHHHHzaaaaaaaaaaaaaaybddbbyddybybybbbbbyaaaaaaaaaaaaaaaaaaaaaaaaaaaaaaaaaaaaaaaaaaaeeeeeeee
aaaaazHHHHzHHHHzzzzzzzzzzHHHHKHHHHzaaaaaaaaaaaaaaybbybdbdbyddbybbbbbyaaaaaaaaaaaaaaaaaaaaaaaaaaaaaaaaaaaaaaaaaaaeeeeeeee
aaaaazzHzzzzzzzzzzzzzzzzzHHHHHHHHHzaaaaaaaaaaaaaayybybbybbybybybbnbbyaaaaaaaaaaaaaaaaaaaaaaaaaaaaaaaaaaaaaaaaaaaeeeeeeee
aaaaazHHIHzHHHHHzzzzzzzzzHHHHHHHHHzaaaaaaaaaaaaaaybbbyybbbbbbbybbbbbyaaaaaaaaaaaaaaaaaaaaaaaaaaaaaaaaaaaaaaaaaaaeeeeeeee
aaaaazHIIHzIHIHIzzzzzzzzzHHHHHHHHHzaaaaaaaaaaaaaaybbbybdbybbbyybbbbbyaaaaaaaaaaaaaaaaaaaaaaaaaaaaaaaaaaaaaaaaaaaeeeeeeee
aaaaazHHIHHHHHIHzzzzzzzzzHHHHHHHHHzaaaaaaaaaaaaaaybdbydbybbbyyybbbbbyaaaaaaaaaaaaaaaaaaaaaaaaaaaaaaaaaaaaaaaaaaaeeeeeeee
aaaaazHIIIzIHHIHzzzzzzzzzzzzzzzzzHzaaaaaaaaaaaaaayydbybbyyyyyyyyyyybyaaaaaaaaaaaaaaaaaaaaaaaaaaaaaaaaaaaaaaaaaaaeeeeeeee
aaaaazHHHHzHHIHIHLLLLLLLLLLLLLLLLHzaaaaaaaaaaaaaaybbdbbbbccccccccccbyaaaaaaaaaaaaaaaaaaaaaaaaaaaaaaaaaaaaaaaaaaaeeeeeeee
aaaaazzzzzzzzzzzzzzzzzzzzzzzzzzzzzzaaaaaaaaaaaaaaybbbybmyyyyyyyyyyyyyaaaaaaaaaaaaaaaaaaaaaaaaaaaaaaaaaaaaaaaaaaaeeeeeeee
aaaaaaaaaaaaaaaaaaaaaaaaaaaaaaaaaaaaaaaaaaaaaaaaayyyyyyyyyyyyyyyyyyyyaaaaaaaaaaaaaaaaaaaaaaaaaaaaaaaaaaaaaaaaaaaeeeeeeee
aaaaaaaaaaaaaaaaaaaaaaaaaaaaaaaaaaaaaaaaaaaaaaaaaaaaaaaaaaaaaaaaaaaaaaaaaaaaaaaaaaaaaaaaaaaaaaaaaaaaaaaaaaaaaaaaeeeeeeee
aaaaaaaaaaaaaaaaaaaaaaaaaaaaaaaaaaaaaaaaaaaaaaaaaaaaaaaaaaaaaaaaaaaaOOOOOOOOOOOOOOOOOOOOOOOaaaaaaaaaaaaaaaaaaaaaeeeeeeee
aaaaaaaaaaaaaaaaaaaaaaaaaaaaaaaaaaaaaaaaaaaaaaaaaaaaaaaaaaaaaaaaaaaaOQMMMMMMNNNNNNNNNNNNNNNNMaaaaaaaaaaaaaaaaaaaeeeeeeee
aaaaaaaaaaaaaaaaaaaaaaaaaaaaaaaaaaAAAAAAAAAAAAAAAAAAAAaaaaaaaaaaaaaaOMMMMMMMOOOOOOOOOOOOOOaaMaaaaaaaaaaaaaaaaaaaeeeeeeee
ayyyyyyyyyyyyyyyyyyyyyyyyyyaaaaaaaAAACACCCCAAAAAAAAAAAaaaaaaaaaaaaaaOOOOOOOMOOOOOOOOOOOOOaaaMaaaaaaaaaaaaaaaaaaaeeeeeeee
ayybmyyyyyyyyyyyybbbbbbbbbyaaaaaaaACCCDCCCCAAAAAAAAAAAaaaaaaaaaaaaaaOOMMMMMMMMMMMOOOOOOOaaaaMaaaaaaaaaaaaaaaaaaaeeeeeeee
aybbbbbbbbbbyyyyybbbbbbbbbyaaaaaaaACACDDADDACACCCCCCCAaaaaaaaaaaaaaaOOMPMPMPMPMPMOOOOOOaaaaaMaaaaaaaaaaaaaaaaaaaeeeeeeee
aybdyyyyydybyyyyybbbbbbbbbyaaaaaaaACDDACCCCCCACCCCCCCAaaaaaaaaaaaaaaOOOOOOOOMOOOOOOOOOaaaaaaMaaaaaaaaaaaaaaaaaaaeeeeeeee
aybbybbbybdbyyyyybbbbbbbbbyaaaaaaaACACCDCACCCACCCCCCCAaaaaaaaaaaaaaaOMMMPMPMMPMPMOOOOaaaaaaaMaaaaaaaaaaaaaaaaaaaeeeeeeee
aybdbdbbbbdyyyyyybbbbnbbbbyaaaaaaaACCCCADAADAACCCECCCAaaaaaaaaaaaaaaOMMMPMMMMMMMMOOOaaaaaaaaMaaaaaaaaaaaaaaaaaaaeeeeeeee
aybdbbdbbybbyyyyybbbbbbbbbyaaaaaaaACCDDCCDCCCACCCCCCCAaaaaaaaaaaaaaaOOOOOMOOOOOOOOOaaaaaaaaaMaaaaaaaaaaaaaaaaaaaeeeeeeee
aybyyyydbyybyyyyybbbbbbbbbyaaaaaaaACAACCCACCCACCCCCCCAaaaaaaaaaaaaaaOOMMPMPMPMMMOOaaMMMMMMMaMaaaaaaaaaaaaaaaaaaaeeeeeeee
aybbdbbbdbybyyyyybbbbbbbbbyaaaaaaaACCCCADAAAAACCCCCCCAaaaaaaaaaaaaaaOOMMMMMPMMMMOaaaMMMMMMMaMaaaaaaaaaaaaaaaaaaaeeeeeeee
aybyyydybbbdbyyyyyyyyyyyybyaaaaaaaAAACCDCAAAAAAAAAAACAaaaaaaaaaaaaaaOOMPMPMMMPMOOaaaMMMMMMMaMaaaaaaaaaaaaaaaaaaaeeeeeeee
aybbbybbdybdbccccccccccccbyaaaaaaaAAACCDFGGGGGGGGGGGCAaaaaaaaaaaaaaaOOOOOOOMOOOOOaMMMMMMMMMMMaaaaaaaaaaaaaaaaaaaeeeeeeee
aybbdbbbbbbyyyyyyyyyyyyyyyyaaaaaaaAAAAAAAAAAAAAAAAAAAAaaaaaaaaaaaaaaOMMPMMMMMOOOOaaaMMMMMMMaaaaaaaaaaaaaaaaaaaaaeeeeeeee
ayyyyybbybbyyyyyyyyyyyyyyyyaaaaaaaaaaaaaaaaaaaaaaaaaaaaaaaaaaaaaaaaaOMMMMMMMMOOOOaaaMMMMMMMaaaaaaaaaaaaaaaaaaaaaeeeeeeee
ayyyyyyyyyyyyyyyyyyyyyyyyyyaaaaaaaaaaaaaaaaaaaaaaaaaaaaaaaaaaaaaaaaaOMMMOOOOOOOOOaaaMMMMMMMaaaaaaaaaaaaaaaaaaaaaeeeeeeee
aaaaaaaaaaaaaaaaaaaaaaaaaaaaaaaaaaaaaaaaaaaaaaaaaaaaaaaaaaaaaaaaaaaaOOOOOOOOOOOOOaaaaaaaaaaaaaaaaaaaaaaaaaaaaaaaeeeeeeee
aaaaaaaaaaaaaaaaaaaaaaaaaaaaaaaaaaaaaaaaaaaaaaaaaaaaaaaaaaaaaaaaaaaaaaaaaaaaaaaaaaaaaaaaaaaaaaaaaaaaaaaaaaaaaaaaeeeeeeee
aaaaaaaaaaaaaaaaaaaaaaaaaaaaaaaaaaaaaaaaaaaaaaaaaaaaaaaaaaaaaaaaaaaaaaaaaaaaaaaaaaaaaaaaaaaaaaaaaaaaaaaaaaaaaaaaeeeeeeee
aaaaaaaaaaaaaaaaaaaaaaaaaaaaaaaaaaaaaaaaaaaaaaaaaaaaaaaaaaaaaaaaaaaaaaaaaaaaaaaaaaaaaaaaaaaaaaaaaaaaaaaaaaaaaaaaeeeeeeee
aaaaaaaaaaaaaaaaaaaaaaaaaaaaaaaaaaaaaaaaaaaaaaaaaaaaaaaaaaaaaaaaaaaaaaaaaaaaaaaaaaaaaaaaaaaaaaaaaaaaaaaaaaaaaaaaeeeeeeee
aaaaaaaaaaaaaaaaaaaaaaaaaaaaaaaaaaaaaaaaaaaaaaaaaaaaaaaaaOOOOOOOOOOOOOOOOOOOOOOOaaaaaaaaaaaaaaaaaaaaaaaaaaaaaaaaeeeeeeee
aaaaaaaaaaaaaaaaaaaaaaaaaaaaaaaaaaaaaaaaaaaaaaaaaaaaaaaaaOOOMMNNNNNNNNNNNNNNNNNNMMaaaaaaaaaaaaaaaaaaaaaaaaaaaaaaeeeeeeee
aaaaaaaaaaaaaaaaaaaaaaaaaaaaaaaaaaaaaaaaaaaaaaaaaaaaaaaaaOOOMMOOOOOOOOOOOOOOOOOOaMaaaaaaaaaaaaaaaaaaaaaaaaaaaaaaeeeeeeee
llllllllllllllllllllllaaBBBBBBBBBBBBBBaaaaaaaaaaaaaaaaaaaOOOOMOOOOOOOOOOOOOOOOOOaMaaaaaaaaaaaaaaaaaaaaaaaaaaaaaaeeeeeeee
aaaaaaaaaaaaaaaaasbbslaaBbbbbBBBBbbbBBaaaaaaOaaaaaaaaaaaaOMMOPOOOOOOMMMOOOOOOOOOaMaaaaaaaaaaaaaaaaaaaaaaaaaaaaaaeeeeeeee
aaaaaaaaaaaaaaaaasbbslaaBbdbbBBBBbdbBBaaaaaaOaaaaaaaaaaaaOMMMMMOOOOMPMMOOOOOOOOOaMaaaaaaaaaaaaaaaaaaaaaaaaaaaaaaeeeeeeee
aaaaaaaaaaaaaaaaasbbslaaBbdbbbbbbdbbBBaaaaaaOaaaaaaaaaaaaOMPPMMOMMOMMPMOOOOOOOOOaMaaaaaaaaaaaaaaaaaaaaaaaaaaaaaaeeeeeeee
aooooooooooooooofsbbslaaBbbBBBmBBBdbBBaaaaaaOaaaaaaaaaaaaOOMMPPOMMMPPMOOOOOOOOOOaMaaaaaaaaaaaaaaaaaaaaaaaaaaaaaaeeeeeeee
aojopqqqoooqqqqoagbbslaaBBBBBBBBBBbBBBaaaaaaOaaaaaaaaaaaaOOPMMPMMMOPMMOOaaaaaaaaaMaaaaaaaaaaaaaaaaaaaaaaaaaaaaaaeeeeeeee
aorooqttqqqqtqqoahbbslaaBbbcccnBbbbbbBaaaaaaOaaaaaaaaaaaaOOMPPMOMMOMMPOOaaaMMMMMaMaaaaaaaaaaaaaaaaaaaaaaaaaaaaaaeeeeeeee
aouoovqtwovtqtqoahbbklaaBbbBBBBBdbbbbBaaaaaaOaaaaaaaaaaaaOOMPMPOOOOMPMOOaMMMMMMMaMaaaaaaaaaaaaaaaaaaaaaaaaaaaaaaeeeeeeee
aorooqqqqoqqqqqoaibbslaaBBcBBBBBbdbbbBaaaaaaOaaaaaaaaaaaaOOMMMMMMMOMMOOOaaaMMMMMaMaaaaaaaaaaaaaaaaaaaaaaaaaaaaaaeeeeeeee
aoroooooootoooooasbbslaaBBcBBBBBbdbbbBaaaaaaaaaaaaaaaaaaaOOOOOMPMMOMOOOOaMMMMMMMMMaaaaaaaaaaaaaaaaaaaaaaaaaaaaaaeeeeeeee
aorooooooqqqqqqoagbbslaaBBbbccccdbdbbBaaaaaaaaaaaaaaaaaaaOOOOOOOMOOMOOOOaaaMMMMMaaaaaaaaaaaaaaaaaaaaaaaaaaaaaaaaeeeeeeee
aorooooooqqqqqqoahbbslaaBBbbBBBBBBBBBBaaaaaaaaaaaaaaaaaaaOOOOOOMPMMMOOOOaMMMMMMMaaaaaaaaaaaaaaaaaaaaaaaaaaaaaaaaeeeeeeee
aovqrrrrttttqqqoahbbklaaBBBBBBBBBBBBBBaaaaaaaaaaaaaaaaaaaOOOOOOQMOMMOOOOaaaMMMMMaaaaaaaaaaaaaaaaaaaaaaaaaaaaaaaaeeeeeeee
aoqqoooooqxqqxqoaibbslaaaaaaaaaaaaaaaaaaaaaaaaaaaaaaaaaaaOOOOOOOOOOOOOOOaaaaaaaaaaaaaaaaaaaaaaaaaaaaaaaaaaaaaaaaeeeeeeee
aoooooooooooooooasbbslaaaaaaaaaaaaaaaaaaaaaaaaaaaaaaaaaaaaaaaaaaaaaaaaaaaaaaaaaaaaaaaaaaaaaaaaaaaaaaaaaaaaaaaaaaeeeeeeee
aaaaaaaaaaaaaaaaasbbslaaaaaaaaaaaaaaaaaaaaaaaaaaaaaaaaaaaaaaaaaaaaaaaaaaaaaaaaaaaaaaaaaaaaaaaaaaaaaaaaaaaaaaaaaaeeeeeeee
aaaaaaaaaaaaaaaaasbbslaaaaaaaaaaaaaaaaaaaaaaaaaaaaaaaaaaaaaaaaaaaaaaaaaaaaaaaaaaaaaaaaaaaaaaaaaaaaaaaaaaaaaaaaaaeeeeeeee
aaaaaaaaaaaaaaaaasbbslaaaaaaaaaaaaaaaaaaaaaaaaaaaaaaaaaaaaaaaaaaaaaaaaaaaaaaaaaaaaaaaaaaaaaaaaaaaaaaaaaaaaaaaaaaeeeeeeee
"}
