"a" = (/turf/unsimulated/wall/rock,/area/vault/spacepond/wine_cellar)
"b" = (/turf/unsimulated/floor/asteroid/air,/area/vault/spacepond/wine_cellar)
"c" = (/mob/living/simple_animal/hostile/scarybat,/turf/unsimulated/floor/asteroid/air,/area/vault/spacepond/wine_cellar)
"d" = (/obj/effect/landmark/corpse/mutilated,/turf/unsimulated/floor/asteroid/air,/area/vault/spacepond/wine_cellar)
"e" = (/obj/item/candle,/obj/structure/window/reinforced/plasma{dir = 1},/obj/structure/window/reinforced/plasma{dir = 4},/turf/unsimulated/floor,/area/vault/spacepond/wine_cellar)
"f" = (/obj/structure/closet/coffin,/obj/structure/window/reinforced/plasma{dir = 4},/turf/unsimulated/floor,/area/vault/spacepond/wine_cellar)
"g" = (/obj/item/candle,/obj/structure/window/reinforced/plasma,/obj/structure/window/reinforced/plasma{dir = 4},/turf/unsimulated/floor,/area/vault/spacepond/wine_cellar)
"h" = (/turf/simulated/wall,/area/vault/spacepond/wine_cellar)
"i" = (/obj/structure/falsewall,/turf/unsimulated/floor/asteroid/air,/area/vault/spacepond/wine_cellar)
"j" = (/turf/simulated/floor{icon_state = "grimy"},/area/vault/spacepond/wine_cellar)
"k" = (/obj/structure/rack,/obj/item/weapon/reagent_containers/food/drinks/bottle/wine,/obj/item/weapon/reagent_containers/food/drinks/bottle/wine{pixel_x = 8},/obj/item/weapon/reagent_containers/food/drinks/bottle/wine{pixel_x = -8},/obj/structure/window/reinforced{dir = 8},/obj/structure/window/reinforced{dir = 1},/turf/simulated/floor{icon_state = "grimy"},/area/vault/spacepond/wine_cellar)
"l" = (/obj/structure/rack,/obj/item/weapon/reagent_containers/food/drinks/bottle/wine,/obj/item/weapon/reagent_containers/food/drinks/bottle/wine{pixel_x = 8},/obj/item/weapon/reagent_containers/food/drinks/bottle/wine{pixel_x = -8},/obj/structure/window/reinforced{dir = 1},/turf/simulated/floor{icon_state = "grimy"},/area/vault/spacepond/wine_cellar)
"m" = (/obj/structure/rack,/obj/item/weapon/reagent_containers/food/drinks/bottle/wine,/obj/item/weapon/reagent_containers/food/drinks/bottle/wine{pixel_x = 8},/obj/item/weapon/reagent_containers/food/drinks/bottle/wine{pixel_x = -8},/obj/structure/window/reinforced{dir = 1},/obj/structure/window/reinforced{dir = 4},/turf/simulated/floor{icon_state = "grimy"},/area/vault/spacepond/wine_cellar)
"n" = (/turf/simulated/floor{dir = 1; icon_state = "ramptop"},/area/vault/spacepond/wine_cellar)
"o" = (/obj/structure/rack,/obj/item/weapon/reagent_containers/food/drinks/bottle/wine{pixel_x = 8},/obj/item/weapon/reagent_containers/food/drinks/bottle/wine,/obj/item/weapon/reagent_containers/food/drinks/bottle/wine{pixel_x = -8},/obj/structure/window/reinforced{dir = 8},/turf/simulated/floor{icon_state = "grimy"},/area/vault/spacepond/wine_cellar)
"p" = (/obj/structure/rack,/obj/item/weapon/reagent_containers/food/drinks/bottle/wine{pixel_x = 8},/obj/item/weapon/reagent_containers/food/drinks/bottle/wine,/obj/item/weapon/reagent_containers/food/drinks/bottle/wine{pixel_x = -8},/turf/simulated/floor{icon_state = "grimy"},/area/vault/spacepond/wine_cellar)
"q" = (/obj/structure/rack,/obj/item/weapon/reagent_containers/food/drinks/bottle/wine{pixel_x = 8},/obj/item/weapon/reagent_containers/food/drinks/bottle/wine,/obj/item/weapon/reagent_containers/food/drinks/bottle/wine{pixel_x = -8},/obj/structure/window/reinforced{dir = 4},/turf/simulated/floor{icon_state = "grimy"},/area/vault/spacepond/wine_cellar)
"r" = (/obj/structure/rack,/obj/item/weapon/reagent_containers/food/drinks/bottle/wine{pixel_x = 8},/obj/item/weapon/reagent_containers/food/drinks/bottle/wine,/obj/item/weapon/reagent_containers/food/drinks/bottle/wine{pixel_x = -8},/obj/structure/window/reinforced,/obj/structure/window/reinforced{dir = 8},/turf/simulated/floor{icon_state = "grimy"},/area/vault/spacepond/wine_cellar)
"s" = (/obj/structure/rack,/obj/item/weapon/reagent_containers/food/drinks/bottle/wine{pixel_x = 8},/obj/item/weapon/reagent_containers/food/drinks/bottle/wine,/obj/item/weapon/reagent_containers/food/drinks/bottle/wine{pixel_x = -8},/obj/structure/window/reinforced,/turf/simulated/floor{icon_state = "grimy"},/area/vault/spacepond/wine_cellar)
"t" = (/obj/structure/rack,/obj/item/weapon/reagent_containers/food/drinks/bottle/wine{pixel_x = 8},/obj/item/weapon/reagent_containers/food/drinks/bottle/wine,/obj/item/weapon/reagent_containers/food/drinks/bottle/wine{pixel_x = -8},/obj/structure/window/reinforced,/obj/structure/window/reinforced{dir = 4},/turf/simulated/floor{icon_state = "grimy"},/area/vault/spacepond/wine_cellar)
"u" = (/obj/structure/reagent_dispensers/bloodkeg,/turf/simulated/floor{icon_state = "grimy"},/area/vault/spacepond/wine_cellar)
"v" = (/obj/item/weapon/shard,/turf/simulated/floor{icon_state = "grimy"},/area/vault/spacepond/wine_cellar)
"w" = (/turf/simulated/floor/wood,/area/vault/spacepond/wine_cellar)
"x" = (/turf/simulated/floor/wood{broken = 1; icon_state = "wood-broken6"},/area/vault/spacepond/wine_cellar)
"y" = (/obj/structure/table/woodentable,/obj/item/weapon/reagent_containers/food/drinks/flask/barflask,/obj/item/weapon/reagent_containers/food/drinks/flask/barflask{pixel_x = 1; pixel_y = 4},/turf/simulated/floor{icon_state = "grimy"},/area/vault/spacepond/wine_cellar)
"z" = (/obj/structure/table/woodentable,/obj/item/weapon/reagent_containers/food/drinks/shaker,/obj/map/spawner/space/drinks,/turf/simulated/floor{icon_state = "grimy"},/area/vault/spacepond/wine_cellar)
"A" = (/obj/structure/table/woodentable,/obj/item/weapon/reagent_containers/food/drinks/drinkingglass{pixel_x = -6; pixel_y = 2},/obj/item/weapon/reagent_containers/food/drinks/drinkingglass{pixel_x = 1},/turf/simulated/floor{icon_state = "grimy"},/area/vault/spacepond/wine_cellar)
"B" = (/obj/structure/reagent_dispensers/beerkeg{pixel_y = -4},/turf/simulated/floor{icon_state = "grimy"},/area/vault/spacepond/wine_cellar)
"C" = (/turf/simulated/floor/wood{broken = 1; icon_state = "wood-broken"},/area/vault/spacepond/wine_cellar)
"D" = (/obj/effect/decal/remains/human/noskull,/turf/simulated/floor/wood,/area/vault/spacepond/wine_cellar)
"E" = (/obj/structure/ladder/spacepond/winecellar,/turf/simulated/floor/wood,/area/vault/spacepond/wine_cellar)

(1,1,1) = {"
aaaaaaaaaaaaaaa
aaaabcbdbbdbbea
aaabdbabdbbdbfa
aaabaaaaaaaabga
ahhihhhhhhhhaaa
ahjjjjjjjjjhaaa
ahkjljljmhnhaaa
ahojpjpjqhnhaaa
ahojpjpjqhnhaaa
ahrjsjsjthnhaaa
ahujjjjjhhnhhha
ahujjvjjhwxwwha
ahujyzABhCDwEha
ahhhhhhhhhhhhha
aaaaaaaaaaaaaaa
"}
