"a" = (/turf/unsimulated/floor/snow,/area)
"u" = (/obj/item/weapon/gun/projectile/hecate/hunting,/obj/item/ammo_storage/speedloader/c38,/obj/item/ammo_storage/speedloader/c38,/obj/item/weapon/bedsheet{pixel_x = -1},/obj/item/weapon/bedsheet{pixel_x = 10},/obj/item/weapon/bedsheet{pixel_x = 4; pixel_y = 8},/turf/unsimulated/floor/snow,/area)
"F" = (/obj/structure/flora/tree/pine,/turf/unsimulated/floor/snow,/area)

(1,1,1) = {"
aaa
aua
aFa
"}
