//MAP CONVERTED BY dmm2tgm.py THIS HEADER COMMENT PREVENTS RECONVERSION, DO NOT REMOVE
"a" = (
/turf/unsimulated/floor/snow,
/area)
"h" = (
/obj/structure/flora/tree/pine,
/turf/unsimulated/floor/snow,
/area)
"A" = (
/obj/abstract/map/nest/deer,
/turf/unsimulated/floor/snow,
/area)
"E" = (
/turf/unsimulated/wall/rock/ice,
/area)
"S" = (
/obj/abstract/map/nest/wolf,
/turf/unsimulated/floor/snow,
/area)

(1,1,1) = {"
a
a
a
a
a
a
a
a
a
a
a
a
a
a
a
"}
(2,1,1) = {"
a
h
a
a
a
h
a
a
a
a
h
a
a
a
a
"}
(3,1,1) = {"
a
a
a
a
a
a
a
a
a
a
a
a
a
h
a
"}
(4,1,1) = {"
a
a
a
a
a
a
a
a
A
a
a
a
a
a
a
"}
(5,1,1) = {"
a
a
a
a
a
a
h
a
a
a
a
a
a
a
a
"}
(6,1,1) = {"
a
a
a
A
a
a
a
a
a
a
a
a
a
a
a
"}
(7,1,1) = {"
a
h
a
a
a
a
a
a
a
h
a
a
a
a
a
"}
(8,1,1) = {"
a
a
a
a
a
a
A
a
a
a
a
a
a
a
a
"}
(9,1,1) = {"
a
a
a
a
a
h
a
a
a
a
a
a
a
a
a
"}
(10,1,1) = {"
a
a
h
a
a
a
a
a
a
a
h
a
a
h
a
"}
(11,1,1) = {"
a
a
a
a
a
a
E
E
E
E
a
a
a
a
a
"}
(12,1,1) = {"
a
a
a
a
h
E
E
E
E
E
E
a
a
a
a
"}
(13,1,1) = {"
a
a
h
a
E
E
E
S
a
E
E
E
a
a
a
"}
(14,1,1) = {"
a
a
a
a
E
E
a
a
a
a
E
E
h
a
a
"}
(15,1,1) = {"
a
a
a
a
a
a
a
a
a
a
a
a
a
a
a
"}
