"b" = (/obj/machinery/suspension_gen{dir = 4},/turf/unsimulated/floor/asteroid,/area/asteroid)
"d" = (/obj/item/trash/bowl,/obj/item/trash/soda_cans{pixel_x = 10; pixel_y = 9},/turf/unsimulated/floor/asteroid,/area/asteroid)
"e" = (/obj/effect/decal/cleanable/dirt,/obj/item/device/measuring_tape,/turf/unsimulated/floor/asteroid,/area/asteroid)
"h" = (/obj/structure/fence/door,/obj/effect/decal/cleanable/dirt,/obj/item/tape/engineering{icon_state = "engineering_door"},/turf/unsimulated/floor/asteroid,/area/asteroid)
"l" = (/obj/structure/table,/obj/effect/decal/cleanable/dirt,/obj/item/weapon/pickaxe/plasmacutter,/turf/unsimulated/floor/asteroid,/area/asteroid)
"q" = (/obj/structure/table,/obj/effect/decal/cleanable/dirt,/obj/item/weapon/storage/box/excavation,/obj/item/weapon/pickaxe/excavationdrill,/turf/unsimulated/floor/asteroid,/area/asteroid)
"r" = (/obj/structure/bed/chair/folding{dir = 8},/turf/unsimulated/floor/asteroid,/area/asteroid)
"v" = (/obj/effect/decal/cleanable/dirt,/turf/unsimulated/floor/asteroid{color = "#a37552"},/area/asteroid)
"w" = (/obj/effect/decal/cleanable/dirt,/obj/item/stack/sheet/bone{pixel_x = -7; pixel_y = 7},/turf/unsimulated/floor/asteroid{color = "#a37552"},/area/asteroid)
"y" = (/obj/machinery/floodlight,/turf/unsimulated/floor/asteroid,/area/asteroid)
"A" = (/obj/effect/decal/cleanable/dirt,/obj/item/weapon/fossil/bone,/turf/unsimulated/floor/asteroid{color = "#a37552"},/area/asteroid)
"B" = (/obj/structure/table,/obj/item/device/flashlight/lantern,/turf/unsimulated/floor/asteroid,/area/asteroid)
"E" = (/obj/structure/bed/chair/folding,/turf/unsimulated/floor/asteroid,/area/asteroid)
"F" = (/obj/effect/decal/cleanable/dirt,/obj/item/trash/liquidfood,/turf/unsimulated/floor/asteroid,/area/asteroid)
"G" = (/obj/structure/closet/crate,/obj/item/weapon/pickaxe,/obj/item/weapon/pickaxe/hand,/obj/item/clothing/gloves/latex,/obj/item/clothing/glasses/science,/turf/unsimulated/floor/asteroid,/area/asteroid)
"H" = (/obj/effect/decal/cleanable/dirt,/turf/unsimulated/floor/asteroid,/area/asteroid)
"I" = (/obj/structure/largecrate,/turf/unsimulated/floor/asteroid,/area/asteroid)
"K" = (/obj/effect/decal/cleanable/dirt,/obj/item/stack/sheet/bone,/obj/item/stack/sheet/bone{pixel_x = 5; pixel_y = -3},/turf/unsimulated/floor/asteroid{color = "#a37552"},/area/asteroid)
"L" = (/obj/effect/decal/cleanable/dirt,/obj/structure/bed/chair/folding{dir = 8},/turf/unsimulated/floor/asteroid,/area/asteroid)
"M" = (/obj/structure/bed/chair/folding{dir = 4},/obj/effect/decal/cleanable/dirt,/turf/unsimulated/floor/asteroid,/area/asteroid)
"P" = (/obj/item/weapon/pickaxe/shovel,/turf/unsimulated/floor/asteroid,/area/asteroid)
"Q" = (/obj/structure/fence{dir = 4},/turf/unsimulated/floor/asteroid,/area/asteroid)
"S" = (/turf/unsimulated/mineral,/area/asteroid)
"T" = (/obj/structure/bed/chair/folding{dir = 1},/turf/unsimulated/floor/asteroid,/area/asteroid)
"V" = (/obj/effect/decal/cleanable/dirt,/obj/effect/decal/remains/human,/turf/unsimulated/floor/asteroid{color = "#a37552"},/area/asteroid)
"W" = (/obj/structure/anomaly_container,/obj/machinery/artifact,/turf/unsimulated/floor/asteroid,/area/asteroid)
"X" = (/turf/unsimulated/floor/asteroid,/area/asteroid)
"Y" = (/obj/effect/decal/cleanable/campfire,/obj/effect/decal/cleanable/dirt,/turf/unsimulated/floor/asteroid,/area/asteroid)
"Z" = (/obj/structure/table,/obj/item/device/depth_scanner,/obj/item/weapon/book/manual/excavation{pixel_x = 1; pixel_y = 8},/turf/unsimulated/floor/asteroid,/area/asteroid)

(1,1,1) = {"
SSSSSSSSS
SSSHyHXSS
SSXHHeHXS
SWHAKVvHS
SbHVvAwHS
SbXHHXHPS
SSQQhQQQS
SSEEHXXIS
SSBZXHXSS
SSlqLXXGS
SSXXXXXGS
SSSMYrySS
SSSdTFSSS
SSSSSSSSS
"}
