//MAP CONVERTED BY dmm2tgm.py THIS HEADER COMMENT PREVENTS RECONVERSION, DO NOT REMOVE
"a" = (
/turf/simulated/wall/r_rock,
/area/mining_surprise)
"b" = (
/obj/effect/decal/cleanable/dirt,
/turf/simulated/floor/airless{
	icon_state = "asteroidfloor"
	},
/area/mining_surprise)
"c" = (
/obj/effect/decal/cleanable/cockroach_remains,
/turf/unsimulated/floor/asteroid,
/area/mining_surprise)
"d" = (
/obj/structure/bed,
/obj/item/weapon/bedsheet/brown/cargo,
/obj/structure/sign/poster{
	pixel_x = -32
	},
/turf/simulated/floor/airless{
	icon_state = "asteroidfloor"
	},
/area/mining_surprise)
"e" = (
/obj/structure/table/woodentable,
/obj/item/trash/tray,
/obj/item/trash/candle,
/obj/effect/decal/cleanable/dirt,
/turf/simulated/floor/airless{
	icon_state = "asteroidfloor"
	},
/area/mining_surprise)
"i" = (
/obj/structure/boulder,
/obj/effect/decal/cleanable/dirt,
/turf/simulated/floor/plating/airless{
	icon_state = "asteroidplating"
	},
/area/mining_surprise)
"j" = (
/obj/item/item_head/tower_shield,
/turf/unsimulated/floor/asteroid,
/area/mining_surprise)
"k" = (
/obj/structure/boulder,
/turf/unsimulated/floor/asteroid,
/area/mining_surprise)
"l" = (
/obj/structure/bed/chair/wood/normal,
/obj/effect/decal/cleanable/cobweb2,
/obj/effect/decal/cleanable/dirt,
/turf/simulated/floor/airless{
	icon_state = "asteroidfloor"
	},
/area/mining_surprise)
"n" = (
/obj/structure/grille,
/obj/structure/window/reinforced{
	dir = 8
	},
/obj/structure/window/reinforced{
	dir = 4
	},
/obj/structure/window/reinforced,
/obj/structure/window/reinforced{
	dir = 1
	},
/turf/simulated/floor/plating/airless{
	icon_state = "asteroidplating"
	},
/area/mining_surprise)
"o" = (
/obj/item/weapon/paper/crumpled/bloody{
	info = "Death is not an escape but it's better than staying here."
	},
/turf/simulated/floor/airless{
	icon_state = "asteroidfloor"
	},
/area/mining_surprise)
"p" = (
/turf/unsimulated/mineral,
/area/mining_surprise)
"q" = (
/obj/structure/rack,
/obj/item/item_handle,
/obj/item/item_handle,
/obj/item/item_head/sword/gladius,
/turf/simulated/floor/airless{
	icon_state = "asteroidfloor"
	},
/area/mining_surprise)
"s" = (
/obj/effect/decal/cleanable/blood{
	icon_state = "floor6-old";
	tag = "icon-floor6-old"
	},
/turf/simulated/floor/airless{
	icon_state = "asteroidfloor"
	},
/area/mining_surprise)
"t" = (
/obj/structure/ore_box,
/turf/unsimulated/floor/asteroid,
/area/mining_surprise)
"u" = (
/turf/unsimulated/floor/asteroid,
/area/mining_surprise)
"v" = (
/obj/structure/boulder,
/turf/simulated/floor/plating/airless{
	icon_state = "asteroidplating"
	},
/area/mining_surprise)
"x" = (
/obj/structure/closet/secure_closet/miner,
/turf/simulated/floor/airless{
	icon_state = "asteroidfloor"
	},
/area/mining_surprise)
"y" = (
/turf/simulated/floor/plating/airless{
	icon_state = "asteroidplating"
	},
/area/mining_surprise)
"z" = (
/obj/structure/vendomatpack/mining,
/obj/effect/decal/cleanable/dirt,
/turf/simulated/floor/plating/airless{
	icon_state = "asteroidplating"
	},
/area/mining_surprise)
"B" = (
/obj/effect/landmark/corpse/miner/rig,
/obj/effect/decal/cleanable/blood{
	icon_state = "floor4"
	},
/obj/item/weapon/gun/projectile/russian/empty,
/turf/simulated/floor/plating/airless{
	icon_state = "asteroidplating"
	},
/area/mining_surprise)
"C" = (
/obj/structure/reagent_dispensers/cauldron,
/turf/simulated/floor/plating/airless{
	icon_state = "asteroidplating"
	},
/area/mining_surprise)
"D" = (
/obj/structure/toilet{
	desc = "The HT-451, a torque rotation-based, waste disposal unit for small matter. This one is a gruesome sight indeed.";
	dir = 4
	},
/obj/structure/curtain/open/shower/right,
/obj/effect/decal/cleanable/dirt,
/turf/simulated/floor/airless{
	icon_state = "asteroidfloor"
	},
/area/mining_surprise)
"E" = (
/obj/item/trash/cigbutt,
/turf/simulated/floor/plating/airless{
	icon_state = "asteroidplating"
	},
/area/mining_surprise)
"F" = (
/obj/effect/decal/cleanable/dirt,
/turf/simulated/floor/plating/airless{
	icon_state = "asteroidplating"
	},
/area/mining_surprise)
"J" = (
/obj/structure/bed/chair/wood/normal{
	dir = 1
	},
/turf/simulated/floor/airless{
	icon_state = "asteroidfloor"
	},
/area/mining_surprise)
"K" = (
/turf/simulated/floor/airless{
	icon_state = "asteroidfloor"
	},
/area/mining_surprise)
"L" = (
/obj/machinery/door/mineral,
/turf/simulated/floor/plating/airless{
	icon_state = "asteroidplating"
	},
/area/mining_surprise)
"M" = (
/obj/item/trash/cigbutt,
/obj/structure/sign/poster{
	pixel_y = -32
	},
/turf/simulated/floor/airless{
	icon_state = "asteroidfloor"
	},
/area/mining_surprise)
"N" = (
/obj/structure/forge,
/obj/effect/decal/cleanable/dirt,
/turf/simulated/floor/airless{
	icon_state = "asteroidfloor"
	},
/area/mining_surprise)
"P" = (
/obj/item/anvil,
/obj/effect/decal/cleanable/cobweb,
/turf/simulated/floor/airless{
	icon_state = "asteroidfloor"
	},
/area/mining_surprise)
"Q" = (
/obj/item/item_head/pickaxe_head,
/obj/structure/hanging_lantern/dim{
	dir = 1
	},
/turf/simulated/floor/plating/airless{
	icon_state = "asteroidplating"
	},
/area/mining_surprise)
"S" = (
/obj/structure/closet,
/obj/effect/decal/cleanable/dirt,
/obj/item/weapon/reagent_containers/glass/bucket{
	pixel_y = 4
	},
/obj/item/stack/sheet/wood,
/obj/item/stack/sheet/wood,
/obj/item/stack/sheet/wood,
/turf/simulated/floor/plating/airless{
	icon_state = "asteroidplating"
	},
/area/mining_surprise)
"U" = (
/obj/structure/hanging_lantern/dim{
	dir = 8
	},
/turf/simulated/floor/airless{
	icon_state = "asteroidfloor"
	},
/area/mining_surprise)
"V" = (
/obj/structure/hanging_lantern/dim{
	dir = 1
	},
/turf/simulated/floor/plating/airless{
	icon_state = "asteroidplating"
	},
/area/mining_surprise)
"X" = (
/obj/item/item_head/pitchfork_head,
/turf/unsimulated/floor/asteroid,
/area/mining_surprise)
"Z" = (
/obj/structure/rack,
/obj/item/weapon/hammer,
/obj/effect/decal/cleanable/dirt,
/obj/structure/sign/xeno_warning_mining{
	pixel_y = 32
	},
/turf/simulated/floor/airless{
	icon_state = "asteroidfloor"
	},
/area/mining_surprise)

(1,1,1) = {"
p
p
p
p
p
a
a
a
a
a
"}
(2,1,1) = {"
p
p
v
v
p
a
d
U
D
a
"}
(3,1,1) = {"
p
k
S
z
p
a
x
K
K
a
"}
(4,1,1) = {"
p
k
F
y
k
a
x
b
M
a
"}
(5,1,1) = {"
p
p
V
y
y
L
b
b
b
a
"}
(6,1,1) = {"
p
P
s
y
X
a
l
e
J
a
"}
(7,1,1) = {"
p
N
b
B
u
a
a
n
a
a
"}
(8,1,1) = {"
p
Z
o
y
u
k
c
u
k
p
"}
(9,1,1) = {"
p
q
b
y
E
y
y
y
i
i
"}
(10,1,1) = {"
p
p
Q
y
y
y
F
i
i
i
"}
(11,1,1) = {"
v
v
y
y
u
u
j
p
p
p
"}
(12,1,1) = {"
v
p
v
C
u
u
t
p
p
p
"}
(13,1,1) = {"
p
p
k
k
t
t
t
p
p
p
"}
(14,1,1) = {"
p
p
k
p
p
p
k
p
p
p
"}
(15,1,1) = {"
p
p
p
p
p
p
p
p
p
p
"}
