//MAP CONVERTED BY dmm2tgm.py THIS HEADER COMMENT PREVENTS RECONVERSION, DO NOT REMOVE
"b" = (
/obj/machinery/suspension_gen{
	dir = 4
	},
/turf/unsimulated/floor/asteroid,
/area/mining_surprise)
"d" = (
/obj/item/trash/bowl,
/obj/item/trash/soda_cans{
	pixel_x = 10;
	pixel_y = 9
	},
/turf/unsimulated/floor/asteroid,
/area/mining_surprise)
"e" = (
/obj/effect/decal/cleanable/dirt,
/obj/item/device/measuring_tape,
/turf/unsimulated/floor/asteroid,
/area/mining_surprise)
"h" = (
/obj/structure/fence/door,
/obj/effect/decal/cleanable/dirt,
/obj/item/tape/engineering{
	icon_state = "engineering_door"
	},
/turf/unsimulated/floor/asteroid,
/area/mining_surprise)
"l" = (
/obj/structure/table,
/obj/effect/decal/cleanable/dirt,
/obj/item/weapon/pickaxe/plasmacutter,
/turf/unsimulated/floor/asteroid,
/area/mining_surprise)
"q" = (
/obj/structure/table,
/obj/effect/decal/cleanable/dirt,
/obj/item/weapon/storage/box/excavation,
/obj/item/weapon/pickaxe/excavationdrill,
/turf/unsimulated/floor/asteroid,
/area/mining_surprise)
"r" = (
/obj/structure/bed/chair/folding{
	dir = 8
	},
/turf/unsimulated/floor/asteroid,
/area/mining_surprise)
"v" = (
/obj/effect/decal/cleanable/dirt,
/turf/unsimulated/floor/asteroid{
	color = "#a37552"
	},
/area/mining_surprise)
"w" = (
/obj/effect/decal/cleanable/dirt,
/obj/item/stack/sheet/bone{
	pixel_x = -7;
	pixel_y = 7
	},
/turf/unsimulated/floor/asteroid{
	color = "#a37552"
	},
/area/mining_surprise)
"y" = (
/obj/machinery/floodlight,
/turf/unsimulated/floor/asteroid,
/area/mining_surprise)
"A" = (
/obj/effect/decal/cleanable/dirt,
/obj/item/weapon/fossil/bone,
/turf/unsimulated/floor/asteroid{
	color = "#a37552"
	},
/area/mining_surprise)
"B" = (
/obj/structure/table,
/obj/item/device/flashlight/lantern,
/turf/unsimulated/floor/asteroid,
/area/mining_surprise)
"E" = (
/obj/structure/bed/chair/folding,
/turf/unsimulated/floor/asteroid,
/area/mining_surprise)
"F" = (
/obj/effect/decal/cleanable/dirt,
/obj/item/trash/liquidfood,
/turf/unsimulated/floor/asteroid,
/area/mining_surprise)
"G" = (
/obj/structure/closet/crate,
/obj/item/weapon/pickaxe,
/obj/item/weapon/pickaxe/hand,
/obj/item/clothing/gloves/latex,
/obj/item/clothing/glasses/scanner/science,
/turf/unsimulated/floor/asteroid,
/area/mining_surprise)
"H" = (
/obj/effect/decal/cleanable/dirt,
/turf/unsimulated/floor/asteroid,
/area/mining_surprise)
"I" = (
/obj/structure/largecrate,
/turf/unsimulated/floor/asteroid,
/area/mining_surprise)
"K" = (
/obj/effect/decal/cleanable/dirt,
/obj/item/stack/sheet/bone,
/obj/item/stack/sheet/bone{
	pixel_x = 5;
	pixel_y = -3
	},
/turf/unsimulated/floor/asteroid{
	color = "#a37552"
	},
/area/mining_surprise)
"L" = (
/obj/effect/decal/cleanable/dirt,
/obj/structure/bed/chair/folding{
	dir = 8
	},
/turf/unsimulated/floor/asteroid,
/area/mining_surprise)
"M" = (
/obj/structure/bed/chair/folding{
	dir = 4
	},
/obj/effect/decal/cleanable/dirt,
/turf/unsimulated/floor/asteroid,
/area/mining_surprise)
"P" = (
/obj/item/weapon/pickaxe/shovel,
/turf/unsimulated/floor/asteroid,
/area/mining_surprise)
"Q" = (
/obj/structure/fence{
	dir = 4
	},
/turf/unsimulated/floor/asteroid,
/area/mining_surprise)
"S" = (
/turf/unsimulated/mineral,
/area/mining_surprise)
"T" = (
/obj/structure/bed/chair/folding{
	dir = 1
	},
/turf/unsimulated/floor/asteroid,
/area/mining_surprise)
"V" = (
/obj/effect/decal/cleanable/dirt,
/obj/effect/decal/remains/human,
/turf/unsimulated/floor/asteroid{
	color = "#a37552"
	},
/area/mining_surprise)
"W" = (
/obj/structure/anomaly_container,
/obj/machinery/artifact,
/turf/unsimulated/floor/asteroid,
/area/mining_surprise)
"X" = (
/turf/unsimulated/floor/asteroid,
/area/mining_surprise)
"Y" = (
/obj/effect/decal/cleanable/campfire,
/obj/effect/decal/cleanable/dirt,
/turf/unsimulated/floor/asteroid,
/area/mining_surprise)
"Z" = (
/obj/structure/table,
/obj/item/device/depth_scanner,
/obj/item/weapon/book/manual/excavation{
	pixel_x = 1;
	pixel_y = 8
	},
/turf/unsimulated/floor/asteroid,
/area/mining_surprise)

(1,1,1) = {"
S
S
S
S
S
S
S
S
S
S
S
S
S
S
"}
(2,1,1) = {"
S
S
S
W
b
b
S
S
S
S
S
S
S
S
"}
(3,1,1) = {"
S
S
X
H
H
X
Q
E
B
l
X
S
S
S
"}
(4,1,1) = {"
S
H
H
A
V
H
Q
E
Z
q
X
M
d
S
"}
(5,1,1) = {"
S
y
H
K
v
H
h
H
X
L
X
Y
T
S
"}
(6,1,1) = {"
S
H
e
V
A
X
Q
X
H
X
X
r
F
S
"}
(7,1,1) = {"
S
X
H
v
w
H
Q
X
X
X
X
y
S
S
"}
(8,1,1) = {"
S
S
X
H
H
P
Q
I
S
G
G
S
S
S
"}
(9,1,1) = {"
S
S
S
S
S
S
S
S
S
S
S
S
S
S
"}
