//MAP CONVERTED BY dmm2tgm.py THIS HEADER COMMENT PREVENTS RECONVERSION, DO NOT REMOVE
"a" = (
/turf/unsimulated/mineral/dense,
/area/mining_surprise)
"b" = (
/turf/unsimulated/mineral/random/high_chance,
/area/mining_surprise)
"c" = (
/turf/unsimulated/mineral/mythril,
/area/mining_surprise)
"d" = (
/turf/unsimulated/mineral/telecrystal,
/area/mining_surprise)
"e" = (
/turf/unsimulated/floor/asteroid,
/area/mining_surprise)
"f" = (
/turf/unsimulated/mineral/random,
/area/mining_surprise)
"g" = (
/turf/unsimulated/mineral/gibtonite,
/area/mining_surprise)
"h" = (
/turf/unsimulated/mineral/random/high_chance_clown{
	rockernaut = 2
	},
/area/mining_surprise)
"i" = (
/turf/unsimulated/mineral/hyperdense,
/area/mining_surprise)
"j" = (
/turf/unsimulated/mineral/random/high_chance_clown,
/area/mining_surprise)

(1,1,1) = {"
i
i
i
i
i
i
i
i
i
f
f
f
f
f
f
f
f
f
f
f
f
f
f
f
f
"}
(2,1,1) = {"
i
b
i
i
i
b
b
b
i
i
f
f
f
f
f
f
f
f
f
f
f
f
f
a
f
"}
(3,1,1) = {"
i
b
b
b
b
b
b
b
b
i
f
f
g
g
f
f
f
f
f
f
f
f
f
f
f
"}
(4,1,1) = {"
i
b
b
b
b
b
b
b
b
i
f
g
g
e
e
f
f
f
f
f
e
e
f
f
f
"}
(5,1,1) = {"
i
b
b
b
b
b
b
b
b
i
f
f
g
e
e
e
f
f
f
f
e
e
e
f
f
"}
(6,1,1) = {"
i
b
c
c
b
e
e
e
e
i
i
f
e
e
e
e
e
f
f
e
e
e
e
f
f
"}
(7,1,1) = {"
i
b
c
e
e
e
e
e
e
e
i
f
e
e
e
e
e
e
e
e
e
e
e
f
f
"}
(8,1,1) = {"
i
b
c
e
e
e
e
e
e
e
i
f
e
e
e
e
e
e
e
e
e
e
e
e
f
"}
(9,1,1) = {"
i
b
b
b
e
e
e
e
e
e
i
a
f
e
e
e
e
e
e
e
e
e
e
e
f
"}
(10,1,1) = {"
i
b
b
b
e
e
e
e
e
e
e
i
a
f
e
e
e
e
e
e
e
e
e
e
f
"}
(11,1,1) = {"
i
b
b
b
b
e
e
e
e
e
e
e
i
f
a
e
e
e
e
e
e
e
e
e
f
"}
(12,1,1) = {"
i
b
b
b
b
j
e
e
e
e
e
e
e
i
e
e
e
e
e
e
e
e
e
e
f
"}
(13,1,1) = {"
i
b
b
b
b
j
j
e
e
e
e
e
e
h
e
e
e
e
e
e
e
e
e
e
f
"}
(14,1,1) = {"
i
b
b
b
b
j
e
e
e
e
e
e
e
i
e
e
e
e
e
e
e
e
e
e
f
"}
(15,1,1) = {"
i
b
b
b
b
e
e
e
e
e
e
e
i
f
a
e
e
e
e
e
e
e
e
e
f
"}
(16,1,1) = {"
i
b
b
b
e
e
e
e
e
e
e
i
a
f
e
e
e
e
e
e
e
e
e
e
f
"}
(17,1,1) = {"
i
b
b
b
e
e
e
e
e
e
i
a
f
e
e
e
e
e
e
e
e
e
e
e
f
"}
(18,1,1) = {"
i
b
d
e
e
e
e
e
e
e
i
f
e
e
e
e
e
e
e
e
e
e
e
e
f
"}
(19,1,1) = {"
i
b
d
e
e
e
e
e
e
e
i
f
e
e
e
e
e
e
e
e
e
e
e
f
f
"}
(20,1,1) = {"
i
b
b
d
b
e
e
e
e
i
i
f
e
e
e
e
e
f
f
e
e
e
e
f
f
"}
(21,1,1) = {"
i
b
b
b
b
b
b
b
b
i
f
f
f
e
e
e
f
f
f
f
e
e
e
f
f
"}
(22,1,1) = {"
i
b
b
b
b
b
b
b
b
i
f
f
f
e
e
f
f
f
f
f
e
e
f
f
f
"}
(23,1,1) = {"
i
b
b
b
b
b
b
b
b
i
f
f
f
f
f
f
f
f
f
f
f
f
f
f
f
"}
(24,1,1) = {"
i
b
i
i
i
b
b
b
i
i
f
f
f
f
f
f
f
f
f
f
f
f
f
a
f
"}
(25,1,1) = {"
i
i
i
i
i
i
i
i
i
f
f
f
f
f
f
f
f
f
f
f
f
f
f
f
f
"}
