"ab" = (/turf/simulated/wall/mineral/wood,/area/mining_bar)
"ac" = (/obj/structure/table/woodentable,/obj/structure/hanging_lantern{dir = 1},/turf/simulated/floor/wood,/area/mining_bar)
"ad" = (/obj/structure/table/woodentable,/obj/item/weapon/reagent_containers/food/drinks/bottle/wine{pixel_y = 15; pixel_x = 4},/obj/item/weapon/reagent_containers/food/drinks/bottle/whiskey{pixel_y = 15; pixel_x = -8},/obj/item/weapon/reagent_containers/food/drinks/bottle/rum{pixel_y = 12; pixel_x = 13},/obj/item/weapon/reagent_containers/food/drinks/drinkingglass{pixel_y = 4; pixel_x = 2},/turf/simulated/floor/wood,/area/mining_bar)
"ae" = (/obj/item/weapon/stool,/obj/machinery/atmospherics/pipe/simple/supply/hidden,/turf/simulated/floor/wood,/area/mining_bar)
"af" = (/obj/structure/table/woodentable,/obj/machinery/chem_dispenser/booze_dispenser{pixel_y = 18},/turf/simulated/floor/wood,/area/mining_bar)
"ag" = (/obj/structure/table/woodentable,/obj/machinery/chem_dispenser/soda_dispenser{pixel_y = 14; pixel_x = 0},/turf/simulated/floor/wood,/area/mining_bar)
"ah" = (/obj/structure/table/woodentable,/obj/machinery/chem_dispenser/brewer{pixel_y = 11},/turf/simulated/floor/wood,/area/mining_bar)
"ai" = (/obj/structure/table/woodentable,/obj/item/weapon/storage/box/drinkingglasses{pixel_y = 13; pixel_x = -4},/obj/item/weapon/storage/box/mugs{pixel_y = 12; pixel_x = 10},/obj/item/weapon/storage/box/condimentbottles{pixel_y = -1; pixel_x = -3},/obj/item/weapon/storage/box/donkpockets/random_amount{pixel_y = -1; pixel_x = 10},/turf/simulated/floor/wood,/area/mining_bar)
"aj" = (/obj/machinery/alarm,/turf/simulated/wall/mineral/wood,/area/mining_bar)
"ak" = (/obj/structure/closet/secure_closet/freezer/meat,/obj/structure/hanging_lantern{dir = 1},/turf/simulated/floor{dir = 8; icon_state = "barber"},/area/mining_bar)
"al" = (/obj/structure/closet/secure_closet/freezer/fridge,/turf/simulated/floor{dir = 8; icon_state = "barber"},/area/mining_bar)
"am" = (/turf/simulated/floor{dir = 8; icon_state = "barber"},/area/mining_bar)
"an" = (/obj/structure/closet/secure_closet/freezer/kitchen/mining,/turf/simulated/floor{dir = 8; icon_state = "barber"},/area/mining_bar)
"ao" = (/obj/structure/table,/obj/machinery/microwave,/turf/simulated/floor{dir = 8; icon_state = "barber"},/area/mining_bar)
"ap" = (/obj/structure/table,/obj/item/weapon/kitchen/rollingpin,/obj/structure/hanging_lantern{dir = 1},/turf/simulated/floor{dir = 8; icon_state = "barber"},/area/mining_bar)
"aq" = (/obj/structure/table,/obj/machinery/reagentgrinder,/turf/simulated/floor{dir = 8; icon_state = "barber"},/area/mining_bar)
"ar" = (/turf/simulated/floor/wood,/area/mining_bar)
"as" = (/obj/item/weapon/stool,/turf/simulated/floor/wood,/area/mining_bar)
"at" = (/turf/simulated/floor/carpet,/area/mining_bar)
"au" = (/obj/machinery/atmospherics/pipe/simple/supply/hidden{dir = 6},/turf/simulated/floor/plating,/area/mining_bar)
"av" = (/obj/machinery/atmospherics/pipe/simple/supply/hidden{dir = 10},/turf/simulated/floor/carpet,/area/mining_bar)
"aw" = (/obj/structure/piano/random{icon_state = "piano"; dir = 4},/turf/simulated/floor/wood,/area/mining_bar)
"ax" = (/obj/machinery/atmospherics/pipe/simple/supply/hidden,/turf/simulated/floor/plating,/area/mining_bar)
"ay" = (/obj/machinery/atmospherics/pipe/simple/supply/hidden{dir = 4},/turf/simulated/floor{dir = 8; icon_state = "barber"},/area/mining_bar)
"az" = (/obj/machinery/atmospherics/pipe/manifold/supply/hidden{dir = 1},/turf/simulated/floor{dir = 8; icon_state = "barber"},/area/mining_bar)
"aA" = (/obj/machinery/atmospherics/pipe/manifold/supply/hidden{dir = 4},/turf/simulated/floor/carpet,/area/mining_bar)
"aB" = (/obj/machinery/atmospherics/pipe/simple/supply/hidden{dir = 4},/turf/simulated/wall/mineral/wood,/area/mining_bar)
"aC" = (/obj/machinery/atmospherics/pipe/simple/supply/hidden{dir = 4},/turf/simulated/floor/plating,/area/mining_bar)
"aD" = (/obj/machinery/atmospherics/pipe/simple/supply/hidden,/obj/machinery/atmospherics/pipe/simple/scrubbers/hidden{dir = 4},/turf/simulated/floor{dir = 8; icon_state = "barber"},/area/mining_bar)
"aE" = (/obj/machinery/atmospherics/pipe/simple/supply/hidden,/obj/machinery/atmospherics/pipe/simple/scrubbers/hidden{dir = 4},/turf/simulated/floor/carpet,/area/mining_bar)
"aF" = (/obj/machinery/atmospherics/unary/vent_pump{dir = 1; external_pressure_bound = 101.325; on = 1},/turf/simulated/floor/carpet,/area/mining_bar)
"aG" = (/obj/machinery/atmospherics/unary/vent_scrubber{dir = 4; on = 0; scrub_CO2 = 0; scrub_Toxins = 0},/turf/simulated/floor/carpet,/area/mining_bar)
"aH" = (/obj/structure/table/woodentable,/obj/machinery/atmospherics/pipe/simple/scrubbers/hidden{dir = 9},/obj/item/weapon/reagent_containers/food/snacks/grilledcheese,/turf/simulated/floor/wood,/area/mining_bar)
"aI" = (/obj/machinery/atmospherics/unary/vent_scrubber{dir = 4; on = 0; scrub_CO2 = 0; scrub_Toxins = 0},/turf/simulated/floor{dir = 8; icon_state = "barber"},/area/mining_bar)
"aJ" = (/obj/machinery/atmospherics/pipe/simple/scrubbers/hidden{dir = 10},/turf/simulated/floor{dir = 8; icon_state = "barber"},/area/mining_bar)
"aK" = (/obj/machinery/atmospherics/unary/vent_pump{dir = 1; external_pressure_bound = 101.325; on = 1},/turf/simulated/floor{dir = 8; icon_state = "barber"},/area/mining_bar)
"aL" = (/obj/machinery/atmospherics/pipe/manifold/scrubbers/hidden{dir = 1},/turf/simulated/floor{dir = 8; icon_state = "barber"},/area/mining_bar)
"aN" = (/obj/machinery/atmospherics/pipe/simple/scrubbers/hidden{dir = 4},/turf/simulated/wall/mineral/wood,/area/mining_bar)
"aO" = (/obj/machinery/atmospherics/pipe/simple/scrubbers/hidden{dir = 4},/turf/simulated/floor/carpet,/area/mining_bar)
"aP" = (/obj/machinery/atmospherics/pipe/simple/scrubbers/hidden{dir = 4},/mob/living/silicon/robot/NPC/dusky,/turf/simulated/floor/carpet,/area/mining_bar)
"aQ" = (/obj/structure/table/woodentable,/obj/machinery/atmospherics/pipe/simple/supply/hidden,/turf/simulated/floor/wood,/area/mining_bar)
"aR" = (/obj/machinery/door/airlock/maintenance{name = "Bar Storage"; req_access_txt = 0; req_one_access_txt = "25;28"},/turf/simulated/floor/plating,/area/mining_bar)
"aS" = (/obj/structure/table/woodentable,/turf/simulated/floor/wood,/area/mining_bar)
"aT" = (/obj/machinery/atmospherics/pipe/manifold/scrubbers/hidden{dir = 8},/turf/simulated/floor{dir = 8; icon_state = "barber"},/area/mining_bar)
"aU" = (/obj/machinery/atmospherics/pipe/simple/scrubbers/hidden{dir = 4},/turf/simulated/floor{dir = 8; icon_state = "barber"},/area/mining_bar)
"aV" = (/obj/machinery/atmospherics/pipe/simple/scrubbers/hidden{dir = 9},/turf/simulated/floor{dir = 8; icon_state = "barber"},/area/mining_bar)
"aW" = (/obj/structure/bed/chair/comfy/couch/right/teal{dir = 8},/turf/simulated/floor/carpet,/area/mining_bar)
"aX" = (/obj/item/weapon/cigbutt,/turf/simulated/floor/plating,/area/mining_bar)
"aY" = (/obj/machinery/atmospherics/pipe/simple/supply/hidden{dir = 9; pixel_y = 0},/turf/simulated/floor/plating,/area/mining_bar)
"aZ" = (/obj/structure/bed/chair/comfy/couch/left/teal{dir = 8},/turf/simulated/floor/carpet,/area/mining_bar)
"ba" = (/obj/structure/hanging_lantern{dir = 1},/turf/unsimulated/floor/asteroid,/area/mine/explored)
"bb" = (/turf/simulated/wall/invulnerable/r_wall,/area/mining_bar)
"bc" = (/turf/simulated/floor/plating,/area/mining_bar)
"bd" = (/obj/machinery/atmospherics/pipe/simple/scrubbers/visible{icon_state = "intact"; dir = 1},/turf/simulated/wall/invulnerable/r_wall,/area/mining_bar)
"be" = (/turf/simulated/floor/engine,/area/mining_bar)
"bf" = (/obj/machinery/atmospherics/pipe/simple/scrubbers/visible,/turf/simulated/floor/engine,/area/mining_bar)
"bg" = (/obj/machinery/atmospherics/unary/tank/oxygen{starting_volume = 3200},/turf/simulated/floor/engine,/area/mining_bar)
"bh" = (/obj/machinery/power/terminal{dir = 1},/obj/structure/cable{icon_state = "0-4"; d2 = 4},/obj/machinery/power/apc{dir = 1; environ = 1; equipment = 1; lighting = 1; locked = 0; name = "apc"; pixel_y = 24},/turf/simulated/floor/engine,/area/mining_bar)
"bi" = (/obj/machinery/power/battery/smes,/obj/structure/cable{d2 = 8; icon_state = "0-8"},/turf/simulated/floor/engine,/area/mining_bar)
"bj" = (/obj/machinery/power/terminal{dir = 8},/obj/structure/cable{icon_state = "0-4"; d2 = 4},/turf/simulated/floor/engine,/area/mining_bar)
"bk" = (/obj/machinery/power/terminal{dir = 4},/obj/structure/cable{d2 = 8; icon_state = "0-8"},/turf/simulated/floor/engine,/area/mining_bar)
"bl" = (/obj/structure/bed/chair/comfy/couch/left/teal{icon_state = "couch_left"; dir = 4},/turf/simulated/floor/carpet,/area/mining_bar)
"bm" = (/obj/machinery/atmospherics/pipe/manifold/supply/visible{color = "#0000B7"; dir = 8; name = "Mix pipe"},/turf/simulated/floor/engine,/area/mining_bar)
"bn" = (/obj/machinery/atmospherics/pipe/simple/supply/visible{dir = 4},/turf/simulated/floor/engine,/area/mining_bar)
"bo" = (/obj/machinery/atmospherics/trinary/mixer{dir = 4; icon_state = "intact_on"; name = "Gas mixer (N2/O2)"; node1_concentration = 0.2; node2_concentration = 0.8; on = 1; target_pressure = 4500},/turf/simulated/floor/engine,/area/mining_bar)
"bp" = (/obj/structure/sink{dir = 8; pixel_x = -11},/turf/simulated/floor{dir = 8; icon_state = "barber"},/area/mining_bar)
"bq" = (/obj/structure/table/woodentable,/obj/item/ashtray/bronze,/obj/item/weapon/storage/fancy/matchbox,/obj/item/weapon/cigbutt/cigarbutt,/turf/simulated/floor/carpet,/area/mining_bar)
"br" = (/obj/structure/bed/chair/comfy/couch/right/teal{icon_state = "couch_right"; dir = 4},/turf/simulated/floor/carpet,/area/mining_bar)
"bs" = (/obj/machinery/atmospherics/pipe/simple/scrubbers/visible{icon_state = "intact"; dir = 5},/turf/simulated/floor/engine,/area/mining_bar)
"bt" = (/obj/machinery/atmospherics/trinary/filter/mirrored{dir = 8; filter_type = 1; icon_state = "hintactm_off"; on = 1},/turf/simulated/floor/engine,/area/mining_bar)
"bu" = (/obj/machinery/atmospherics/pipe/simple/scrubbers/visible{dir = 4},/turf/simulated/floor/engine,/area/mining_bar)
"bv" = (/obj/machinery/atmospherics/pipe/simple/scrubbers/visible{icon_state = "intact"; dir = 10},/turf/simulated/floor/engine,/area/mining_bar)
"bw" = (/obj/machinery/atmospherics/pipe/simple/supply/visible,/turf/simulated/floor/engine,/area/mining_bar)
"bx" = (/obj/machinery/atmospherics/pipe/simple/supply/hidden{dir = 6},/obj/structure/reagent_dispensers/beerkeg,/turf/simulated/floor{dir = 8; icon_state = "barber"},/area/mining_bar)
"by" = (/obj/abstract/map/spawner/robot/clean,/turf/simulated/floor/wood,/area/mining_bar)
"bz" = (/obj/abstract/map/spawner/maint,/obj/structure/rack,/obj/abstract/map/spawner/maint,/turf/simulated/floor/engine,/area/mining_bar)
"bA" = (/obj/machinery/atmospherics/trinary/filter/mirrored{dir = 1; filter_type = 2; icon_state = "hintactm_off"; on = 1},/turf/simulated/floor/engine,/area/mining_bar)
"bB" = (/obj/machinery/atmospherics/pipe/manifold/supply/visible,/turf/simulated/floor/engine,/area/mining_bar)
"bC" = (/obj/machinery/atmospherics/unary/tank/nitrogen{dir = 8},/turf/simulated/floor/engine,/area/mining_bar)
"bD" = (/obj/machinery/atmospherics/pipe/simple/supply/hidden{dir = 4},/obj/machinery/smartfridge/drinks,/turf/simulated/wall/mineral/wood,/area/mining_bar)
"bE" = (/obj/machinery/recharge_station,/turf/simulated/floor/engine,/area/mining_bar)
"bF" = (/obj/machinery/atmospherics/pipe/simple/scrubbers/visible{icon_state = "intact"; dir = 1},/turf/simulated/floor/engine,/area/mining_bar)
"bG" = (/obj/structure/table,/obj/item/weapon/storage/toolbox/mechanical,/turf/simulated/floor/engine,/area/mining_bar)
"bH" = (/obj/structure/table,/obj/item/weapon/storage/toolbox/robotics,/obj/item/weapon/book/manual/robotics_cyborgs,/turf/simulated/floor/engine,/area/mining_bar)
"bI" = (/obj/structure/table,/obj/abstract/map/spawner/engi/materials,/obj/abstract/map/spawner/engi/materials,/turf/simulated/floor/engine,/area/mining_bar)
"bJ" = (/obj/machinery/vaporizer,/turf/simulated/floor/engine,/area/mining_bar)
"bK" = (/obj/structure/sign/double/barsign/mining,/turf/simulated/wall/invulnerable/r_wall,/area/mining_bar)
"bL" = (/obj/structure/hanging_lantern{dir = 8},/turf/simulated/floor/engine,/area/mining_bar)
"bN" = (/turf/simulated/floor/plating{icon_state = "platingdmg3"},/area/mining_bar)
"bO" = (/turf/simulated/floor/plating{icon_state = "platingdmg2"},/area/mining_bar)
"bP" = (/turf/simulated/floor/plating{tag = "icon-panelscorched"; icon_state = "panelscorched"},/area/mining_bar)
"bQ" = (/obj/structure/window/reinforced/plasma,/obj/structure/window/reinforced/plasma{dir = 8},/obj/structure/window/reinforced/plasma{dir = 1},/obj/structure/grille,/turf/simulated/floor/plating,/area/mining_bar)
"bR" = (/obj/structure/window/reinforced/plasma,/obj/structure/window/reinforced/plasma{dir = 1},/obj/structure/grille,/turf/simulated/floor/plating,/area/mining_bar)
"bS" = (/obj/machinery/atmospherics/pipe/manifold/supply/hidden{dir = 1},/turf/simulated/floor/plating,/area/mining_bar)
"bT" = (/obj/structure/window/reinforced/plasma,/obj/structure/window/reinforced/plasma{dir = 1},/obj/structure/window/reinforced/plasma{dir = 4},/obj/structure/grille,/turf/simulated/floor/plating,/area/mining_bar)
"bU" = (/obj/effect/glowshroom,/turf/unsimulated/floor/asteroid,/area/mine/explored)
"bV" = (/obj/machinery/atmospherics/unary/vent{dir = 1},/turf/unsimulated/floor/asteroid,/area/mine/explored)
"bW" = (/turf/unsimulated/floor/asteroid,/area/mine/explored)
"bX" = (/turf/unsimulated/mineral/random,/area/mine/explored)
"bY" = (/obj/machinery/door/airlock/external,/obj/machinery/atmospherics/pipe/simple/supply/hidden,/turf/simulated/floor/plating,/area/mining_bar)
"bZ" = (/turf/simulated/wall/mineral/wood,/area/mine/explored)
"ca" = (/obj/machinery/door/airlock/external,/turf/simulated/floor/plating,/area/mine/explored)
"cb" = (/obj/machinery/atmospherics/unary/vent_pump{dir = 1; external_pressure_bound = 101.325; on = 1},/turf/simulated/floor/plating,/area/mine/explored)

(1,1,1) = {"
bXbXbXbXbXbXbXbXbXbXbXbXbXbXbXbXbXbXbXbXbX
bXbXabababbXbXbXabababababababababbXbXbXbX
bXababakababababababadafagahacarabajabbXbX
bXabalamanabaoapaqabbcauavataibcasawababbX
bXabbpambxaBayayazaCaCaAaFaGarbcbNbcarabbX
bXabaIaJaKabaIaLaDaNaOaEaPaHararbcbOarabbX
bXabamaTaUaUaUaVaKabaSaQaSaSbcarbNbNbcabbX
bXbbabaRababababababasaeasasbcaXarbyarabbX
bXbbbzbfbgbhbibjbkabbcaxbcbPbcbcblataWabbX
bXbbbzbfbmbnbnbobnbDbSaYbcarbParbrataZabbX
bXbbbLbsbtbubvbwbebbbYabbQbRbTabbqbcababbX
bXbbbEbebebebAbBbCbbcbbZbWbWbWababababbXbX
bXbbbbbGbHbIbFbJbbbbcabZbWbWbWbXbXbXbXbXbX
bXbXbbbbbbbbbdbKbbbWbWbabWbWbWbWbXbXbXbXbX
bXbXbXbXbXbXbVbWbWbWbWbWbWbUbWbWbWbWbUbXbX
bXbXbXbXbXbUbWbXbWbWbWbWbWbWbUbWbXbWbWbXbX
bXbXbXbXbWbWbXbXbXbXbWbWbWbWbXbXbXbWbWbXbX
bXbXbXbXbXbXbXbXbXbXbXbXbXbXbXbXbXbXbXbXbX
"}