"aa" = (/turf/unsimulated/wall/rock,/area/mine/explored)
"ab" = (/turf/simulated/wall/mineral/wood,/area/mining_bar)
"ac" = (/obj/structure/closet/secure_closet/freezer/meat,/obj/machinery/light{dir = 1},/turf/simulated/floor{dir = 8; icon_state = "barber"},/area/mining_bar)
"ad" = (/obj/structure/table/woodentable,/obj/item/weapon/reagent_containers/food/drinks/bottle/wine{pixel_z = 15; pixel_w = 4},/obj/item/weapon/reagent_containers/food/drinks/bottle/whiskey{pixel_z = 15; pixel_w = -8},/obj/item/weapon/reagent_containers/food/drinks/bottle/rum{pixel_z = 12; pixel_w = 13},/obj/item/weapon/reagent_containers/food/drinks/drinkingglass{pixel_z = 4; pixel_w = 2},/turf/simulated/floor/wood,/area/mining_bar)
"ae" = (/obj/structure/table/woodentable,/obj/machinery/light{dir = 1},/turf/simulated/floor/wood,/area/mining_bar)
"af" = (/obj/structure/table/woodentable,/obj/machinery/chem_dispenser/booze_dispenser{pixel_z = 18},/turf/simulated/floor/wood,/area/mining_bar)
"ag" = (/obj/structure/table/woodentable,/obj/machinery/chem_dispenser/soda_dispenser{pixel_z = 14; pixel_w = 0},/turf/simulated/floor/wood,/area/mining_bar)
"ah" = (/obj/structure/table/woodentable,/obj/machinery/chem_dispenser/brewer{pixel_z = 11},/turf/simulated/floor/wood,/area/mining_bar)
"ai" = (/obj/structure/table/woodentable,/obj/item/weapon/storage/box/drinkingglasses{pixel_z = 13; pixel_w = -4},/obj/item/weapon/storage/box/mugs{pixel_z = 12; pixel_w = 10},/obj/item/weapon/storage/box/condimentbottles{pixel_z = -1; pixel_w = -3},/obj/item/weapon/storage/box/donkpockets/random_amount{pixel_z = -1; pixel_w = 10},/turf/simulated/floor/wood,/area/mining_bar)
"aj" = (/obj/machinery/alarm,/turf/simulated/wall/mineral/wood,/area/mining_bar)
"ak" = (/obj/machinery/light{dir = 1},/turf/simulated/floor/wood,/area/mining_bar)
"al" = (/obj/structure/closet/secure_closet/freezer/fridge,/turf/simulated/floor{dir = 8; icon_state = "barber"},/area/mining_bar)
"am" = (/turf/simulated/floor{dir = 8; icon_state = "barber"},/area/mining_bar)
"an" = (/obj/structure/closet/secure_closet/freezer/kitchen/mining,/turf/simulated/floor{dir = 8; icon_state = "barber"},/area/mining_bar)
"ao" = (/obj/structure/table,/obj/machinery/microwave,/turf/simulated/floor{dir = 8; icon_state = "barber"},/area/mining_bar)
"ap" = (/obj/structure/table,/obj/item/weapon/kitchen/rollingpin,/turf/simulated/floor{dir = 8; icon_state = "barber"},/area/mining_bar)
"aq" = (/obj/structure/table,/obj/machinery/reagentgrinder,/turf/simulated/floor{dir = 8; icon_state = "barber"},/area/mining_bar)
"ar" = (/turf/simulated/floor/wood,/area/mining_bar)
"as" = (/obj/machinery/atmospherics/pipe/simple/supply/hidden{dir = 6},/turf/simulated/floor/wood,/area/mining_bar)
"at" = (/obj/machinery/atmospherics/pipe/manifold/supply/hidden{dir = 1},/turf/simulated/floor/wood,/area/mining_bar)
"au" = (/obj/machinery/atmospherics/pipe/simple/supply/hidden{dir = 4},/turf/simulated/floor/wood,/area/mining_bar)
"av" = (/obj/structure/table/woodentable,/obj/machinery/atmospherics/pipe/simple/supply/hidden{dir = 10},/obj/machinery/light{dir = 1},/turf/simulated/floor/wood,/area/mining_bar)
"aw" = (/obj/machinery/atmospherics/pipe/simple/supply/hidden{dir = 6},/turf/simulated/floor{dir = 8; icon_state = "barber"},/area/mining_bar)
"ax" = (/obj/machinery/atmospherics/pipe/simple/supply/hidden{dir = 4},/turf/simulated/wall/mineral/wood,/area/mining_bar)
"ay" = (/obj/machinery/atmospherics/pipe/simple/supply/hidden{dir = 4},/turf/simulated/floor{dir = 8; icon_state = "barber"},/area/mining_bar)
"az" = (/obj/machinery/atmospherics/pipe/manifold/supply/hidden{dir = 1},/turf/simulated/floor{dir = 8; icon_state = "barber"},/area/mining_bar)
"aA" = (/obj/machinery/atmospherics/pipe/simple/supply/hidden{dir = 9},/turf/simulated/floor/wood,/area/mining_bar)
"aB" = (/obj/machinery/atmospherics/unary/vent_pump{dir = 1; external_pressure_bound = 101.325; on = 1},/turf/simulated/floor/wood,/area/mining_bar)
"aC" = (/obj/machinery/atmospherics/unary/vent_scrubber{dir = 4; on = 0; scrub_CO2 = 0; scrub_Toxins = 0},/turf/simulated/floor/wood,/area/mining_bar)
"aD" = (/obj/machinery/atmospherics/pipe/simple/scrubbers/hidden{dir = 10},/turf/simulated/floor/wood,/area/mining_bar)
"aE" = (/obj/structure/table/woodentable,/obj/machinery/atmospherics/pipe/simple/supply/hidden,/turf/simulated/floor/wood,/area/mining_bar)
"aF" = (/obj/structure/bed/chair/wood/normal{icon_state = "wooden_chair"; dir = 4},/turf/simulated/floor/wood,/area/mining_bar)
"aG" = (/obj/structure/table/woodentable,/obj/item/candle,/turf/simulated/floor/wood,/area/mining_bar)
"aH" = (/obj/structure/bed/chair/wood/normal{icon_state = "wooden_chair"; dir = 8},/turf/simulated/floor/wood,/area/mining_bar)
"aI" = (/obj/machinery/atmospherics/unary/vent_scrubber{dir = 4; on = 0; scrub_CO2 = 0; scrub_Toxins = 0},/turf/simulated/floor{dir = 8; icon_state = "barber"},/area/mining_bar)
"aJ" = (/obj/machinery/atmospherics/pipe/simple/scrubbers/hidden{dir = 10},/turf/simulated/floor{dir = 8; icon_state = "barber"},/area/mining_bar)
"aK" = (/obj/machinery/atmospherics/unary/vent_pump{dir = 1; external_pressure_bound = 101.325; on = 1},/turf/simulated/floor{dir = 8; icon_state = "barber"},/area/mining_bar)
"aL" = (/obj/machinery/atmospherics/pipe/manifold/scrubbers/hidden{dir = 1},/turf/simulated/floor{dir = 8; icon_state = "barber"},/area/mining_bar)
"aM" = (/obj/machinery/atmospherics/pipe/simple/scrubbers/hidden{dir = 4},/obj/machinery/atmospherics/pipe/simple/supply/hidden,/turf/simulated/floor{dir = 8; icon_state = "barber"},/area/mining_bar)
"aN" = (/obj/machinery/atmospherics/pipe/simple/scrubbers/hidden{dir = 4},/turf/simulated/wall/mineral/wood,/area/mining_bar)
"aO" = (/obj/machinery/atmospherics/pipe/simple/scrubbers/hidden{dir = 4},/turf/simulated/floor/wood,/area/mining_bar)
"aP" = (/obj/machinery/atmospherics/pipe/simple/scrubbers/hidden{dir = 4},/mob/living/silicon/robot/NPC/dusky,/turf/simulated/floor/wood,/area/mining_bar)
"aQ" = (/obj/machinery/atmospherics/pipe/manifold/scrubbers/hidden,/turf/simulated/floor/wood,/area/mining_bar)
"aR" = (/obj/machinery/atmospherics/pipe/simple/scrubbers/hidden{dir = 4},/obj/machinery/atmospherics/pipe/simple/supply/hidden,/turf/simulated/floor/wood,/area/mining_bar)
"aS" = (/obj/structure/table/woodentable,/turf/simulated/floor/wood,/area/mining_bar)
"aT" = (/obj/machinery/atmospherics/pipe/manifold/scrubbers/hidden{dir = 8},/turf/simulated/floor{dir = 8; icon_state = "barber"},/area/mining_bar)
"aU" = (/obj/machinery/atmospherics/pipe/simple/scrubbers/hidden{dir = 4},/turf/simulated/floor{dir = 8; icon_state = "barber"},/area/mining_bar)
"aV" = (/obj/machinery/atmospherics/pipe/simple/scrubbers/hidden{dir = 9},/turf/simulated/floor{dir = 8; icon_state = "barber"},/area/mining_bar)
"aW" = (/obj/structure/table/woodentable,/obj/machinery/light{dir = 8},/turf/simulated/floor/wood,/area/mining_bar)
"aX" = (/obj/machinery/atmospherics/pipe/simple/scrubbers/hidden,/turf/simulated/floor/wood,/area/mining_bar)
"aY" = (/obj/machinery/light{dir = 4},/turf/simulated/floor/wood,/area/mining_bar)
"aZ" = (/obj/machinery/door/airlock/maintenance{name = "Bar Storage"; req_access_txt = 0; req_one_access_txt = "25;28"},/obj/machinery/atmospherics/pipe/simple/scrubbers/hidden,/turf/simulated/floor/plating,/area/mining_bar)
"ba" = (/obj/item/weapon/stool,/turf/simulated/floor/wood,/area/mining_bar)
"bb" = (/obj/machinery/atmospherics/pipe/simple/supply/hidden,/turf/simulated/floor/wood,/area/mining_bar)
"bc" = (/turf/simulated/floor/plating,/area/mining_bar)
"bd" = (/obj/machinery/atmospherics/pipe/simple/scrubbers/visible{icon_state = "intact"; dir = 1},/turf/simulated/floor/plating,/area/mining_bar)
"be" = (/obj/machinery/atmospherics/unary/tank/oxygen{starting_volume = 3200},/turf/simulated/floor/plating,/area/mining_bar)
"bf" = (/obj/machinery/power/terminal{dir = 1},/obj/structure/cable{icon_state = "0-4"; d2 = 4},/obj/machinery/power/apc{dir = 1; environ = 1; equipment = 1; lighting = 1; locked = 0; name = "apc"; pixel_y = 24},/turf/simulated/floor/plating,/area/mining_bar)
"bg" = (/obj/machinery/power/battery/smes,/obj/structure/cable{d2 = 8; icon_state = "0-8"},/turf/simulated/floor/plating,/area/mining_bar)
"bh" = (/obj/machinery/power/terminal{dir = 8},/obj/structure/cable{icon_state = "0-4"; d2 = 4},/turf/simulated/floor/plating,/area/mining_bar)
"bi" = (/obj/machinery/power/terminal{dir = 4},/obj/structure/cable{d2 = 8; icon_state = "0-8"},/turf/simulated/floor/plating,/area/mining_bar)
"bj" = (/obj/machinery/atmospherics/pipe/manifold/scrubbers/hidden{dir = 4},/turf/simulated/floor/wood,/area/mining_bar)
"bk" = (/obj/machinery/light{dir = 8},/turf/simulated/floor/plating,/area/mining_bar)
"bl" = (/obj/machinery/atmospherics/pipe/manifold/supply{icon_state = "map"; dir = 8},/turf/simulated/floor/plating,/area/mining_bar)
"bm" = (/obj/machinery/atmospherics/pipe/simple/supply/visible{icon_state = "intact"; dir = 8},/turf/simulated/floor/plating,/area/mining_bar)
"bn" = (/obj/machinery/atmospherics/trinary/mixer{dir = 4; icon_state = "intact_on"; name = "Gas mixer (N2/O2)"; node1_concentration = 0.2; node2_concentration = 0.8; on = 1; target_pressure = 4500},/turf/simulated/floor/plating,/area/mining_bar)
"bo" = (/obj/machinery/atmospherics/pipe/manifold/supply/hidden,/turf/simulated/floor/wood,/area/mining_bar)
"bp" = (/obj/machinery/atmospherics/unary/vent_pump{dir = 8; on = 1},/turf/simulated/floor/wood,/area/mining_bar)
"bq" = (/obj/machinery/atmospherics/pipe/simple/scrubbers/visible{icon_state = "intact"; dir = 5},/turf/simulated/floor/plating,/area/mining_bar)
"br" = (/obj/machinery/atmospherics/trinary/filter/mirrored{icon_state = "hintactm_off"; dir = 8},/turf/simulated/floor/plating,/area/mining_bar)
"bs" = (/obj/machinery/atmospherics/pipe/simple/scrubbers/visible{icon_state = "intact"; dir = 8},/turf/simulated/floor/plating,/area/mining_bar)
"bt" = (/obj/machinery/atmospherics/pipe/simple/scrubbers/visible{icon_state = "intact"; dir = 10},/turf/simulated/floor/plating,/area/mining_bar)
"bu" = (/obj/machinery/atmospherics/pipe/simple/supply/visible{icon_state = "intact"; dir = 1},/turf/simulated/floor/plating,/area/mining_bar)
"bv" = (/obj/machinery/light{dir = 4},/turf/simulated/floor/plating,/area/mining_bar)
"bw" = (/obj/machinery/door/airlock/external,/obj/machinery/atmospherics/pipe/simple/supply/hidden,/turf/simulated/floor/plating,/area/mining_bar)
"bx" = (/obj/structure/bed/chair/wood/normal,/turf/simulated/floor/wood,/area/mining_bar)
"by" = (/obj/structure/bed/chair/wood/normal,/obj/machinery/atmospherics/pipe/simple/scrubbers/hidden,/turf/simulated/floor/wood,/area/mining_bar)
"bz" = (/obj/machinery/atmospherics/trinary/filter/mirrored{icon_state = "hintactm_off"; dir = 1},/turf/simulated/floor/plating,/area/mining_bar)
"bA" = (/obj/machinery/atmospherics/pipe/manifold/supply/visible,/turf/simulated/floor/plating,/area/mining_bar)
"bB" = (/obj/machinery/atmospherics/unary/tank/nitrogen{dir = 8},/turf/simulated/floor/plating,/area/mining_bar)
"bC" = (/obj/machinery/suit_storage_unit,/turf/simulated/floor/plating,/area/mining_bar)
"bD" = (/obj/machinery/atmospherics/unary/vent_pump{dir = 1; external_pressure_bound = 101.325; on = 1},/turf/simulated/floor/plating,/area/mining_bar)
"bE" = (/obj/machinery/atmospherics/unary/vent_scrubber{dir = 4; on = 0; scrub_CO2 = 0; scrub_Toxins = 0},/obj/machinery/light/small{dir = 4; on = 1},/turf/simulated/floor/plating,/area/mining_bar)
"bF" = (/obj/machinery/atmospherics/pipe/manifold/scrubbers/hidden{dir = 1},/turf/simulated/wall/mineral/wood,/area/mining_bar)
"bG" = (/obj/machinery/atmospherics/pipe/manifold/scrubbers/hidden{dir = 1},/obj/machinery/light{dir = 8},/turf/simulated/floor/wood,/area/mining_bar)
"bH" = (/obj/structure/table/woodentable,/obj/item/candle,/obj/machinery/atmospherics/pipe/simple/scrubbers/hidden{dir = 4},/turf/simulated/floor/wood,/area/mining_bar)
"bI" = (/obj/structure/table/woodentable,/obj/machinery/atmospherics/pipe/simple/scrubbers/hidden{dir = 4},/turf/simulated/floor/wood,/area/mining_bar)
"bJ" = (/obj/structure/table/woodentable,/obj/item/candle,/obj/machinery/atmospherics/pipe/simple/scrubbers/hidden{dir = 9},/turf/simulated/floor/wood,/area/mining_bar)
"bK" = (/obj/machinery/suit_storage_unit,/obj/machinery/light/small{dir = 8},/turf/simulated/floor/plating,/area/mining_bar)
"bL" = (/obj/machinery/atmospherics/unary/vent_scrubber{dir = 4; on = 0; scrub_CO2 = 0; scrub_Toxins = 0},/turf/simulated/floor/plating,/area/mining_bar)
"bM" = (/obj/machinery/atmospherics/pipe/manifold/scrubbers/hidden,/turf/simulated/wall/mineral/wood,/area/mining_bar)
"bN" = (/obj/machinery/atmospherics/pipe/simple/scrubbers/hidden{dir = 9},/turf/simulated/floor/wood,/area/mining_bar)
"bO" = (/obj/structure/bed/chair/wood/normal{icon_state = "wooden_chair"; dir = 1},/turf/simulated/floor/wood,/area/mining_bar)
"bP" = (/obj/machinery/light,/turf/simulated/floor/plating,/area/mining_bar)
"bQ" = (/obj/machinery/atmospherics/pipe/simple/scrubbers,/turf/simulated/wall/mineral/wood,/area/mining_bar)
"bR" = (/obj/structure/sign/double/barsign/mining,/turf/simulated/wall/mineral/wood,/area/mining_bar)
"bS" = (/obj/machinery/door/airlock/external,/turf/simulated/floor/plating,/area/mining_bar)
"bT" = (/obj/machinery/computer/arcade,/obj/machinery/light,/turf/simulated/floor/wood,/area/mining_bar)
"bU" = (/obj/effect/glowshroom,/turf/unsimulated/floor/asteroid,/area/mine/explored)
"bV" = (/obj/machinery/atmospherics/unary/vent{dir = 1},/turf/unsimulated/floor/asteroid,/area/mine/explored)
"bW" = (/turf/unsimulated/floor/asteroid,/area/mine/explored)
"bX" = (/turf/unsimulated/mineral/random,/area/mine/explored)
"bY" = (/turf/unsimulated/mineral/random,/area/mine/unexplored)
"bZ" = (/turf/unsimulated/floor/asteroid,/area/mine/unexplored)
"ca" = (/turf/unsimulated/floor/asteroid/cave,/area/mine/unexplored)
"cb" = (/obj/machinery/atmospherics/pipe/simple/scrubbers/visible,/turf/simulated/floor/plating,/area/mining_bar)

(1,1,1) = {"
aaaaaaaaaaaaaaaaaaaaaaaaaaaaaaaaaaaaaaaaaaaaaaaaaa
aaaaabababaaaaaaabababababababababaaaaaaabababaaaa
aaababacababababababadaeafagahaiababajababakababaa
aaabalamanabaoapaqabarasatauauauavararararararabaa
aaabamamawaxayayazauauaAaBaCaDaraEararaFaGaHarabaa
aaabaIaJaKabaIaLaMaNaOaOaPaOaQaOaRaOaDaFaSaHarabaa
aaabamaTaUaUaUaVaKabaWaSaSaSaSaSaEaraXarararaYabaa
aaababaZababababababbababababababbaraXararararabaa
aaabbcbdbebfbgbhbiabararararararbbaCbjaFaGaHarabaa
aaabbkbdblbmbmbnbmaxauatatauauaubobpaXaFaSaHarabaa
aaabbcbqbrbsbtbubvababbwbwajabarbxbxbyararararabaa
aaabbcbcbcbcbzbAbBabbCbDbDbEbFbGbHbIbJararararabaa
aaabbcbcbcbccbbcbcabbKbcbcbLbMbNbObObOararbaarabaa
aaababbPababbQbRabababbSbSababababababababbTababaa
aaaaabababbUbVbWbWbWbWbWbWbUbWbWbWbWbUbUabababaaaa
aaaaaaaaaabUbWbXbWbWbWbWbWbWbUbWbXbWbWbXaaaaaaaaaa
bYbYbYbYbZbZbYbYbYbYbZbZbZbZbYbYbYbZbZbYbYbYbYbYbY
bYbYbYbZbZbZbYbYbYbYcabYbZbZbYbYbZbZbYbYbYbYbYbYbY
bYbYbYbYbYbYbYbYbYbYbYbYbYbYbYbYbYbYbYbYbYbYbYbYbY
"}
