//MAP CONVERTED BY dmm2tgm.py THIS HEADER COMMENT PREVENTS RECONVERSION, DO NOT REMOVE
"a" = (
/obj/structure/shuttle/diag_wall/smooth{
	dir = 8
	},
/turf/unsimulated/mineral,
/area/mining_surprise)
"b" = (
/obj/structure/shuttle/diag_wall/smooth{
	dir = 1
	},
/turf/unsimulated/mineral,
/area/mining_surprise)
"c" = (
/obj/machinery/door/unpowered/shuttle,
/turf/simulated/floor/shuttle,
/area/mining_surprise)
"e" = (
/obj/structure/flora/rock/pile,
/turf/unsimulated/floor/asteroid,
/area/mining_surprise)
"f" = (
/obj/effect/decal/cleanable/soot,
/obj/structure/boulder,
/turf/unsimulated/floor/asteroid,
/area/mining_surprise)
"g" = (
/obj/effect/decal/cleanable/dirt,
/turf/unsimulated/floor/asteroid,
/area/mining_surprise)
"j" = (
/obj/effect/decal/cleanable/soot,
/turf/unsimulated/floor/asteroid,
/area/mining_surprise)
"k" = (
/obj/item/device/radio/intercom{
	dir = 4;
	name = "Station Intercom (General)";
	pixel_x = 27
	},
/obj/structure/bed/chair/shuttle{
	dir = 1
	},
/obj/item/weapon/paper/crumpled{
	info = "The rambling journal of a man whose pod never made it back to Central Command. The last entry reads, 'Dear journal, I think this is it for me. I really wish I took the shuttle...'"
	},
/obj/effect/decal/cleanable/dirt,
/turf/simulated/floor/shuttle,
/area/mining_surprise)
"m" = (
/turf/unsimulated/floor/asteroid,
/area/mining_surprise)
"p" = (
/turf/simulated/wall/shuttle,
/area/mining_surprise)
"q" = (
/obj/structure/grille,
/obj/structure/window/reinforced{
	dir = 8
	},
/obj/structure/window/reinforced,
/obj/item/weapon/shard{
	icon_state = "small";
	pixel_x = 5;
	pixel_y = -5
	},
/obj/item/weapon/shard,
/turf/simulated/floor/shuttle/plating,
/area/mining_surprise)
"u" = (
/obj/machinery/media/receiver/boombox/wallmount/shuttle{
	pixel_x = -32
	},
/obj/structure/bed/chair/shuttle{
	dir = 1
	},
/obj/effect/decal/remains/human,
/obj/item/clothing/head/dunce_cap{
	pixel_y = 8
	},
/obj/effect/decal/cleanable/dirt,
/turf/simulated/floor/shuttle,
/area/mining_surprise)
"x" = (
/obj/structure/shuttle/engine/propulsion/left,
/obj/effect/decal/cleanable/soot,
/turf/simulated/floor/plating,
/area/mining_surprise)
"z" = (
/obj/structure/shuttle/engine/propulsion/right,
/obj/effect/decal/cleanable/soot,
/turf/simulated/floor/plating,
/area/mining_surprise)
"C" = (
/obj/effect/decal/cleanable/dirt,
/obj/item/weapon/storage/fancy/donut_box/empty,
/turf/unsimulated/floor/asteroid,
/area/mining_surprise)
"F" = (
/turf/unsimulated/mineral,
/area/mining_surprise)
"G" = (
/obj/effect/decal/cleanable/soot,
/obj/effect/decal/cleanable/soot,
/obj/item/stack/rods,
/turf/unsimulated/floor/asteroid,
/area/mining_surprise)
"J" = (
/obj/effect/decal/cleanable/dirt,
/obj/item/stack/rods,
/turf/unsimulated/floor/asteroid,
/area/mining_surprise)
"R" = (
/obj/item/device/flashlight/flare,
/turf/unsimulated/floor/asteroid,
/area/mining_surprise)
"Y" = (
/obj/structure/boulder,
/obj/effect/decal/cleanable/dirt,
/turf/unsimulated/floor/asteroid,
/area/mining_surprise)

(1,1,1) = {"
F
F
F
F
F
F
F
F
F
F
F
F
F
F
"}
(2,1,1) = {"
F
F
F
F
F
F
F
Y
F
F
F
F
F
F
"}
(3,1,1) = {"
a
p
p
x
j
C
j
g
e
F
Y
F
F
F
"}
(4,1,1) = {"
q
u
k
c
j
j
R
m
m
m
m
R
J
F
"}
(5,1,1) = {"
b
p
p
z
G
j
j
j
m
F
g
e
F
F
"}
(6,1,1) = {"
F
F
F
F
f
f
F
F
F
F
F
F
F
F
"}
(7,1,1) = {"
F
F
F
F
F
F
F
F
F
F
F
F
F
F
"}
