//MAP CONVERTED BY dmm2tgm.py THIS HEADER COMMENT PREVENTS RECONVERSION, DO NOT REMOVE
"aa" = (
/turf/unsimulated/mineral,
/area/asteroid)
"ab" = (
/turf/unsimulated/floor/asteroid,
/area/asteroid)
"ac" = (
/turf/unsimulated/mineral,
/turf/simulated/wall/shuttle/unsmoothed{
	icon_state = "diagonalWall3"
	},
/area/asteroid)
"ad" = (
/turf/unsimulated/mineral,
/turf/simulated/wall/shuttle/unsmoothed{
	dir = 4;
	icon_state = "diagonalWall3"
	},
/area/asteroid)
"ae" = (
/obj/structure/boulder,
/obj/effect/decal/cleanable/dirt,
/turf/unsimulated/floor/asteroid,
/area/asteroid)
"af" = (
/turf/unsimulated/floor/asteroid,
/turf/simulated/wall/shuttle/unsmoothed{
	dir = 8;
	icon_state = "diagonalWall3"
	},
/area/asteroid)
"ag" = (
/turf/unsimulated/floor/asteroid,
/turf/simulated/wall/shuttle/unsmoothed{
	dir = 1;
	icon_state = "diagonalWall3"
	},
/area/asteroid)
"ah" = (
/obj/effect/decal/cleanable/scattered_sand,
/turf/unsimulated/floor/asteroid,
/area/asteroid)
"ai" = (
/obj/structure/door_assembly/door_assembly_ext,
/turf/simulated/floor/plating,
/area/asteroid)
"aj" = (
/turf/unsimulated/floor/asteroid,
/turf/simulated/wall/shuttle/unsmoothed{
	icon_state = "diagonalWall3"
	},
/area/asteroid)
"ak" = (
/obj/item/stack/rods,
/obj/effect/decal/cleanable/dirt,
/turf/unsimulated/floor/asteroid,
/area/asteroid)
"aq" = (
/obj/structure/grille/window_spawner/reinforced,
/turf/simulated/floor/plating,
/area/asteroid)
"dg" = (
/obj/effect/decal/cleanable/dirt,
/turf/simulated/floor/shuttle{
	icon_state = "floor3"
	},
/area/asteroid)
"ep" = (
/obj/structure/bed/chair,
/turf/simulated/floor/shuttle{
	icon_state = "floor3"
	},
/area/asteroid)
"et" = (
/obj/structure/bed/chair{
	dir = 1
	},
/turf/simulated/floor/shuttle{
	icon_state = "floor3"
	},
/area/asteroid)
"fb" = (
/obj/effect/decal/cleanable/dirt,
/obj/effect/decal/cleanable/blood/drip{
	basecolor = "#2299FC"
	},
/obj/effect/decal/cleanable/blood/drip{
	basecolor = "#2299FC";
	pixel_x = 6;
	pixel_y = 11
	},
/turf/simulated/floor/shuttle{
	icon_state = "floor3"
	},
/area/asteroid)
"fO" = (
/obj/item/weapon/rack_parts,
/obj/abstract/map/spawner/assistant/materials,
/turf/simulated/floor/shuttle{
	icon_state = "floor3"
	},
/area/asteroid)
"fQ" = (
/turf/simulated/wall/shuttle/unsmoothed{
	dir = 1;
	icon_state = "wall3"
	},
/area/asteroid)
"gb" = (
/obj/effect/decal/cleanable/scattered_sand,
/obj/item/weapon/shard,
/turf/unsimulated/floor/asteroid,
/area/asteroid)
"jk" = (
/obj/structure/window/reinforced{
	dir = 1
	},
/obj/structure/grille/broken,
/obj/effect/decal/cleanable/dirt,
/obj/item/weapon/shard,
/turf/simulated/floor/plating,
/area/asteroid)
"kr" = (
/obj/structure/grille,
/obj/structure/window/reinforced{
	one_way = 1
	},
/obj/structure/window/reinforced{
	dir = 8
	},
/obj/item/weapon/shard{
	icon_state = "small"
	},
/obj/item/weapon/shard{
	icon_state = "small";
	pixel_x = 5;
	pixel_y = -5
	},
/turf/simulated/floor/plating,
/area/asteroid)
"kv" = (
/obj/effect/decal/cleanable/soot,
/obj/effect/decal/cleanable/blood/gibs/robot/down,
/obj/effect/decal/cleanable/blood/oil/streak,
/turf/unsimulated/floor/asteroid,
/area/asteroid)
"md" = (
/obj/structure/bed/chair,
/obj/effect/decal/cleanable/blood/splatter{
	basecolor = "#2299FC"
	},
/obj/effect/landmark/corpse/vox/crossbow/space,
/turf/simulated/floor/shuttle{
	icon_state = "floor2"
	},
/area/asteroid)
"mr" = (
/obj/structure/shuttle/engine/heater,
/obj/effect/decal/cleanable/soot,
/turf/unsimulated/floor/asteroid,
/area/asteroid)
"mw" = (
/obj/effect/decal/cleanable/soot,
/obj/effect/decal/cleanable/blood/oil/streak,
/turf/unsimulated/floor/asteroid,
/area/asteroid)
"ng" = (
/obj/effect/decal/cleanable/dirt,
/obj/item/stack/sheet/metal{
	amount = 2
	},
/turf/unsimulated/floor/asteroid,
/area/asteroid)
"oT" = (
/obj/effect/decal/cleanable/soot,
/obj/item/weapon/shard{
	icon_state = "medium"
	},
/turf/unsimulated/floor/asteroid,
/area/asteroid)
"oY" = (
/obj/effect/decal/cleanable/soot,
/obj/item/weapon/shard{
	icon_state = "small";
	pixel_x = 5;
	pixel_y = -5
	},
/turf/unsimulated/floor/asteroid,
/area/asteroid)
"px" = (
/obj/machinery/light/broken{
	dir = 4
	},
/turf/simulated/floor/shuttle{
	icon_state = "floor3"
	},
/area/asteroid)
"qx" = (
/obj/structure/computerframe{
	anchored = 1
	},
/obj/effect/decal/cleanable/scattered_sand,
/turf/simulated/floor/plating,
/area/asteroid)
"qV" = (
/obj/effect/decal/cleanable/soot,
/obj/item/stack/rods,
/turf/simulated/floor/plating,
/area/asteroid)
"tD" = (
/obj/effect/decal/cleanable/dirt,
/obj/item/weapon/broken_bottle,
/turf/simulated/floor/shuttle{
	icon_state = "floor3"
	},
/area/asteroid)
"vG" = (
/obj/structure/shuttle/engine/propulsion{
	dir = 1
	},
/obj/effect/decal/cleanable/dirt,
/turf/unsimulated/floor/asteroid,
/area/asteroid)
"vT" = (
/obj/item/weapon/rack_parts,
/turf/simulated/floor/shuttle{
	icon_state = "floor3"
	},
/area/asteroid)
"wB" = (
/obj/structure/table/reinforced,
/obj/structure/window/reinforced{
	dir = 1
	},
/obj/abstract/map/spawner/maint,
/turf/simulated/floor/shuttle{
	icon_state = "floor3"
	},
/area/asteroid)
"xL" = (
/obj/structure/window/reinforced{
	dir = 1
	},
/obj/effect/decal/cleanable/scattered_sand,
/obj/item/stack/rods,
/turf/simulated/floor/shuttle{
	icon_state = "floor2"
	},
/area/asteroid)
"xQ" = (
/obj/item/weapon/rack_parts,
/turf/unsimulated/floor/asteroid,
/area/asteroid)
"yG" = (
/obj/structure/grille/broken,
/obj/effect/decal/cleanable/dirt,
/turf/simulated/floor/plating,
/area/asteroid)
"yN" = (
/obj/item/weapon/shard{
	icon_state = "medium"
	},
/turf/unsimulated/floor/asteroid,
/area/asteroid)
"zj" = (
/obj/effect/decal/cleanable/soot,
/turf/simulated/floor/plating,
/area/asteroid)
"zy" = (
/obj/structure/grille,
/obj/item/weapon/shard,
/obj/structure/window/reinforced{
	one_way = 1
	},
/obj/structure/window/reinforced{
	dir = 8
	},
/turf/simulated/floor/plating,
/area/asteroid)
"zG" = (
/obj/item/weapon/shard{
	icon_state = "small";
	pixel_x = 5;
	pixel_y = -5
	},
/obj/structure/grille/window_spawner/reinforced,
/turf/simulated/floor/plating,
/area/asteroid)
"Ar" = (
/obj/item/stack/sheet/metal,
/turf/unsimulated/floor/asteroid,
/area/asteroid)
"BM" = (
/obj/structure/shuttle/engine/heater{
	dir = 1
	},
/obj/structure/window/reinforced,
/turf/simulated/floor/plating,
/area/asteroid)
"Cp" = (
/obj/structure/grille,
/obj/structure/window/reinforced{
	dir = 8
	},
/obj/item/weapon/shard,
/turf/simulated/floor/plating,
/area/asteroid)
"CW" = (
/obj/effect/decal/cleanable/dirt,
/obj/effect/decal/cleanable/blood/drip{
	basecolor = "#2299FC";
	pixel_x = 6;
	pixel_y = 11
	},
/obj/effect/decal/cleanable/blood/drip{
	basecolor = "#2299FC"
	},
/obj/effect/decal/cleanable/blood/splatter{
	basecolor = "#2299FC"
	},
/turf/simulated/floor/shuttle{
	icon_state = "floor3"
	},
/area/asteroid)
"Dc" = (
/obj/effect/decal/cleanable/soot,
/turf/simulated/floor/plating{
	icon_state = "platingdmg1";
	tag = "icon-platingdmg1"
	},
/area/asteroid)
"Dh" = (
/obj/structure/window/reinforced{
	dir = 8
	},
/obj/structure/window/reinforced{
	dir = 1
	},
/obj/structure/grille/broken,
/obj/effect/decal/cleanable/dirt,
/obj/item/weapon/shard{
	icon_state = "medium"
	},
/turf/simulated/floor/plating,
/area/asteroid)
"DA" = (
/obj/effect/decal/cleanable/dirt,
/obj/item/stack/rods,
/turf/unsimulated/floor/asteroid,
/area/asteroid)
"DD" = (
/obj/structure/girder,
/turf/simulated/floor/plating,
/area/asteroid)
"DO" = (
/obj/structure/bed/chair,
/obj/machinery/light/broken{
	dir = 1
	},
/turf/simulated/floor/shuttle{
	icon_state = "floor3"
	},
/area/asteroid)
"FS" = (
/obj/structure/flora/pottedplant/claypot,
/turf/simulated/floor/shuttle{
	icon_state = "floor3"
	},
/area/asteroid)
"FX" = (
/obj/effect/decal/cleanable/scattered_sand,
/obj/effect/decal/cleanable/soot,
/obj/effect/decal/cleanable/blood/gibs/robot/down,
/obj/item/weapon/shard{
	icon_state = "small";
	pixel_x = 5;
	pixel_y = -5
	},
/obj/effect/decal/cleanable/blood/oil/streak,
/turf/unsimulated/floor/asteroid,
/area/asteroid)
"Gd" = (
/obj/structure/flora/rock/pile,
/turf/unsimulated/floor/asteroid,
/area/asteroid)
"Hf" = (
/obj/effect/decal/cleanable/soot,
/obj/effect/decal/cleanable/dirt,
/turf/unsimulated/floor/asteroid,
/area/asteroid)
"HZ" = (
/obj/structure/flora/rock,
/turf/unsimulated/floor/asteroid,
/area/asteroid)
"IT" = (
/obj/item/weapon/rack_parts,
/obj/abstract/map/spawner/assistant/tools,
/turf/simulated/floor/shuttle{
	icon_state = "floor3"
	},
/area/asteroid)
"KY" = (
/obj/structure/grille/window_spawner/reinforced,
/turf/simulated/floor/plating/vox,
/area/asteroid)
"LV" = (
/obj/effect/decal/cleanable/soot,
/turf/simulated/floor/shuttle{
	icon_state = "floor3"
	},
/area/asteroid)
"Rl" = (
/obj/structure/shuttle/engine/propulsion{
	dir = 4
	},
/obj/effect/decal/cleanable/soot,
/turf/unsimulated/floor/asteroid,
/area/asteroid)
"Rs" = (
/obj/structure/grille,
/obj/structure/window/reinforced{
	dir = 4
	},
/turf/simulated/floor/plating,
/area/asteroid)
"RR" = (
/obj/effect/decal/cleanable/dirt,
/turf/unsimulated/floor/asteroid,
/area/asteroid)
"RW" = (
/obj/structure/table,
/obj/effect/decal/cleanable/scattered_sand,
/obj/abstract/map/spawner/maint,
/turf/simulated/floor/shuttle{
	icon_state = "floor2"
	},
/area/asteroid)
"Sc" = (
/obj/structure/table,
/obj/item/weapon/shard,
/obj/item/weapon/reagent_containers/food/drinks/bottle/whiskey,
/turf/simulated/floor/shuttle{
	icon_state = "floor2"
	},
/area/asteroid)
"SD" = (
/obj/effect/decal/cleanable/dirt,
/turf/simulated/floor/plating{
	icon_state = "platingdmg1";
	tag = "icon-platingdmg1"
	},
/area/asteroid)
"SR" = (
/obj/item/weapon/shard{
	icon_state = "small";
	pixel_x = 5;
	pixel_y = -5
	},
/turf/simulated/floor/plating,
/area/asteroid)
"TS" = (
/obj/structure/table/reinforced,
/obj/structure/window/reinforced{
	dir = 1
	},
/obj/item/weapon/crossbow,
/turf/simulated/floor/shuttle{
	icon_state = "floor3"
	},
/area/asteroid)
"UB" = (
/obj/effect/decal/cleanable/scattered_sand,
/obj/effect/decal/cleanable/soot,
/obj/effect/decal/cleanable/dirt,
/obj/item/stack/rods,
/turf/unsimulated/floor/asteroid,
/area/asteroid)
"UU" = (
/obj/effect/decal/cleanable/scattered_sand,
/obj/structure/grille/broken,
/obj/effect/decal/cleanable/dirt,
/obj/item/weapon/shard{
	icon_state = "small";
	pixel_x = 5;
	pixel_y = -5
	},
/obj/item/stack/rods,
/turf/simulated/floor/plating,
/area/asteroid)
"VF" = (
/obj/item/weapon/table_parts/reinforced,
/turf/simulated/floor/shuttle{
	icon_state = "floor3"
	},
/area/asteroid)
"Wf" = (
/obj/item/weapon/shard{
	icon_state = "small"
	},
/turf/unsimulated/floor/asteroid,
/area/asteroid)
"WG" = (
/obj/effect/decal/cleanable/dirt,
/obj/effect/decal/cleanable/blood/splatter{
	basecolor = "#2299FC"
	},
/obj/effect/landmark/corpse/vox/crossbow/space,
/turf/simulated/floor/shuttle{
	icon_state = "floor3"
	},
/area/asteroid)
"WZ" = (
/obj/effect/decal/cleanable/soot,
/obj/effect/decal/cleanable/dirt,
/obj/item/stack/rods,
/turf/unsimulated/floor/asteroid,
/area/asteroid)
"Xz" = (
/obj/structure/bed/chair{
	dir = 1
	},
/obj/effect/decal/cleanable/dirt,
/turf/simulated/floor/shuttle{
	icon_state = "floor3"
	},
/area/asteroid)
"Yj" = (
/obj/structure/boulder,
/turf/unsimulated/floor/asteroid,
/area/asteroid)
"Yk" = (
/obj/effect/decal/cleanable/soot,
/turf/unsimulated/floor/asteroid,
/area/asteroid)
"YD" = (
/obj/structure/door_assembly/door_assembly_ext{
	anchored = 1
	},
/turf/simulated/floor/shuttle{
	icon_state = "floor3"
	},
/area/asteroid)
"Zb" = (
/obj/effect/decal/cleanable/soot,
/turf/simulated/floor/plating{
	icon_state = "platingdmg2"
	},
/area/asteroid)
"Zc" = (
/obj/structure/table/reinforced,
/turf/simulated/floor/shuttle{
	icon_state = "floor3"
	},
/area/asteroid)
"Zl" = (
/obj/effect/decal/cleanable/soot,
/obj/item/weapon/broken_bottle,
/turf/simulated/floor/plating,
/area/asteroid)
"Zv" = (
/obj/machinery/light/broken{
	dir = 8
	},
/obj/item/weapon/table_parts,
/obj/abstract/map/spawner/space/supply,
/turf/simulated/floor/shuttle{
	icon_state = "floor3"
	},
/area/asteroid)
"ZQ" = (
/turf/simulated/floor/shuttle{
	icon_state = "floor3"
	},
/area/asteroid)
"ZU" = (
/obj/structure/window/reinforced{
	dir = 1
	},
/obj/item/weapon/shard{
	icon_state = "small";
	pixel_x = 5;
	pixel_y = -5
	},
/turf/simulated/floor/shuttle{
	icon_state = "floor2"
	},
/area/asteroid)

(1,1,1) = {"
aa
aa
aa
aa
aa
aa
aa
aa
aa
aa
aa
aa
aa
aa
aa
aa
aa
aa
aa
aa
aa
aa
aa
aa
aa
aa
aa
aa
"}
(2,1,1) = {"
aa
aa
aa
aa
aa
aa
aa
aa
aa
aa
aa
aa
Yj
RR
Gd
aa
aa
aa
aa
aa
aa
aa
aa
aa
aa
aa
aa
aa
"}
(3,1,1) = {"
aa
aa
aa
aa
aa
aa
aa
ab
ab
aa
aa
Yj
ab
RR
RR
xQ
Yj
aa
aa
aa
aa
aa
aa
aa
aa
aa
aa
aa
"}
(4,1,1) = {"
aa
aa
aa
aa
aa
aa
aa
mw
RR
ab
ab
ab
ab
ab
DA
RR
RR
RR
aa
Yj
aa
aa
aa
aa
aa
aa
aa
aa
"}
(5,1,1) = {"
aa
aa
aa
Yj
aa
UB
mr
oT
Hf
RR
ab
ab
RR
af
ai
YD
aj
Wf
yN
RR
aa
aa
aa
aa
aa
aa
aa
aa
"}
(6,1,1) = {"
aa
aa
ah
FX
Rl
Yk
Hf
WZ
ab
ab
ab
ab
Yk
Zb
zj
LV
fQ
DD
yG
zy
ac
RR
Gd
aa
aa
aa
aa
aa
"}
(7,1,1) = {"
aa
ak
ab
Yk
gb
kv
Gd
ab
ab
RR
ab
Yk
oY
qV
Dc
SD
TS
Zv
dg
fO
fQ
aq
aj
ab
Yj
aa
aa
aa
"}
(8,1,1) = {"
ae
RR
RR
Ar
ab
ab
RR
RR
Gd
RR
ab
RR
RR
jk
Zl
zj
VF
WG
fb
CW
xL
Sc
Dh
RR
aa
aa
aa
aa
"}
(9,1,1) = {"
aa
aa
ab
ab
ab
RR
ab
RR
RR
HZ
ab
RR
RR
zG
ep
SR
Zc
Xz
tD
ZQ
md
qx
UU
RR
ab
aa
aa
aa
"}
(10,1,1) = {"
aa
Yj
ab
Gd
aa
Yj
ng
ab
ab
RR
RR
RR
ab
fQ
DO
ZQ
wB
ZQ
dg
et
ZU
RW
Rs
ab
ab
Yj
aa
aa
"}
(11,1,1) = {"
aa
aa
aa
aa
aa
aa
aa
Yj
ab
ab
ab
RR
vG
BM
FS
ZQ
ZQ
px
IT
vT
fQ
KY
ad
RR
Yj
aa
aa
aa
"}
(12,1,1) = {"
aa
aa
aa
aa
aa
aa
aa
aa
aa
ab
ab
ab
ab
ag
fQ
fQ
fQ
fQ
Cp
kr
ad
aa
aa
aa
aa
aa
aa
aa
"}
(13,1,1) = {"
aa
aa
aa
aa
aa
aa
aa
aa
aa
aa
ab
aa
Yj
aa
aa
aa
aa
aa
aa
aa
aa
aa
aa
aa
aa
aa
aa
aa
"}
(14,1,1) = {"
aa
aa
aa
aa
aa
aa
aa
aa
aa
aa
aa
aa
aa
aa
aa
aa
aa
aa
aa
aa
aa
aa
aa
aa
aa
aa
aa
aa
"}
