"a" = (/obj/structure/shuttle/diag_wall/smooth{dir = 8},/turf/unsimulated/mineral,/area/asteroid)
"b" = (/obj/structure/shuttle/diag_wall/smooth{dir = 1},/turf/unsimulated/mineral,/area/asteroid)
"c" = (/obj/machinery/door/unpowered/shuttle,/turf/simulated/floor/shuttle,/area/asteroid)
"e" = (/obj/structure/flora/rock/pile,/turf/unsimulated/floor/asteroid,/area/asteroid)
"f" = (/obj/effect/decal/cleanable/soot,/obj/structure/boulder,/turf/unsimulated/floor/asteroid,/area/asteroid)
"g" = (/obj/effect/decal/cleanable/dirt,/turf/unsimulated/floor/asteroid,/area/asteroid)
"j" = (/obj/effect/decal/cleanable/soot,/turf/unsimulated/floor/asteroid,/area/asteroid)
"k" = (/obj/item/device/radio/intercom{dir = 4; name = "Station Intercom (General)"; pixel_x = 27},/obj/structure/bed/chair/shuttle{dir = 1},/obj/item/weapon/paper/crumpled{info = "The rambling journal of a man whose pod never made it back to Central Command. The last entry reads, 'Dear journal, I think this is it for me. I really wish I took the shuttle...'"},/obj/effect/decal/cleanable/dirt,/turf/simulated/floor/shuttle,/area/asteroid)
"m" = (/turf/unsimulated/floor/asteroid,/area/asteroid)
"p" = (/turf/simulated/wall/shuttle,/area/asteroid)
"q" = (/obj/structure/grille,/obj/structure/window/reinforced{dir = 8},/obj/structure/window/reinforced,/obj/item/weapon/shard{icon_state = "small"; pixel_x = 5; pixel_y = -5},/obj/item/weapon/shard,/turf/simulated/floor/shuttle/plating,/area/asteroid)
"u" = (/obj/machinery/media/receiver/boombox/wallmount/shuttle{pixel_x = -32},/obj/structure/bed/chair/shuttle{dir = 1},/obj/effect/decal/remains/human,/obj/item/clothing/head/dunce_cap{pixel_y = 8},/obj/effect/decal/cleanable/dirt,/turf/simulated/floor/shuttle,/area/asteroid)
"x" = (/obj/structure/shuttle/engine/propulsion/left,/obj/effect/decal/cleanable/soot,/turf/simulated/floor/plating,/area/asteroid)
"z" = (/obj/structure/shuttle/engine/propulsion/right,/obj/effect/decal/cleanable/soot,/turf/simulated/floor/plating,/area/asteroid)
"C" = (/obj/effect/decal/cleanable/dirt,/obj/item/weapon/storage/fancy/donut_box/empty,/turf/unsimulated/floor/asteroid,/area/asteroid)
"F" = (/turf/unsimulated/mineral,/area/asteroid)
"G" = (/obj/effect/decal/cleanable/soot,/obj/effect/decal/cleanable/soot,/obj/item/stack/rods,/turf/unsimulated/floor/asteroid,/area/asteroid)
"J" = (/obj/effect/decal/cleanable/dirt,/obj/item/stack/rods,/turf/unsimulated/floor/asteroid,/area/asteroid)
"R" = (/obj/item/device/flashlight/flare,/turf/unsimulated/floor/asteroid,/area/asteroid)
"Y" = (/obj/structure/boulder,/obj/effect/decal/cleanable/dirt,/turf/unsimulated/floor/asteroid,/area/asteroid)

(1,1,1) = {"
FFaqbFF
FFpupFF
FFpkpFF
FFxczFF
FFjjGfF
FFCjjfF
FFjRjFF
FYgmjFF
FFemmFF
FFFmFFF
FFYmgFF
FFFReFF
FFFJFFF
FFFFFFF
"}
