//MAP CONVERTED BY dmm2tgm.py THIS HEADER COMMENT PREVENTS RECONVERSION, DO NOT REMOVE
"a" = (
/turf/unsimulated/mineral/random,
/area/mining_surprise)
"b" = (
/turf/unsimulated/mineral/random,
/turf/simulated/wall/cult{
	icon_state = "cult0"
	},
/area/mining_surprise)
"c" = (
/obj/structure/cult/pillar,
/turf/simulated/floor/engine/cult,
/area/mining_surprise)
"d" = (
/turf/simulated/floor/engine/cult,
/area/mining_surprise)
"e" = (
/obj/structure/grille/cult,
/turf/simulated/floor/engine/cult,
/area/mining_surprise)
"f" = (
/obj/structure/cult_legacy/forge,
/turf/simulated/floor/engine/cult,
/area/mining_surprise)
"g" = (
/turf/simulated/wall/cult{
	icon_state = "cult0"
	},
/area/mining_surprise)
"h" = (
/obj/effect/gateway/active/cult,
/turf/simulated/floor/engine/cult,
/area/mining_surprise)
"i" = (
/obj/item/candle/blood{
	lit = 1;
	wax = 50000
	},
/turf/simulated/floor/engine/cult,
/area/mining_surprise)
"j" = (
/mob/living/simple_animal/hostile/faithless/cult,
/turf/simulated/floor/engine/cult,
/area/mining_surprise)
"k" = (
/mob/living/simple_animal/hostile/scarybat/cult,
/turf/simulated/floor/engine/cult,
/area/mining_surprise)
"l" = (
/obj/item/clothing/suit/space/plasmaman/cultist,
/turf/simulated/floor/engine/cult,
/area/mining_surprise)
"m" = (
/obj/structure/cult_legacy/talisman{
	icon_state = "altar";
	name = "Foresaken Altar"
	},
/obj/item/weapon/coin/iron{
	pixel_x = 6;
	pixel_y = 3
	},
/obj/item/weapon/reagent_containers/food/drinks/cult/bloodfilled{
	pixel_y = 8
	},
/turf/simulated/floor/engine/cult,
/area/mining_surprise)
"n" = (
/obj/item/clothing/head/helmet/space/plasmaman/cultist,
/turf/simulated/floor/engine/cult,
/area/mining_surprise)
"o" = (
/obj/structure/cult_legacy/tome,
/turf/simulated/floor/engine/cult,
/area/mining_surprise)
"p" = (
/obj/structure/cult_legacy/talisman,
/turf/simulated/floor/engine/cult,
/area/mining_surprise)
"q" = (
/obj/effect/decal/cleanable/blood{
	icon_state = "floor4"
	},
/turf/simulated/floor/carpet,
/area/mining_surprise)
"r" = (
/obj/effect/decal/cleanable/blood{
	icon_state = "gibbl4"
	},
/turf/simulated/floor/carpet,
/area/mining_surprise)
"s" = (
/obj/item/weapon/storage/cult{
	pixel_y = 6
	},
/obj/structure/table/woodentable,
/turf/simulated/floor/engine/cult,
/area/mining_surprise)
"t" = (
/obj/effect/decal/cleanable/blood{
	icon_state = "floor7"
	},
/turf/simulated/floor/engine/cult,
/area/mining_surprise)
"A" = (
/obj/structure/table/woodentable,
/obj/item/weapon/kitchen/utensil/knife/large/ritual{
	pixel_y = 8
	},
/turf/simulated/floor/engine/cult,
/area/mining_surprise)
"D" = (
/obj/structure/cult/pillar/alt,
/turf/simulated/floor/engine/cult,
/area/mining_surprise)
"L" = (
/obj/structure/table/woodentable,
/turf/simulated/floor/engine/cult,
/area/mining_surprise)
"T" = (
/turf/simulated/floor/carpet,
/area/mining_surprise)
"Z" = (
/obj/effect/decal/cleanable/blood{
	icon_state = "floor4"
	},
/turf/simulated/floor/engine/cult,
/area/mining_surprise)

(1,1,1) = {"
a
a
a
a
a
a
a
a
a
a
a
a
a
a
a
"}
(2,1,1) = {"
a
a
a
a
a
b
c
j
c
b
a
a
a
a
a
"}
(3,1,1) = {"
a
a
a
a
e
d
g
T
g
L
e
a
a
a
a
"}
(4,1,1) = {"
a
a
a
e
h
j
e
q
e
s
d
e
a
a
a
"}
(5,1,1) = {"
a
a
e
d
i
d
e
T
e
L
i
d
e
a
a
"}
(6,1,1) = {"
a
b
f
d
d
g
g
T
g
g
d
j
p
b
a
"}
(7,1,1) = {"
a
c
g
d
Z
g
i
l
i
g
d
d
g
c
a
"}
(8,1,1) = {"
a
d
d
d
d
d
k
m
k
d
d
d
d
d
a
"}
(9,1,1) = {"
a
D
g
d
d
g
i
n
i
g
d
t
g
D
a
"}
(10,1,1) = {"
a
b
f
d
j
g
g
T
g
g
d
d
h
b
a
"}
(11,1,1) = {"
a
a
e
d
i
L
e
T
e
j
i
d
e
a
a
"}
(12,1,1) = {"
a
a
a
e
d
A
e
r
e
d
d
e
a
a
a
"}
(13,1,1) = {"
a
a
a
a
e
L
g
T
g
o
e
a
a
a
a
"}
(14,1,1) = {"
a
a
a
a
a
b
D
j
D
b
a
a
a
a
a
"}
(15,1,1) = {"
a
a
a
a
a
a
a
a
a
a
a
a
a
a
a
"}
