//MAP CONVERTED BY dmm2tgm.py THIS HEADER COMMENT PREVENTS RECONVERSION, DO NOT REMOVE
"a" = (
/turf/unsimulated/mineral/random/high_chance,
/area/mining_surprise)
"c" = (
/obj/item/stack/ore/telecrystal{
	pixel_x = 5;
	pixel_y = 5
	},
/obj/item/stack/ore/telecrystal{
	pixel_x = -5;
	pixel_y = 5
	},
/obj/item/stack/ore/telecrystal,
/turf/unsimulated/floor/asteroid/underground,
/area/mining_surprise)
"e" = (
/obj/item/stack/ore/diamond,
/turf/unsimulated/floor/asteroid/underground,
/area/mining_surprise)
"j" = (
/obj/structure/crystal,
/turf/unsimulated/floor/asteroid/underground,
/area/mining_surprise)
"y" = (
/obj/item/stack/ore/telecrystal,
/turf/unsimulated/floor/asteroid/underground,
/area/mining_surprise)
"z" = (
/turf/unsimulated/floor/asteroid/underground,
/area/mining_surprise)
"D" = (
/obj/structure/crystal,
/turf/unsimulated/mineral/snow{
	mined_type = /turf/unsimulated/floor/asteroid/underground
	},
/area/mining_surprise)
"E" = (
/obj/item/stack/ore/diamond{
	pixel_x = 3;
	pixel_y = 3
	},
/obj/item/stack/ore/diamond,
/turf/unsimulated/floor/asteroid/underground,
/area/mining_surprise)
"O" = (
/turf/unsimulated/mineral/snow{
	mined_type = /turf/unsimulated/floor/asteroid/underground
	},
/area/mining_surprise)
"X" = (
/obj/item/stack/ore/telecrystal,
/obj/item/stack/ore/telecrystal{
	pixel_x = 5;
	pixel_y = 10
	},
/turf/unsimulated/floor/asteroid/underground,
/area/mining_surprise)

(1,1,1) = {"
a
a
a
a
a
a
a
a
a
a
a
a
a
a
a
a
a
a
a
a
"}
(2,1,1) = {"
a
a
a
a
a
a
a
a
a
a
a
a
a
a
a
a
a
a
a
a
"}
(3,1,1) = {"
a
a
a
a
a
a
a
a
a
a
a
a
a
a
a
O
a
a
a
a
"}
(4,1,1) = {"
a
a
a
a
a
a
a
a
a
a
a
O
a
a
a
O
O
a
a
a
"}
(5,1,1) = {"
a
a
a
a
a
a
a
a
a
a
a
a
a
a
O
a
a
a
a
a
"}
(6,1,1) = {"
a
a
a
a
a
a
a
a
a
a
a
a
a
a
a
O
a
a
a
a
"}
(7,1,1) = {"
a
a
a
a
a
a
a
a
a
O
O
O
a
a
a
a
a
a
a
a
"}
(8,1,1) = {"
a
a
a
a
a
O
a
a
O
j
D
y
O
a
a
a
a
a
a
O
"}
(9,1,1) = {"
a
a
a
a
a
a
a
O
O
j
E
j
z
O
a
a
a
a
a
a
"}
(10,1,1) = {"
a
a
a
a
a
a
O
D
j
z
z
z
X
j
O
a
a
a
a
a
"}
(11,1,1) = {"
a
a
a
a
a
a
O
z
c
z
z
z
j
O
O
a
a
a
a
a
"}
(12,1,1) = {"
a
O
a
O
a
a
O
O
j
z
z
z
y
j
O
a
a
a
a
a
"}
(13,1,1) = {"
a
O
O
a
a
a
a
O
e
z
y
j
e
O
a
a
a
a
a
a
"}
(14,1,1) = {"
a
O
a
a
O
O
O
a
O
D
j
z
D
a
a
a
a
a
a
a
"}
(15,1,1) = {"
a
a
O
a
a
O
O
O
a
O
D
O
a
a
a
a
a
a
a
a
"}
(16,1,1) = {"
a
O
O
a
a
a
O
a
a
a
a
a
a
a
a
a
a
O
a
a
"}
(17,1,1) = {"
O
O
a
a
a
O
a
a
a
a
a
a
a
a
a
a
O
a
a
a
"}
(18,1,1) = {"
a
a
a
a
a
a
a
a
a
a
a
a
a
a
a
a
a
a
a
a
"}
(19,1,1) = {"
a
a
a
a
a
a
a
a
a
a
a
a
a
a
a
a
a
a
a
a
"}
(20,1,1) = {"
a
a
a
a
a
a
a
a
a
a
a
a
a
a
a
a
a
a
a
a
"}
