//MAP CONVERTED BY dmm2tgm.py THIS HEADER COMMENT PREVENTS RECONVERSION, DO NOT REMOVE
"a" = (
/turf/unsimulated/floor/asteroid/hive,
/area/mining_surprise)
"i" = (
/turf/unsimulated/mineral/random/hive/high_chance,
/area/mining_surprise)
"j" = (
/turf/unsimulated/mineral/random,
/area/mining_surprise)
"s" = (
/turf/unsimulated/mineral/random/hive/high_chance_clown,
/area/mining_surprise)
"v" = (
/turf/unsimulated/mineral/random/hive,
/area/mining_surprise)
"A" = (
/mob/living/simple_animal/hostile/asteroid/hivelord/boss,
/turf/unsimulated/floor/asteroid/hive/living,
/area/mining_surprise)
"F" = (
/mob/living/simple_animal/hostile/asteroid/hivelord/guardian,
/turf/unsimulated/floor/asteroid/hive,
/area/mining_surprise)
"G" = (
/turf/unsimulated/mineral/hyperdense,
/area/mining_surprise)
"H" = (
/mob/living/simple_animal/hostile/asteroid/hivelord/guardian,
/turf/unsimulated/floor/asteroid/hive/living,
/area/mining_surprise)
"L" = (
/obj/item/asteroid/hivelord_core{
	time_left = 288000
	},
/turf/unsimulated/floor/asteroid/hive/living,
/area/mining_surprise)
"N" = (
/turf/unsimulated/mineral/hyperdense/hive,
/area/mining_surprise)
"S" = (
/turf/unsimulated/mineral/telecrystal/hive,
/area/mining_surprise)
"U" = (
/turf/unsimulated/floor/asteroid/hive/living,
/area/mining_surprise)
"Z" = (
/obj/item/asteroid/hivelord_core{
	time_left = 288000
	},
/turf/unsimulated/floor/asteroid/hive,
/area/mining_surprise)

(1,1,1) = {"
G
G
N
N
N
G
N
G
G
N
N
N
G
N
G
G
N
G
G
N
N
G
N
G
N
N
G
"}
(2,1,1) = {"
G
v
v
v
v
v
v
j
v
j
v
v
v
v
j
v
v
j
v
v
v
v
j
v
v
v
N
"}
(3,1,1) = {"
N
v
v
v
i
i
a
v
a
v
v
U
U
U
v
a
v
a
a
a
a
v
v
a
i
v
N
"}
(4,1,1) = {"
N
v
v
a
a
U
a
a
a
a
a
a
a
U
U
a
U
a
i
i
a
a
U
a
a
v
G
"}
(5,1,1) = {"
N
v
i
U
U
a
U
U
a
a
i
a
i
a
a
U
U
a
a
a
U
a
i
a
v
j
G
"}
(6,1,1) = {"
G
v
i
a
a
a
a
Z
a
i
i
a
U
a
i
H
i
a
i
a
L
a
a
a
a
v
N
"}
(7,1,1) = {"
N
v
a
a
H
a
i
i
a
i
U
a
U
U
a
a
U
i
i
a
U
a
i
a
i
v
G
"}
(8,1,1) = {"
N
v
v
a
U
U
a
a
a
a
a
U
U
a
i
a
a
a
a
i
a
a
i
U
i
j
G
"}
(9,1,1) = {"
N
v
a
a
U
U
U
i
a
i
a
a
U
a
a
U
a
U
U
U
U
i
a
U
a
v
N
"}
(10,1,1) = {"
N
j
a
U
U
i
a
U
a
a
a
i
a
a
i
i
a
a
U
i
U
U
i
U
i
j
N
"}
(11,1,1) = {"
G
v
a
a
a
i
a
U
a
a
i
i
S
s
s
s
i
a
a
U
a
U
U
U
i
v
N
"}
(12,1,1) = {"
N
v
a
i
a
a
a
a
U
a
S
i
s
U
U
U
s
S
a
U
a
U
a
a
a
v
G
"}
(13,1,1) = {"
N
j
a
a
a
U
i
a
U
U
U
U
U
U
U
U
U
i
a
L
a
F
a
i
a
v
N
"}
(14,1,1) = {"
G
j
i
a
Z
U
a
a
a
a
U
U
U
A
U
U
U
U
a
U
a
i
i
i
i
j
G
"}
(15,1,1) = {"
G
v
i
a
U
a
a
i
a
a
i
s
U
U
U
s
i
a
U
a
U
a
a
a
a
v
N
"}
(16,1,1) = {"
N
v
a
U
U
U
a
U
a
a
a
i
s
s
s
i
i
U
U
U
a
U
a
a
i
v
N
"}
(17,1,1) = {"
N
v
a
U
a
a
i
U
a
U
a
a
i
i
i
S
a
a
a
a
i
a
i
a
i
v
N
"}
(18,1,1) = {"
G
v
i
U
a
i
i
a
a
a
U
U
a
a
S
i
a
a
a
i
a
a
a
U
U
j
N
"}
(19,1,1) = {"
G
j
i
a
a
U
a
a
a
i
a
U
U
a
a
a
U
a
U
a
a
i
L
a
a
v
G
"}
(20,1,1) = {"
N
v
a
a
a
U
i
a
a
i
S
a
U
i
a
a
U
i
i
a
a
a
U
a
a
j
G
"}
(21,1,1) = {"
G
v
a
U
a
a
U
i
U
a
a
a
U
a
i
a
F
a
a
i
a
i
U
a
i
v
N
"}
(22,1,1) = {"
G
j
a
a
U
i
a
F
i
i
a
a
a
a
a
U
a
U
a
U
U
U
U
i
a
v
G
"}
(23,1,1) = {"
N
v
i
a
a
a
a
U
U
U
a
i
U
L
i
a
i
i
i
U
U
a
a
a
i
j
G
"}
(24,1,1) = {"
N
v
v
a
a
U
U
U
U
a
U
a
a
U
a
U
a
a
a
a
U
U
a
a
i
v
N
"}
(25,1,1) = {"
N
j
v
v
v
a
U
a
a
U
a
v
v
a
U
U
v
v
U
a
i
i
a
U
i
v
G
"}
(26,1,1) = {"
G
v
j
v
v
v
v
j
v
v
v
v
v
v
j
v
v
v
v
v
j
v
v
j
v
v
N
"}
(27,1,1) = {"
G
G
N
G
N
N
G
N
G
N
G
N
N
G
G
N
N
N
G
G
N
N
N
G
G
N
G
"}
