//MAP CONVERTED BY dmm2tgm.py THIS HEADER COMMENT PREVENTS RECONVERSION, DO NOT REMOVE
"a" = (
/turf/unsimulated/floor/asteroid/hive,
/area/asteroid)
"i" = (
/turf/unsimulated/mineral/random/hive/high_chance,
/area/asteroid)
"j" = (
/turf/unsimulated/mineral/random,
/area/asteroid)
"s" = (
/turf/unsimulated/mineral/random/hive/high_chance_clown,
/area/asteroid)
"v" = (
/turf/unsimulated/mineral/random/hive,
/area/asteroid)
"A" = (
/mob/living/simple_animal/hostile/asteroid/hivelord/boss,
/turf/unsimulated/floor/asteroid/hive,
/area/asteroid)
"B" = (
/obj/item/stack/ore/telecrystal,
/turf/unsimulated/floor/asteroid/hive/living,
/area/asteroid)
"F" = (
/mob/living/simple_animal/hostile/asteroid/hivelord{
	name = "hivelord guardian";
	desc = "A direct subject to the Hivelord Queen 'Maria', will protect the hive indiscriminately."
	},
/turf/unsimulated/floor/asteroid/hive,
/area/asteroid)
"G" = (
/turf/unsimulated/mineral/hyperdense,
/area/asteroid)
"H" = (
/mob/living/simple_animal/hostile/asteroid/hivelord{
	name = "hivelord guardian";
	desc = "A direct subject to the Hivelord Queen 'Maria', will protect the hive indiscriminately."
	},
/turf/unsimulated/floor/asteroid/hive/living,
/area/asteroid)
"L" = (
/obj/item/asteroid/hivelord_core{
	time_left = 288000
	},
/turf/unsimulated/floor/asteroid/hive/living,
/area/asteroid)
"N" = (
/turf/unsimulated/mineral/hyperdense/hive,
/area/asteroid)
"S" = (
/obj/item/stack/ore/telecrystal,
/turf/unsimulated/floor/asteroid/hive,
/area/asteroid)
"U" = (
/turf/unsimulated/floor/asteroid/hive/living,
/area/asteroid)
"Z" = (
/obj/item/asteroid/hivelord_core{
	time_left = 288000
	},
/turf/unsimulated/floor/asteroid/hive,
/area/asteroid)

(1,1,1) = {"
G
G
N
N
N
G
N
G
G
N
N
N
G
N
G
G
N
G
G
N
N
G
N
G
N
N
G
"}
(2,1,1) = {"
G
v
v
v
v
v
v
j
v
j
v
v
v
v
j
v
v
j
v
v
v
v
j
v
v
v
N
"}
(3,1,1) = {"
N
v
v
v
i
i
a
v
a
v
v
a
a
a
v
a
v
a
a
a
a
v
v
a
i
v
N
"}
(4,1,1) = {"
N
v
v
a
a
a
a
a
a
a
a
a
a
a
a
a
a
a
s
s
a
a
U
a
a
v
G
"}
(5,1,1) = {"
N
v
i
a
a
a
a
a
a
a
s
a
s
a
a
a
a
a
a
a
U
a
a
a
v
j
G
"}
(6,1,1) = {"
G
v
i
a
a
a
a
Z
a
i
s
a
U
a
s
H
i
a
s
a
L
a
a
a
a
v
N
"}
(7,1,1) = {"
N
v
a
a
H
a
s
i
a
s
U
a
U
U
a
a
a
i
s
a
U
a
s
a
i
v
G
"}
(8,1,1) = {"
N
v
v
a
a
a
a
a
a
a
a
U
U
a
s
a
a
a
a
i
a
a
s
a
i
j
G
"}
(9,1,1) = {"
N
v
a
a
a
a
a
i
a
s
a
a
a
a
a
a
a
a
a
U
a
s
a
a
a
v
N
"}
(10,1,1) = {"
N
j
a
a
a
i
a
U
a
a
a
a
a
a
s
s
a
a
U
i
a
a
s
a
i
j
N
"}
(11,1,1) = {"
G
v
a
a
a
s
a
U
a
a
s
s
a
s
s
s
s
a
a
U
a
a
a
a
i
v
N
"}
(12,1,1) = {"
N
v
a
i
a
a
a
a
U
a
a
s
s
B
B
S
s
a
a
U
a
a
a
a
a
v
G
"}
(13,1,1) = {"
N
j
a
a
a
U
i
a
U
a
a
a
a
a
U
U
a
s
a
L
a
F
a
i
a
v
N
"}
(14,1,1) = {"
G
j
i
a
Z
a
a
a
a
a
U
U
U
A
U
U
U
a
a
a
a
s
i
i
i
j
G
"}
(15,1,1) = {"
G
v
i
a
U
a
a
s
a
a
s
s
S
B
B
s
s
a
a
a
U
a
a
a
a
v
N
"}
(16,1,1) = {"
N
v
a
U
U
a
a
U
a
a
a
s
s
s
s
s
s
a
a
U
a
U
a
a
i
v
N
"}
(17,1,1) = {"
N
v
a
U
a
a
i
U
a
a
a
a
s
s
s
s
a
a
a
a
i
a
U
a
i
v
N
"}
(18,1,1) = {"
G
v
i
U
a
s
i
a
a
a
a
a
a
a
a
s
a
a
a
i
a
a
a
a
a
j
N
"}
(19,1,1) = {"
G
j
i
a
a
U
a
a
a
s
a
U
U
a
a
a
U
a
U
a
a
s
L
a
a
v
G
"}
(20,1,1) = {"
N
v
a
a
a
U
s
a
a
i
i
a
U
i
a
a
U
i
i
a
a
a
U
a
a
j
G
"}
(21,1,1) = {"
G
v
a
U
a
a
U
i
U
a
a
a
U
a
s
a
F
a
a
s
a
s
U
a
i
v
N
"}
(22,1,1) = {"
G
j
a
a
U
s
a
F
i
i
a
a
a
a
a
a
a
a
a
U
a
a
U
s
a
v
G
"}
(23,1,1) = {"
N
v
i
a
a
a
a
U
U
U
a
s
U
L
s
a
s
s
s
a
a
a
a
a
i
j
G
"}
(24,1,1) = {"
N
v
v
a
a
U
U
U
U
a
a
a
a
a
a
a
a
a
a
a
U
U
a
a
i
v
N
"}
(25,1,1) = {"
N
j
v
v
v
a
a
a
a
U
a
v
v
a
U
a
v
v
a
a
i
i
a
U
i
v
G
"}
(26,1,1) = {"
G
v
j
v
v
v
v
j
v
v
v
v
v
v
j
v
v
v
v
v
j
v
v
j
v
v
N
"}
(27,1,1) = {"
G
G
N
G
N
N
G
N
G
N
G
N
N
G
G
N
N
N
G
G
N
N
N
G
G
N
G
"}
