"aa" = (/turf/space,/area)
"ab" = (/turf/simulated/wall/invulnerable/r_wall,/area/vault/assistantlair)
"ac" = (/obj/item/weapon/shard,/turf/simulated/floor/plating,/area/vault/assistantlair)
"ad" = (/obj/machinery/light/small{dir = 1; invisibility = 1},/turf/simulated/floor/plating,/area/vault/assistantlair)
"ae" = (/obj/effect/decal/cleanable/dirt,/turf/simulated/floor/plating,/area/vault/assistantlair)
"af" = (/turf/simulated/floor/plating,/area/vault/assistantlair)
"ag" = (/obj/effect/decal/cleanable/dirt,/obj/item/trash/danitos,/turf/simulated/floor/plating,/area/vault/assistantlair)
"ah" = (/obj/item/trash/chips,/turf/simulated/floor/plating{icon_state = "panelscorched"},/area/vault/assistantlair)
"ai" = (/obj/effect/decal/cleanable/dirt,/obj/item/weapon/cane,/turf/simulated/floor/plating,/area/vault/assistantlair)
"aj" = (/turf/simulated/floor/plating{icon_state = "panelscorched"},/area/vault/assistantlair)
"ak" = (/turf/simulated/floor/plating{icon_state = "platingdmg1"},/area/vault/assistantlair)
"al" = (/obj/item/weapon/dnainjector/nofail/randompower,/obj/item/trash/syndi_cakes,/turf/simulated/floor/plating,/area/vault/assistantlair)
"am" = (/obj/effect/decal/cleanable/dirt,/turf/simulated/floor/plating{icon_state = "platingdmg1"},/area/vault/assistantlair)
"an" = (/obj/effect/decal/cleanable/dirt,/obj/item/weapon/shard{icon_state = "small"; pixel_x = 5; pixel_y = -5},/obj/item/weapon/shard{icon_state = "medium"},/turf/simulated/floor/plating,/area/vault/assistantlair)
"ao" = (/obj/structure/vendomatpack/security,/turf/simulated/floor/plating,/area/vault/assistantlair)
"ap" = (/obj/item/trash/discountchocolate,/turf/simulated/floor/plating{icon_state = "platingdmg1"},/area/vault/assistantlair)
"aq" = (/obj/item/trash/chicken_bucket,/turf/simulated/floor/plating{icon_state = "platingdmg1"},/area/vault/assistantlair)
"ar" = (/obj/machinery/light/small{dir = 1},/turf/simulated/floor/plating,/area/vault/assistantlair)
"as" = (/obj/structure/rack{dir = 8},/obj/item/weapon/grenade/smokebomb,/obj/item/weapon/grenade/smokebomb,/turf/simulated/floor/plating,/area/vault/assistantlair)
"at" = (/obj/item/clothing/gloves/rainbow,/obj/item/clothing/shoes/rainbow,/obj/item/clothing/under/rainbow,/obj/item/clothing/head/soft/rainbow,/obj/item/weapon/coin/silver,/obj/structure/closet/crate,/turf/simulated/floor/plating,/area/vault/assistantlair)
"au" = (/obj/effect/decal/cleanable/dirt,/obj/item/weapon/shard,/turf/simulated/floor/plating,/area/vault/assistantlair)
"av" = (/obj/structure/toilet{desc = "The HT-451, a torque rotation-based, waste disposal unit for small matter. This one is a gruesome sight indeed."; dir = 4},/obj/machinery/light/small{dir = 1},/obj/item/weapon/cell/hyper,/turf/simulated/floor/plating,/area/vault/assistantlair)
"aw" = (/obj/effect/step_trigger/thrower/west,/turf/simulated/floor/plating,/area/vault/assistantlair)
"ax" = (/obj/effect/decal/cleanable/dirt,/obj/item/trash/raisins,/turf/simulated/floor/plating{icon_state = "panelscorched"},/area/vault/assistantlair)
"ay" = (/obj/effect/decal/cleanable/dirt,/obj/machinery/light/small{dir = 8},/obj/structure/mannequin/wood/fat,/turf/simulated/floor/plating,/area/vault/assistantlair)
"az" = (/obj/structure/closet/emcloset,/turf/simulated/floor/plating{icon_state = "platingdmg1"},/area/vault/assistantlair)
"aA" = (/obj/structure/sign/poster,/turf/simulated/wall/invulnerable/r_wall,/area/vault/assistantlair)
"aB" = (/obj/structure/grille,/obj/structure/window/barricade/full,/turf/simulated/floor/plating,/area/vault/assistantlair)
"aC" = (/obj/machinery/door,/turf/simulated/floor/plating,/area/vault/assistantlair)
"aD" = (/obj/item/weapon/storage/belt/slim,/obj/structure/rack{dir = 8},/obj/item/clothing/mask/gas,/turf/simulated/floor/plating,/area/vault/assistantlair)
"aE" = (/obj/item/weapon/shard{icon_state = "medium"},/turf/simulated/floor/plating,/area/vault/assistantlair)
"aF" = (/obj/item/weapon/shard{icon_state = "small"; pixel_x = 5; pixel_y = -5},/turf/simulated/floor/plating{icon_state = "platingdmg1"},/area/vault/assistantlair)
"aG" = (/obj/effect/decal/cleanable/dirt,/obj/structure/closet/crate,/obj/abstract/map/spawner/misc/gym,/turf/simulated/floor/plating,/area/vault/assistantlair)
"aH" = (/obj/structure/table,/obj/item/weapon/storage/firstaid/toxin{pixel_x = -2; pixel_y = 4},/turf/simulated/floor/plating,/area/vault/assistantlair)
"aI" = (/obj/structure/table,/obj/item/weapon/crowbar,/obj/machinery/media/receiver/boombox,/turf/simulated/floor/plating,/area/vault/assistantlair)
"aJ" = (/obj/effect/decal/cleanable/dirt,/obj/item/weapon/shard{icon_state = "small"; pixel_x = 5; pixel_y = -5},/turf/simulated/floor/plating,/area/vault/assistantlair)
"aK" = (/obj/effect/step_trigger/thrower/east,/obj/structure/curtain/black,/turf/simulated/floor/plating,/area/vault/assistantlair)
"aL" = (/obj/effect/decal/cleanable/dirt,/turf/simulated/floor/plating{icon_state = "panelscorched"},/area/vault/assistantlair)
"aM" = (/obj/effect/decal/cleanable/dirt,/obj/abstract/map/nest/spider/limited,/turf/simulated/floor/plating,/area/vault/assistantlair)
"aN" = (/obj/effect/decal/cleanable/dirt,/obj/machinery/light/small{dir = 1},/turf/simulated/floor/plating{icon_state = "platingdmg1"},/area/vault/assistantlair)
"aO" = (/obj/structure/table,/obj/item/weapon/storage/firstaid/regular,/turf/simulated/floor/plating,/area/vault/assistantlair)
"aP" = (/obj/effect/decal/cleanable/dirt,/obj/machinery/light/small{dir = 8},/turf/simulated/floor/plating,/area/vault/assistantlair)
"aQ" = (/obj/item/toy/balloon/glove,/turf/simulated/floor/plating,/area/vault/assistantlair)
"aR" = (/obj/item/clothing/suit/ianshirt,/turf/simulated/floor/plating,/area/vault/assistantlair)
"aS" = (/obj/machinery/light/small{dir = 4},/obj/effect/decal/cleanable/dirt,/turf/simulated/floor/plating,/area/vault/assistantlair)
"aT" = (/obj/effect/decal/cleanable/dirt,/obj/machinery/light/small,/turf/simulated/floor/plating{icon_state = "panelscorched"},/area/vault/assistantlair)
"aU" = (/obj/structure/table,/obj/item/clothing/mask/scarf/blue,/turf/simulated/floor/plating{icon_state = "platingdmg1"},/area/vault/assistantlair)
"aV" = (/obj/structure/reagent_dispensers/fueltank,/turf/simulated/floor/plating,/area/vault/assistantlair)
"aW" = (/obj/item/weapon/stool,/turf/simulated/floor/plating,/area/vault/assistantlair)
"aX" = (/obj/structure/curtain/black,/obj/effect/step_trigger/thrower,/turf/simulated/floor/plating,/area/vault/assistantlair)
"aY" = (/obj/structure/closet,/obj/item/device/flashlight/flare,/turf/simulated/floor/plating{icon_state = "panelscorched"},/area/vault/assistantlair)
"aZ" = (/obj/structure/table,/obj/item/clothing/monkeyclothes,/turf/simulated/floor/plating,/area/vault/assistantlair)
"ba" = (/obj/structure/rack,/obj/item/clothing/suit/fire/firefighter,/obj/machinery/light/small{dir = 8},/turf/simulated/floor/plating,/area/vault/assistantlair)
"bb" = (/obj/structure/rack,/obj/item/clothing/mask/gas,/obj/machinery/light/small{dir = 4; on = 1},/turf/simulated/floor/plating,/area/vault/assistantlair)
"bc" = (/obj/structure/table/woodentable/poker,/obj/item/weapon/reagent_containers/food/drinks/bottle/tequila{pixel_y = 6},/turf/simulated/floor/plating,/area/vault/assistantlair)
"bd" = (/obj/effect/mine/stun,/turf/simulated/floor/plating,/area/vault/assistantlair)
"be" = (/obj/structure/sign/poster{desc = "Grey Pride World Wide!"; icon_state = "poster8"; pixel_x = 32},/obj/item/weapon/macuahuitl,/turf/simulated/floor/plating,/area/vault/assistantlair)
"bf" = (/obj/machinery/light/small,/turf/simulated/floor/plating,/area/vault/assistantlair)
"bg" = (/obj/item/weapon/coin/clown,/obj/structure/table,/turf/simulated/floor/plating,/area/vault/assistantlair)
"bh" = (/obj/structure/curtain/black,/turf/simulated/floor/plating,/area/vault/assistantlair)
"bi" = (/obj/machinery/door/airlock/maintenance_hatch,/turf/simulated/floor/plating,/area/vault/assistantlair)
"bj" = (/obj/machinery/light/small{dir = 8},/turf/simulated/floor/plating{tag = "icon-panelscorched"; icon_state = "panelscorched"},/area/vault/assistantlair)
"bk" = (/obj/structure/punching_bag/clown,/turf/simulated/floor/mineral/clown,/area/vault/assistantlair)
"bl" = (/obj/structure/bed/chair/vehicle/gokart,/obj/item/key/gokart,/turf/simulated/floor/wood,/area/vault/assistantlair)
"bm" = (/obj/structure/falserwall,/turf/simulated/floor/wood,/area/vault/assistantlair)
"bn" = (/obj/machinery/vending/autodrobe,/turf/simulated/floor/arcade,/area/vault/assistantlair)
"bo" = (/obj/structure/bed/chair/wood/wings,/obj/item/weapon/storage/fancy/matchbox,/turf/simulated/floor/arcade,/area/vault/assistantlair)
"bp" = (/turf/simulated/floor/arcade,/area/vault/assistantlair)
"bq" = (/obj/structure/punching_bag/captain,/turf/simulated/floor/arcade,/area/vault/assistantlair)
"br" = (/obj/machinery/computer/arcade,/turf/simulated/floor/wood,/area/vault/assistantlair)
"bs" = (/obj/effect/glowshroom,/turf/simulated/floor/plating,/area/vault/assistantlair)
"bt" = (/obj/effect/step_trigger/thrower/west,/obj/effect/decal/cleanable/dirt,/obj/structure/curtain/black,/turf/simulated/floor/plating,/area/vault/assistantlair)
"bu" = (/obj/effect/decal/cleanable/dirt,/obj/machinery/light/small{dir = 1},/turf/simulated/floor/plating,/area/vault/assistantlair)
"bv" = (/obj/structure/table,/obj/item/weapon/reagent_containers/food/snacks/grown/banana,/obj/item/weapon/stamp/clown,/turf/simulated/floor/plating,/area/vault/assistantlair)
"bw" = (/obj/machinery/computer/security/telescreen/entertainment{pixel_x = -32},/turf/simulated/floor/arcade,/area/vault/assistantlair)
"bx" = (/obj/structure/table/woodentable,/obj/item/ashtray/bronze,/obj/item/clothing/mask/cigarette/cigar,/turf/simulated/floor/arcade,/area/vault/assistantlair)
"by" = (/obj/item/weapon/storage/belt/champion,/turf/simulated/floor/arcade,/area/vault/assistantlair)
"bz" = (/turf/simulated/floor/wood,/area/vault/assistantlair)
"bA" = (/turf/simulated/floor/plating,/turf/simulated/floor/plating{icon_state = "platingdmg2"},/area/vault/assistantlair)
"bB" = (/obj/effect/mine/stun,/obj/item/weapon/shard{icon_state = "medium"},/turf/simulated/floor/plating,/area/vault/assistantlair)
"bC" = (/obj/effect/decal/cleanable/dirt,/obj/item/stack/rods,/turf/simulated/floor/plating{icon_state = "platingdmg3"},/area/vault/assistantlair)
"bD" = (/obj/structure/bed,/obj/structure/curtain/open/right,/obj/item/weapon/bedsheet/black,/turf/simulated/floor/wood,/area/vault/assistantlair)
"bE" = (/obj/structure/bed/chair/wood/wings{dir = 1},/turf/simulated/floor/arcade,/area/vault/assistantlair)
"bF" = (/obj/item/weapon/storage/bag/money/treasure,/turf/simulated/floor/arcade,/area/vault/assistantlair)
"bG" = (/obj/machinery/computer/slot_machine,/turf/simulated/floor/wood,/area/vault/assistantlair)
"bH" = (/obj/structure/closet/firecloset,/turf/simulated/floor/plating{icon_state = "platingdmg1"},/area/vault/assistantlair)
"bI" = (/obj/effect/decal/cleanable/dirt,/obj/structure/reagent_dispensers/silicate,/turf/simulated/floor/plating,/area/vault/assistantlair)
"bJ" = (/obj/machinery/light/small{dir = 1; invisibility = 1},/obj/item/clothing/head/lordadmiralhat,/turf/simulated/floor/plating,/area/vault/assistantlair)
"bK" = (/obj/structure/bed,/obj/structure/curtain/open/right,/obj/item/weapon/bedsheet/green,/turf/simulated/floor/wood,/area/vault/assistantlair)
"bL" = (/obj/structure/rack{dir = 8},/obj/item/clothing/mask/breath,/obj/item/clothing/mask/breath,/obj/item/weapon/tank/oxygen,/obj/item/weapon/tank/oxygen,/obj/item/weapon/storage/belt/utility,/obj/item/weapon/storage/box/lights/mixed,/turf/simulated/floor/plating,/area/vault/assistantlair)
"bM" = (/obj/item/weapon/stool{pixel_y = 8},/obj/machinery/light/small{dir = 4; on = 1},/turf/simulated/floor/plating,/area/vault/assistantlair)
"bN" = (/turf/simulated/floor/plating{tag = "icon-platingdmg3"; icon_state = "platingdmg3"},/area/vault/assistantlair)
"bO" = (/obj/structure/table,/obj/item/clothing/head/batman,/turf/simulated/floor/plating,/area/vault/assistantlair)
"bP" = (/obj/effect/decal/cleanable/dirt,/turf/simulated/floor/plating{tag = "icon-panelscorched"; icon_state = "panelscorched"},/area/vault/assistantlair)
"bQ" = (/obj/structure/bed,/obj/structure/curtain/open/right,/obj/item/weapon/bedsheet/red,/turf/simulated/floor/wood,/area/vault/assistantlair)
"bR" = (/obj/machinery/atmospherics/pipe/simple/supply/hidden{dir = 6},/obj/structure/table,/obj/effect/decal/cleanable/dirt,/obj/item/weapon/wirecutters,/obj/item/device/multitool,/turf/simulated/floor/plating,/area/vault/assistantlair)
"bS" = (/obj/effect/decal/cleanable/cobweb,/obj/machinery/vending/coffee,/turf/simulated/floor/plating,/area/vault/assistantlair)
"bT" = (/obj/machinery/vending/snack,/turf/simulated/floor/plating,/area/vault/assistantlair)
"bU" = (/obj/structure/table,/obj/item/clothing/head/kitty,/turf/simulated/floor/plating{tag = "icon-platingdmg2"; icon_state = "platingdmg2"},/area/vault/assistantlair)
"bV" = (/obj/effect/mine/stun,/obj/item/clothing/gloves/rainbow/clown,/turf/simulated/floor/plating,/area/vault/assistantlair)
"bW" = (/obj/structure/bed,/obj/structure/curtain/open/right,/obj/item/weapon/bedsheet/blue,/turf/simulated/floor/wood,/area/vault/assistantlair)
"bX" = (/obj/structure/bedsheetbin,/obj/structure/table/woodentable,/turf/simulated/floor/arcade,/area/vault/assistantlair)
"bY" = (/obj/structure/table/woodentable,/obj/item/device/flashlight/lamp/green{on = 0; pixel_x = -3; pixel_y = 8},/turf/simulated/floor/arcade,/area/vault/assistantlair)
"bZ" = (/obj/structure/safe,/obj/abstract/map/spawner/safe/any,/obj/abstract/map/spawner/safe/any,/obj/abstract/map/spawner/safe/any,/turf/simulated/floor/arcade,/area/vault/assistantlair)
"ca" = (/obj/machinery/vending/assist,/turf/simulated/floor/plating,/area/vault/assistantlair)
"cb" = (/obj/structure/table,/obj/item/weapon/storage/toolbox/mechanical{pixel_x = -2; pixel_y = -1},/obj/item/device/radio,/turf/simulated/floor/plating,/area/vault/assistantlair)
"cc" = (/obj/item/weapon/stool,/obj/machinery/light/small{dir = 8},/turf/simulated/floor/plating,/area/vault/assistantlair)
"cd" = (/obj/structure/table,/obj/item/weapon/reagent_containers/food/drinks/beer{pixel_x = -6; pixel_y = 5},/obj/item/weapon/reagent_containers/food/drinks/beer{pixel_x = 2; pixel_y = -2},/turf/simulated/floor/plating,/area/vault/assistantlair)
"ce" = (/obj/structure/table,/obj/item/weapon/reagent_containers/food/condiment/saltshaker{pixel_x = -3},/obj/item/weapon/reagent_containers/food/condiment/peppermill{pixel_x = 3},/turf/simulated/floor/plating,/area/vault/assistantlair)
"cf" = (/obj/machinery/vending,/turf/simulated/floor/plating,/area/vault/assistantlair)
"cg" = (/obj/machinery/vending/cigarette{desc = "This machine's days of giving you cancer are long gone."; icon_state = "cigs-broken"; stat = 1},/turf/simulated/floor/plating{icon_state = "panelscorched"},/area/vault/assistantlair)
"ch" = (/obj/structure/table,/obj/item/weapon/wirerod,/turf/simulated/floor/plating,/area/vault/assistantlair)
"ci" = (/obj/structure/table,/obj/item/stack/cable_coil/random,/obj/item/stack/cable_coil/random,/obj/item/stack/cable_coil/random,/obj/item/stack/cable_coil/random,/turf/simulated/floor/plating,/area/vault/assistantlair)
"cj" = (/obj/structure/table,/obj/item/stack/sheet/glass/glass/bigstack,/obj/item/stack/sheet/metal/bigstack,/turf/simulated/floor/plating,/area/vault/assistantlair)
"ck" = (/obj/effect/step_trigger/thrower/east,/obj/machinery/door/airlock/maintenance_hatch,/turf/simulated/floor/plating,/area/vault/assistantlair)
"cl" = (/obj/item/weapon/beach_ball/holoball,/obj/machinery/light/small{dir = 1},/turf/simulated/floor/plating,/area/vault/assistantlair)
"cm" = (/obj/effect/decal/cleanable/egg_smudge,/turf/simulated/floor/plating{icon_state = "platingdmg1"},/area/vault/assistantlair)
"cn" = (/obj/structure/closet/emcloset,/turf/simulated/floor/plating,/area/vault/assistantlair)
"co" = (/obj/machinery/light/small{dir = 4; on = 1},/turf/simulated/floor/plating,/area/vault/assistantlair)
"cp" = (/obj/machinery/atmospherics/pipe/simple/supply/hidden,/obj/structure/table,/obj/machinery/microwave{pixel_x = -3; pixel_y = 6},/turf/simulated/floor/plating,/area/vault/assistantlair)
"cq" = (/obj/effect/decal/cleanable/vomit,/turf/simulated/floor/plating,/area/vault/assistantlair)
"cr" = (/obj/structure/kitchenspike,/turf/simulated/floor/plating{icon_state = "platingdmg1"},/area/vault/assistantlair)
"cs" = (/obj/structure/closet,/obj/item/weapon/kitchen/utensil/knife/large,/obj/item/weapon/reagent_containers/food/drinks/flour,/obj/item/weapon/reagent_containers/food/drinks/flour,/obj/item/weapon/reagent_containers/food/condiment/sugar,/obj/item/weapon/reagent_containers/food/snacks/meat{desc = "A slab of meat. You're not exactly sure where this came from."},/obj/item/weapon/reagent_containers/food/snacks/meat{desc = "A slab of meat. You're not exactly sure where this came from."},/obj/item/weapon/reagent_containers/food/snacks/meat{desc = "A slab of meat. You're not exactly sure where this came from."},/turf/simulated/floor/plating,/area/vault/assistantlair)
"ct" = (/obj/structure/rack,/obj/item/weapon/gibtonite,/turf/simulated/floor/plating,/area/vault/assistantlair)
"cu" = (/obj/structure/sink/kitchen,/turf/simulated/wall/invulnerable/r_wall,/area/vault/assistantlair)
"cv" = (/obj/structure/table,/obj/machinery/light/small{dir = 1},/turf/simulated/floor/plating,/area/vault/assistantlair)
"cw" = (/obj/structure/bed/chair{dir = 8},/turf/simulated/floor/plating,/area/vault/assistantlair)
"cx" = (/obj/effect/decal/cleanable/cobweb2,/turf/simulated/floor/plating,/area/vault/assistantlair)
"cy" = (/obj/effect/decal/cleanable/dirt,/obj/item/weapon/rack_parts,/turf/simulated/floor/plating,/area/vault/assistantlair)
"cz" = (/obj/structure/rack,/obj/item/weapon/glowstick/blue,/obj/item/weapon/glowstick/red,/obj/item/weapon/glowstick,/turf/simulated/floor/plating,/area/vault/assistantlair)
"cA" = (/obj/abstract/map/spawner/mobs/lizard,/turf/simulated/floor/plating,/area/vault/assistantlair)
"cB" = (/obj/structure/table,/obj/abstract/map/spawner/space/drinks,/turf/simulated/floor/plating,/area/vault/assistantlair)
"cC" = (/obj/structure/rack,/obj/item/clothing/mask/gas,/obj/machinery/light/small{dir = 1},/turf/simulated/floor/plating,/area/vault/assistantlair)
"cD" = (/obj/item/weapon/crowbar,/obj/effect/decal/cleanable/dirt,/obj/item/weapon/cigbutt,/turf/simulated/floor/plating{icon_state = "platingdmg1"},/area/vault/assistantlair)
"cE" = (/obj/structure/closet/emcloset,/obj/effect/decal/cleanable/cobweb2,/turf/simulated/floor/plating{icon_state = "platingdmg1"},/area/vault/assistantlair)
"cF" = (/obj/abstract/map/spawner/misc/seeds,/obj/effect/decal/cleanable/scattered_sand,/turf/simulated/floor/plating,/area/vault/assistantlair)
"cG" = (/obj/item/weapon/reagent_containers/glass/bucket,/turf/simulated/floor/plating,/area/vault/assistantlair)
"cH" = (/obj/abstract/map/spawner/misc/seeds,/turf/simulated/floor/plating,/area/vault/assistantlair)
"cI" = (/obj/abstract/map/spawner/mobs/mouse,/turf/simulated/floor/plating,/area/vault/assistantlair)
"cJ" = (/obj/effect/decal/cleanable/dirt,/obj/machinery/light_construct/small{dir = 4},/obj/item/weapon/cigbutt,/mob/living/carbon/monkey,/turf/simulated/floor/plating{icon_state = "platingdmg3"},/area/vault/assistantlair)
"cK" = (/obj/structure/rack,/obj/item/bodybag,/turf/simulated/floor/plating,/area/vault/assistantlair)
"cL" = (/obj/item/weapon/gun_barrel,/turf/simulated/floor/plating,/area/vault/assistantlair)
"cM" = (/obj/structure/rack,/obj/item/clothing/suit/fire/firefighter,/turf/simulated/floor/plating,/area/vault/assistantlair)
"cN" = (/obj/structure/closet/emcloset,/obj/machinery/light/small,/turf/simulated/floor/plating,/area/vault/assistantlair)
"cO" = (/obj/machinery/portable_atmospherics/hydroponics/soil,/obj/abstract/map/spawner/misc/seeds,/obj/machinery/light,/turf/simulated/floor/plating,/area/vault/assistantlair)
"cP" = (/obj/machinery/portable_atmospherics/hydroponics/soil,/obj/abstract/map/spawner/misc/seeds,/obj/effect/decal/cleanable/scattered_sand,/turf/simulated/floor/plating,/area/vault/assistantlair)
"cQ" = (/obj/machinery/biogenerator,/turf/simulated/floor/plating,/area/vault/assistantlair)
"cR" = (/obj/machinery/seed_extractor,/obj/machinery/light,/turf/simulated/floor/plating,/area/vault/assistantlair)
"cS" = (/obj/machinery/photocopier,/turf/simulated/floor/plating,/area/vault/assistantlair)
"cT" = (/obj/structure/closet,/turf/simulated/floor/plating,/area/vault/assistantlair)
"cU" = (/obj/item/weapon/blunderbuss/flawless,/obj/structure/grille,/turf/simulated/floor/plating,/area/vault/assistantlair)
"cV" = (/obj/structure/grille/broken,/obj/item/stack/rods,/turf/simulated/floor/plating,/area/vault/assistantlair)
"cW" = (/obj/structure/rack,/obj/item/asteroid/goliath_hide,/obj/item/asteroid/goliath_hide,/turf/simulated/floor/plating,/area/vault/assistantlair)
"cX" = (/obj/structure/table,/obj/abstract/map/spawner/assistant/tools,/obj/abstract/map/spawner/assistant/tools,/turf/simulated/floor/plating,/area/vault/assistantlair)
"cY" = (/obj/structure/table,/obj/abstract/map/spawner/assistant/materials,/turf/simulated/floor/plating,/area/vault/assistantlair)
"cZ" = (/obj/structure/table,/obj/machinery/cell_charger,/obj/item/weapon/wrench,/obj/item/weapon/screwdriver{pixel_y = 16},/turf/simulated/floor/plating,/area/vault/assistantlair)
"da" = (/obj/structure/rack,/obj/item/weapon/reagent_containers/food/drinks/thermos/full,/obj/item/weapon/reagent_containers/food/drinks/thermos/full,/turf/simulated/floor/plating,/area/vault/assistantlair)
"db" = (/obj/effect/decal/cleanable/dirt,/obj/machinery/light/small{dir = 4},/turf/simulated/floor/plating,/area/vault/assistantlair)
"dc" = (/obj/effect/decal/cleanable/dirt,/obj/machinery/light/small{dir = 8; flickering = 1},/obj/effect/decal/warning_stripes{tag = "icon-warning"; icon_state = "warning"},/turf/simulated/floor/plating,/area/vault/assistantlair)
"dd" = (/obj/effect/decal/warning_stripes{tag = "icon-loading_area (EAST)"; icon_state = "loading_area"; dir = 4},/turf/simulated/floor/plating,/area/vault/assistantlair)
"de" = (/obj/effect/decal/cleanable/dirt,/obj/structure/falserwall,/turf/simulated/floor/plating,/area/vault/assistantlair)
"df" = (/obj/effect/mine/stun,/obj/item/toy/gasha/skub,/turf/simulated/floor/plating,/area/vault/assistantlair)
"dg" = (/obj/machinery/door/airlock/external,/turf/simulated/floor/plating,/area/vault/assistantlair)
"dh" = (/obj/structure/rack,/obj/item/weapon/extinguisher,/turf/simulated/floor/plating,/area/vault/assistantlair)
"di" = (/obj/structure/rack,/obj/item/weapon/cell/potato,/turf/simulated/floor/plating,/area/vault/assistantlair)
"dj" = (/obj/structure/reagent_dispensers/watertank,/turf/simulated/floor/plating,/area/vault/assistantlair)
"dk" = (/obj/machinery/portable_atmospherics/canister/air,/obj/structure/window/reinforced{dir = 8},/turf/simulated/floor/plating,/area/vault/assistantlair)
"dl" = (/obj/machinery/portable_atmospherics/canister/oxygen,/turf/simulated/floor/plating,/area/vault/assistantlair)
"dm" = (/obj/machinery/portable_atmospherics/canister/nitrogen,/obj/structure/window/reinforced{dir = 4},/turf/simulated/floor/plating,/area/vault/assistantlair)
"dn" = (/obj/machinery/space_heater/air_conditioner,/obj/structure/window/reinforced{dir = 8},/turf/simulated/floor/plating,/area/vault/assistantlair)
"do" = (/obj/machinery/space_heater,/turf/simulated/floor/plating,/area/vault/assistantlair)
"dp" = (/obj/structure/rack,/obj/item/clothing/mask/gas,/obj/item/clothing/glasses/sunglasses,/obj/structure/window/reinforced{dir = 4},/turf/simulated/floor/plating,/area/vault/assistantlair)
"dq" = (/obj/structure/table,/obj/item/trash/cheesie,/obj/item/clothing/gloves/yellow,/turf/simulated/floor/plating{icon_state = "panelscorched"},/area/vault/assistantlair)

(1,1,1) = {"
aaaaaaababababababababababababababababababababababababababaa
aaaaaaabacadaeaeafabagaeahabaiaeajabakafalabafafamaeaeafabab
aaaaaaabanaoabakafabapabaeaeaqabaeabafabababaeabafabafakarab
aaaaaaabajababaeajabaeabababababaeabafabaearamabasabatabaeab
aaaaaaabauabavaeawabaxabayazababafafafabaeabababaAabababafab
aaaaaaabauababaBafaCafabaeafaeafakabababaeamaDabafafafafaeab
aaaaaaabaEaFabakaeabababababababaeabaGababafaDabaHafabaIafab
aaaaaaabaJafaKaeaLabajaMaeafababaeabaeafaNaeaDabaOafababaeab
aaaaaaabaPafabaeababaeababaCababaeakaeafafafafaKaQaRafabaSab
aaaaaaabakababaTabaUaeabaVafaVabaWafabaXababababababaYabaeab
aaaaaaabaeabafababaZafabbaafbbabbcafabafajafbdafbeabababafab
aaaaaaabafababakaeaeajabaVafaVabaWbfabafababababafafafafafab
aaaaaaabaebgabaeabababababbhabababababafaebiaeababababababab
aaaaaaabbjbkabaeabblbmbnbobpbpbqbrbrabafbsaAafbtafbubiafacab
aaaaaaabaebvabafabababbwbxbybpbpbzbzabafbAaAbsabafaeabbBbCab
aaaaaaabafababbiabbDbzbpbEbFbpbpbzbGabakafaAbsabbHbAabafbIab
aaaaaaabaeabbJaeabbKbzbpbpbpbpbpbzbGabbsafaAafabbLaeabaebMab
ababababbNabbObPabbQbzbpbpbpbpbpbzbzabafbsaAbsababafabaebRab
abbSbTabaeabbUbVabbWbzbXbYbpbpbZbrbrabafakaAafcaabaeabbAcbab
abcccdabaPafaeaeabababababaXabababababafbsaAbsababakabafafab
abaWceabababababababcfcgaeafafafchcicjafafckafabclaeababajab
abcmaeaeafbiaeafafafafafaeaeajaebfafaeafafababaeafaecnabcoab
abcpcqcrcsabafaeajbfakababababababbiababaectabbiababababafab
ababaXababababaBcuabbhabcvcwcxabaVcyakabaeczabafcAafcBabaeab
abcCcDafaecEabcFcGcHcHabafcIafabaBaBcJabafcKabafafcLababakab
abcMaeabafcNabcOcPcQcRabcSafcTabcUaBcVabaPcWabcXcYababcZafab
ababbiabaeababababababababbiababababababaXabababababafaecoab
abdadbabdcdddeaeaedfbuaeaeaeafafafarafafaeafafaraeckbdababab
dgafafabaVdhabdidjababababaWdkdldmafaBcfcfdndodpdqabcaabaaaa
ababababababababababaaaaababababababababababababababababaaaa
"}
