"aa" = (/turf/simulated/wall/invulnerable/r_wall,/area/vault/assistantlair)
"ab" = (/turf/space,/area)
"ac" = (/obj/abstract/map/nest/spider/limited,/turf/simulated/floor/plating,/area/vault/assistantlair)
"ad" = (/obj/structure/closet/firecloset,/obj/item/device/instrument/bikehorn,/obj/item/clothing/head/dunce_cap,/turf/simulated/floor/plating,/area/vault/assistantlair)
"ae" = (/obj/item/weapon/shard,/turf/simulated/floor/plating,/area/vault/assistantlair)
"af" = (/obj/machinery/light/small{dir = 1; invisibility = 1},/turf/simulated/floor/plating,/area/vault/assistantlair)
"ag" = (/obj/effect/decal/cleanable/dirt,/obj/structure/falserwall,/turf/simulated/floor/plating,/area/vault/assistantlair)
"ah" = (/obj/effect/decal/cleanable/dirt,/turf/simulated/floor/plating,/area/vault/assistantlair)
"ai" = (/obj/structure/reagent_dispensers/watertank,/turf/simulated/floor/plating,/area/vault/assistantlair)
"aj" = (/obj/effect/decal/cleanable/dirt,/obj/item/trash/danitos,/turf/simulated/floor/plating,/area/vault/assistantlair)
"ak" = (/obj/item/trash/chips,/turf/simulated/floor/plating{icon_state = "panelscorched"},/area/vault/assistantlair)
"al" = (/obj/effect/decal/cleanable/dirt,/obj/item/weapon/cane,/obj/effect/decal/cleanable/cobweb,/turf/simulated/floor/plating,/area/vault/assistantlair)
"am" = (/turf/simulated/floor/plating{icon_state = "panelscorched"},/area/vault/assistantlair)
"an" = (/turf/simulated/floor/plating{icon_state = "platingdmg1"},/area/vault/assistantlair)
"ao" = (/turf/simulated/floor/plating,/area/vault/assistantlair)
"ap" = (/obj/item/weapon/dnainjector/nofail/randompower,/obj/item/trash/syndi_cakes,/turf/simulated/floor/plating,/area/vault/assistantlair)
"aq" = (/obj/effect/decal/cleanable/dirt,/turf/simulated/floor/plating{icon_state = "platingdmg1"},/area/vault/assistantlair)
"ar" = (/obj/effect/decal/cleanable/dirt,/obj/item/weapon/shard{icon_state = "small"; pixel_x = 5; pixel_y = -5},/obj/item/weapon/shard{icon_state = "medium"},/turf/simulated/floor/plating,/area/vault/assistantlair)
"as" = (/obj/structure/vendomatpack/security,/turf/simulated/floor/plating,/area/vault/assistantlair)
"at" = (/obj/item/trash/discountchocolate,/turf/simulated/floor/plating{icon_state = "platingdmg1"},/area/vault/assistantlair)
"au" = (/obj/item/trash/chicken_bucket,/turf/simulated/floor/plating{icon_state = "platingdmg1"},/area/vault/assistantlair)
"av" = (/obj/machinery/light/small{dir = 1},/obj/effect/decal/cleanable/cobweb2,/turf/simulated/floor/plating,/area/vault/assistantlair)
"aw" = (/obj/effect/decal/cleanable/dirt,/obj/effect/decal/cleanable/cobweb,/turf/simulated/floor/plating,/area/vault/assistantlair)
"ax" = (/obj/machinery/light/small{dir = 1},/turf/simulated/floor/plating,/area/vault/assistantlair)
"ay" = (/obj/structure/rack{dir = 8},/obj/item/weapon/grenade/smokebomb,/obj/item/weapon/grenade/smokebomb,/turf/simulated/floor/plating,/area/vault/assistantlair)
"az" = (/obj/item/clothing/gloves/rainbow,/obj/item/clothing/shoes/rainbow,/obj/item/clothing/under/rainbow,/obj/item/clothing/head/soft/rainbow,/obj/item/weapon/coin/silver,/obj/structure/closet/crate,/turf/simulated/floor/plating,/area/vault/assistantlair)
"aA" = (/obj/machinery/door/airlock/maintenance_hatch,/obj/structure/window/barricade/full/block,/turf/simulated/floor/plating,/area/vault/assistantlair)
"aB" = (/obj/effect/decal/cleanable/dirt,/obj/item/weapon/shard,/turf/simulated/floor/plating,/area/vault/assistantlair)
"aC" = (/obj/structure/toilet{desc = "The HT-451, a torque rotation-based, waste disposal unit for small matter. This one is a gruesome sight indeed."; dir = 4},/obj/machinery/light/small{dir = 1},/obj/item/weapon/cell/hyper,/turf/simulated/floor/plating,/area/vault/assistantlair)
"aD" = (/obj/effect/step_trigger/thrower/west,/turf/simulated/floor/plating,/area/vault/assistantlair)
"aE" = (/obj/effect/decal/cleanable/dirt,/obj/item/trash/raisins,/turf/simulated/floor/plating{icon_state = "panelscorched"},/area/vault/assistantlair)
"aF" = (/obj/effect/decal/cleanable/dirt,/obj/machinery/light/small{dir = 8},/obj/structure/mannequin/wood/fat,/obj/item/clothing/accessory/storage/webbing,/turf/simulated/floor/plating,/area/vault/assistantlair)
"aG" = (/obj/structure/closet/emcloset,/obj/effect/decal/cleanable/cobweb2,/obj/item/clothing/gloves/anchor_arms,/turf/simulated/floor/plating{icon_state = "platingdmg1"},/area/vault/assistantlair)
"aH" = (/obj/structure/sign/poster,/turf/simulated/wall/invulnerable/r_wall,/area/vault/assistantlair)
"aI" = (/obj/structure/window/barricade/full,/turf/simulated/floor/plating,/area/vault/assistantlair)
"aJ" = (/obj/structure/grille,/obj/structure/window/barricade/full,/turf/simulated/floor/plating,/area/vault/assistantlair)
"aK" = (/obj/machinery/door/airlock/maintenance_hatch,/turf/simulated/floor/plating,/area/vault/assistantlair)
"aL" = (/obj/effect/decal/cleanable/soot,/turf/simulated/floor/plating,/area/vault/assistantlair)
"aM" = (/obj/structure/falserwall,/turf/simulated/floor/plating,/area/vault/assistantlair)
"aN" = (/obj/item/weapon/storage/belt/slim,/obj/structure/rack{dir = 8},/obj/item/clothing/mask/gas,/obj/effect/decal/cleanable/cobweb2,/turf/simulated/floor/plating,/area/vault/assistantlair)
"aO" = (/turf/simulated/floor/plating{icon_state = "warnplate"},/area/vault/assistantlair)
"aP" = (/obj/item/weapon/shard{icon_state = "medium"},/turf/simulated/floor/plating,/area/vault/assistantlair)
"aQ" = (/obj/item/weapon/shard{icon_state = "small"; pixel_x = 5; pixel_y = -5},/obj/effect/decal/cleanable/cobweb,/turf/simulated/floor/plating{icon_state = "platingdmg1"},/area/vault/assistantlair)
"aR" = (/obj/effect/decal/cleanable/dirt,/obj/structure/closet/crate,/obj/abstract/map/spawner/misc/gym,/obj/effect/decal/cleanable/cobweb,/turf/simulated/floor/plating,/area/vault/assistantlair)
"aS" = (/obj/item/weapon/storage/belt/slim,/obj/structure/rack{dir = 8},/obj/item/clothing/mask/gas,/turf/simulated/floor/plating,/area/vault/assistantlair)
"aT" = (/obj/structure/table,/obj/item/weapon/storage/firstaid/toxin{pixel_x = -2; pixel_y = 4},/turf/simulated/floor/plating,/area/vault/assistantlair)
"aU" = (/obj/structure/table,/obj/item/weapon/crowbar,/obj/machinery/media/receiver/boombox,/turf/simulated/floor/plating,/area/vault/assistantlair)
"aV" = (/obj/machinery/computer/security,/turf/simulated/floor/plating,/area/vault/assistantlair)
"aW" = (/obj/item/weapon/reagent_containers/food/snacks/bustanuts,/obj/item/weapon/reagent_containers/food/snacks/bustanuts,/obj/structure/rack,/turf/simulated/floor/plating{tag = "icon-platingdmg3"; icon_state = "platingdmg3"},/area/vault/assistantlair)
"aX" = (/obj/effect/decal/cleanable/dirt,/obj/item/weapon/shard{icon_state = "small"; pixel_x = 5; pixel_y = -5},/turf/simulated/floor/plating,/area/vault/assistantlair)
"aY" = (/obj/effect/step_trigger/thrower/east,/obj/structure/curtain/black,/turf/simulated/floor/plating,/area/vault/assistantlair)
"aZ" = (/obj/effect/decal/cleanable/dirt,/turf/simulated/floor/plating{icon_state = "panelscorched"},/area/vault/assistantlair)
"ba" = (/obj/effect/decal/cleanable/dirt,/obj/abstract/map/nest/spider/limited,/turf/simulated/floor/plating,/area/vault/assistantlair)
"bb" = (/obj/effect/decal/cleanable/cobweb2,/turf/simulated/floor/plating,/area/vault/assistantlair)
"bc" = (/obj/effect/decal/cleanable/dirt,/obj/machinery/light/small{dir = 1},/turf/simulated/floor/plating{icon_state = "platingdmg1"},/area/vault/assistantlair)
"bd" = (/obj/structure/table,/obj/item/weapon/storage/firstaid/regular,/turf/simulated/floor/plating,/area/vault/assistantlair)
"be" = (/obj/effect/decal/cleanable/dirt,/obj/effect/decal/cleanable/cockroach_remains,/turf/simulated/floor/plating,/area/vault/assistantlair)
"bf" = (/obj/effect/decal/cleanable/dirt,/obj/item/weapon/stool,/turf/simulated/floor/plating,/area/vault/assistantlair)
"bg" = (/obj/effect/decal/cleanable/dirt,/obj/machinery/light/small{dir = 8},/turf/simulated/floor/plating,/area/vault/assistantlair)
"bh" = (/obj/effect/decal/cleanable/cockroach_remains,/turf/simulated/floor/plating,/area/vault/assistantlair)
"bi" = (/obj/item/toy/balloon/glove,/turf/simulated/floor/plating,/area/vault/assistantlair)
"bj" = (/obj/item/clothing/suit/ianshirt,/turf/simulated/floor/plating,/area/vault/assistantlair)
"bk" = (/obj/machinery/light/small{dir = 4},/obj/effect/decal/cleanable/dirt,/turf/simulated/floor/plating,/area/vault/assistantlair)
"bl" = (/obj/effect/decal/cleanable/dirt,/obj/machinery/light/small,/turf/simulated/floor/plating{icon_state = "panelscorched"},/area/vault/assistantlair)
"bm" = (/obj/structure/table,/obj/item/clothing/mask/scarf/blue,/turf/simulated/floor/plating{icon_state = "platingdmg1"},/area/vault/assistantlair)
"bn" = (/obj/structure/reagent_dispensers/fueltank,/turf/simulated/floor/plating,/area/vault/assistantlair)
"bo" = (/obj/item/weapon/stool,/obj/structure/sign/poster{icon_state = "bsposter10"; pixel_x = -32},/turf/simulated/floor/plating,/area/vault/assistantlair)
"bp" = (/obj/structure/curtain/black,/obj/effect/step_trigger/thrower,/turf/simulated/floor/plating,/area/vault/assistantlair)
"bq" = (/obj/structure/closet,/obj/item/device/flashlight/flare,/turf/simulated/floor/plating{icon_state = "panelscorched"},/area/vault/assistantlair)
"br" = (/obj/structure/sign/poster{desc = "Grey Pride World Wide!"; icon_state = "poster8"; pixel_y = -32},/obj/structure/table,/obj/item/device/flashlight/lamp,/turf/simulated/floor/plating,/area/vault/assistantlair)
"bs" = (/obj/structure/table,/obj/item/clothing/monkeyclothes,/obj/item/clothing/accessory/glowstick/phazon,/turf/simulated/floor/plating,/area/vault/assistantlair)
"bt" = (/obj/structure/rack,/obj/item/clothing/suit/fire/firefighter,/obj/machinery/light/small{dir = 8},/turf/simulated/floor/plating,/area/vault/assistantlair)
"bu" = (/obj/structure/rack,/obj/item/clothing/mask/gas,/obj/machinery/light/small{dir = 4; on = 1},/turf/simulated/floor/plating,/area/vault/assistantlair)
"bv" = (/obj/structure/table/woodentable/poker,/obj/item/weapon/reagent_containers/food/drinks/bottle/tequila{pixel_y = 6},/turf/simulated/floor/plating,/area/vault/assistantlair)
"bw" = (/obj/effect/mine/stun,/turf/simulated/floor/plating,/area/vault/assistantlair)
"bx" = (/obj/structure/sign/poster{desc = "Grey Pride World Wide!"; icon_state = "poster8"; pixel_x = 32},/obj/item/weapon/macuahuitl,/turf/simulated/floor/plating,/area/vault/assistantlair)
"by" = (/obj/item/weapon/stool,/turf/simulated/floor/plating,/area/vault/assistantlair)
"bz" = (/obj/machinery/light/small,/turf/simulated/floor/plating,/area/vault/assistantlair)
"bA" = (/obj/item/weapon/coin/clown,/obj/structure/table,/turf/simulated/floor/plating,/area/vault/assistantlair)
"bB" = (/obj/effect/decal/cleanable/vomit,/obj/item/weapon/reagent_containers/food/snacks/brainburger,/turf/simulated/floor/plating,/area/vault/assistantlair)
"bC" = (/obj/structure/curtain/black,/turf/simulated/floor/plating,/area/vault/assistantlair)
"bD" = (/obj/effect/decal/cleanable/dirt,/obj/effect/decal/cleanable/cobweb2,/turf/simulated/floor/plating,/area/vault/assistantlair)
"bE" = (/obj/structure/punching_bag/clown,/turf/simulated/floor/mineral/clown,/area/vault/assistantlair)
"bF" = (/obj/machinery/light/small{dir = 8},/turf/simulated/floor/plating{tag = "icon-panelscorched"; icon_state = "panelscorched"},/area/vault/assistantlair)
"bG" = (/obj/structure/bed/chair/vehicle/gokart,/obj/item/key/gokart,/obj/effect/decal/remains/human,/turf/simulated/floor/wood,/area/vault/assistantlair)
"bH" = (/obj/structure/falserwall,/turf/simulated/floor/wood,/area/vault/assistantlair)
"bI" = (/obj/machinery/vending/autodrobe,/turf/simulated/floor/arcade,/area/vault/assistantlair)
"bJ" = (/obj/structure/bed/chair/wood/wings,/obj/item/weapon/storage/fancy/matchbox,/turf/simulated/floor/arcade,/area/vault/assistantlair)
"bK" = (/turf/simulated/floor/arcade,/area/vault/assistantlair)
"bL" = (/obj/structure/punching_bag/captain,/turf/simulated/floor/arcade,/area/vault/assistantlair)
"bM" = (/obj/machinery/computer/arcade,/turf/simulated/floor/wood,/area/vault/assistantlair)
"bN" = (/obj/machinery/computer/arcade,/obj/structure/sign/poster{desc = "Grey Pride World Wide!"; icon_state = "poster8"; pixel_x = 32},/turf/simulated/floor/wood,/area/vault/assistantlair)
"bO" = (/obj/effect/glowshroom,/turf/simulated/floor/plating,/area/vault/assistantlair)
"bP" = (/obj/effect/step_trigger/thrower/west,/obj/effect/decal/cleanable/dirt,/obj/structure/curtain/black,/turf/simulated/floor/plating,/area/vault/assistantlair)
"bQ" = (/obj/effect/decal/cleanable/dirt,/obj/machinery/light/small{dir = 1},/turf/simulated/floor/plating,/area/vault/assistantlair)
"bR" = (/obj/item/weapon/shard,/obj/effect/decal/cleanable/cobweb2,/turf/simulated/floor/plating,/area/vault/assistantlair)
"bS" = (/obj/structure/table,/obj/item/weapon/reagent_containers/food/snacks/grown/banana,/obj/item/weapon/stamp/clown,/turf/simulated/floor/plating,/area/vault/assistantlair)
"bT" = (/obj/item/weapon/reagent_containers/glass/beaker/fuel,/turf/simulated/floor/plating,/area/vault/assistantlair)
"bU" = (/obj/machinery/computer/security/telescreen/entertainment{pixel_x = -32},/turf/simulated/floor/arcade,/area/vault/assistantlair)
"bV" = (/obj/structure/table/woodentable,/obj/item/ashtray/bronze,/obj/item/clothing/mask/cigarette/cigar,/turf/simulated/floor/arcade,/area/vault/assistantlair)
"bW" = (/obj/item/weapon/storage/belt/champion,/turf/simulated/floor/arcade,/area/vault/assistantlair)
"bX" = (/turf/simulated/floor/wood,/area/vault/assistantlair)
"bY" = (/obj/effect/decal/warning_stripes/unshielded_area{pixel_x = 32},/turf/simulated/floor/wood,/area/vault/assistantlair)
"bZ" = (/turf/simulated/floor/plating,/turf/simulated/floor/plating{icon_state = "platingdmg2"},/area/vault/assistantlair)
"ca" = (/obj/effect/mine/stun,/obj/item/weapon/shard{icon_state = "medium"},/turf/simulated/floor/plating,/area/vault/assistantlair)
"cb" = (/obj/effect/decal/cleanable/dirt,/obj/item/stack/rods,/turf/simulated/floor/plating{icon_state = "platingdmg3"},/area/vault/assistantlair)
"cc" = (/obj/structure/bed,/obj/structure/curtain/open/right,/obj/item/weapon/bedsheet/black,/turf/simulated/floor/wood,/area/vault/assistantlair)
"cd" = (/obj/structure/bed/chair/wood/wings{dir = 1},/turf/simulated/floor/arcade,/area/vault/assistantlair)
"ce" = (/obj/machinery/computer/slot_machine,/turf/simulated/floor/wood,/area/vault/assistantlair)
"cf" = (/obj/structure/closet/firecloset,/turf/simulated/floor/plating{icon_state = "platingdmg1"},/area/vault/assistantlair)
"cg" = (/obj/effect/decal/cleanable/dirt,/obj/structure/reagent_dispensers/silicate,/turf/simulated/floor/plating,/area/vault/assistantlair)
"ch" = (/obj/machinery/light/small{dir = 1; invisibility = 1},/obj/item/clothing/head/lordadmiralhat,/obj/effect/decal/cleanable/cobweb,/turf/simulated/floor/plating,/area/vault/assistantlair)
"ci" = (/obj/structure/bed,/obj/structure/curtain/open/right,/obj/item/weapon/bedsheet/green,/turf/simulated/floor/wood,/area/vault/assistantlair)
"cj" = (/obj/structure/rack{dir = 8},/obj/item/clothing/mask/breath,/obj/item/clothing/mask/breath,/obj/item/weapon/tank/oxygen,/obj/item/weapon/tank/oxygen,/obj/item/weapon/storage/belt/utility,/obj/item/weapon/storage/box/lights/mixed,/turf/simulated/floor/plating,/area/vault/assistantlair)
"ck" = (/obj/item/weapon/stool{pixel_y = 8},/obj/machinery/light/small{dir = 4; on = 1},/turf/simulated/floor/plating,/area/vault/assistantlair)
"cl" = (/turf/simulated/floor/plating{tag = "icon-platingdmg3"; icon_state = "platingdmg3"},/area/vault/assistantlair)
"cm" = (/obj/structure/table,/obj/item/clothing/head/batman,/turf/simulated/floor/plating,/area/vault/assistantlair)
"cn" = (/obj/effect/decal/cleanable/dirt,/turf/simulated/floor/plating{tag = "icon-panelscorched"; icon_state = "panelscorched"},/area/vault/assistantlair)
"co" = (/obj/structure/bed,/obj/structure/curtain/open/right,/obj/item/weapon/bedsheet/red,/turf/simulated/floor/wood,/area/vault/assistantlair)
"cp" = (/obj/machinery/atmospherics/pipe/simple/supply/hidden{dir = 6},/obj/structure/table,/obj/effect/decal/cleanable/dirt,/obj/item/weapon/wirecutters,/obj/item/device/multitool,/turf/simulated/floor/plating,/area/vault/assistantlair)
"cq" = (/obj/effect/decal/cleanable/cobweb,/obj/machinery/vending/coffee,/turf/simulated/floor/plating,/area/vault/assistantlair)
"cr" = (/obj/machinery/vending/snack,/turf/simulated/floor/plating,/area/vault/assistantlair)
"cs" = (/obj/structure/table,/obj/item/clothing/head/kitty,/turf/simulated/floor/plating{tag = "icon-platingdmg2"; icon_state = "platingdmg2"},/area/vault/assistantlair)
"ct" = (/obj/effect/mine/stun,/obj/item/clothing/gloves/rainbow/clown,/turf/simulated/floor/plating,/area/vault/assistantlair)
"cu" = (/obj/structure/bed,/obj/structure/curtain/open/right,/obj/item/weapon/bedsheet/blue,/turf/simulated/floor/wood,/area/vault/assistantlair)
"cv" = (/obj/structure/bedsheetbin,/obj/structure/table/woodentable,/turf/simulated/floor/arcade,/area/vault/assistantlair)
"cw" = (/obj/structure/table/woodentable,/obj/item/device/flashlight/lamp/green{on = 0; pixel_x = -3; pixel_y = 8},/turf/simulated/floor/arcade,/area/vault/assistantlair)
"cx" = (/obj/structure/safe,/obj/abstract/map/spawner/safe/any,/obj/abstract/map/spawner/safe/any,/obj/abstract/map/spawner/safe/any,/turf/simulated/floor/arcade,/area/vault/assistantlair)
"cy" = (/obj/machinery/vending/assist,/turf/simulated/floor/plating,/area/vault/assistantlair)
"cz" = (/obj/structure/table,/obj/item/weapon/storage/toolbox/mechanical{pixel_x = -2; pixel_y = -1},/obj/item/device/radio,/turf/simulated/floor/plating,/area/vault/assistantlair)
"cA" = (/obj/item/weapon/stool,/obj/machinery/light/small{dir = 8},/turf/simulated/floor/plating,/area/vault/assistantlair)
"cB" = (/obj/structure/table,/obj/item/weapon/reagent_containers/food/drinks/beer{pixel_x = -6; pixel_y = 5},/obj/item/weapon/reagent_containers/food/drinks/beer{pixel_x = 2; pixel_y = -2},/turf/simulated/floor/plating,/area/vault/assistantlair)
"cC" = (/obj/structure/table,/obj/item/weapon/reagent_containers/food/condiment/saltshaker{pixel_x = -3},/obj/item/weapon/reagent_containers/food/condiment/peppermill{pixel_x = 3},/turf/simulated/floor/plating,/area/vault/assistantlair)
"cD" = (/obj/machinery/vending,/obj/effect/decal/cleanable/cobweb,/turf/simulated/floor/plating,/area/vault/assistantlair)
"cE" = (/obj/machinery/vending/cigarette{desc = "This machine's days of giving you cancer are long gone."; icon_state = "cigs-broken"; stat = 1},/turf/simulated/floor/plating{icon_state = "panelscorched"},/area/vault/assistantlair)
"cF" = (/obj/structure/table,/obj/item/weapon/wirerod,/turf/simulated/floor/plating,/area/vault/assistantlair)
"cG" = (/obj/structure/table,/obj/item/stack/cable_coil/random,/obj/item/stack/cable_coil/random,/obj/item/stack/cable_coil/random,/obj/item/stack/cable_coil/random,/turf/simulated/floor/plating,/area/vault/assistantlair)
"cH" = (/obj/structure/table,/obj/item/stack/sheet/glass/glass/bigstack,/obj/item/stack/sheet/metal/bigstack,/turf/simulated/floor/plating,/area/vault/assistantlair)
"cI" = (/obj/item/weapon/beach_ball/holoball,/obj/machinery/light/small{dir = 1},/turf/simulated/floor/plating,/area/vault/assistantlair)
"cJ" = (/obj/effect/decal/cleanable/egg_smudge,/turf/simulated/floor/plating{icon_state = "platingdmg1"},/area/vault/assistantlair)
"cK" = (/obj/structure/closet/emcloset,/turf/simulated/floor/plating,/area/vault/assistantlair)
"cL" = (/obj/machinery/light/small{dir = 4; on = 1},/turf/simulated/floor/plating,/area/vault/assistantlair)
"cM" = (/obj/machinery/atmospherics/pipe/simple/supply/hidden,/obj/structure/table,/obj/machinery/microwave{pixel_x = -3; pixel_y = 6},/turf/simulated/floor/plating,/area/vault/assistantlair)
"cN" = (/obj/effect/decal/cleanable/vomit,/turf/simulated/floor/plating,/area/vault/assistantlair)
"cO" = (/obj/structure/kitchenspike,/turf/simulated/floor/plating{icon_state = "platingdmg1"},/area/vault/assistantlair)
"cP" = (/obj/structure/closet,/obj/item/weapon/kitchen/utensil/knife/large,/obj/item/weapon/reagent_containers/food/drinks/flour,/obj/item/weapon/reagent_containers/food/drinks/flour,/obj/item/weapon/reagent_containers/food/condiment/sugar,/obj/item/weapon/reagent_containers/food/snacks/meat{desc = "A slab of meat. You're not exactly sure where this came from."},/obj/item/weapon/reagent_containers/food/snacks/meat{desc = "A slab of meat. You're not exactly sure where this came from."},/obj/item/weapon/reagent_containers/food/snacks/meat{desc = "A slab of meat. You're not exactly sure where this came from."},/turf/simulated/floor/plating,/area/vault/assistantlair)
"cQ" = (/obj/structure/rack,/obj/item/weapon/gibtonite,/turf/simulated/floor/plating,/area/vault/assistantlair)
"cR" = (/obj/structure/sink/kitchen,/turf/simulated/wall/invulnerable/r_wall,/area/vault/assistantlair)
"cS" = (/obj/structure/table,/obj/machinery/light/small{dir = 1},/turf/simulated/floor/plating,/area/vault/assistantlair)
"cT" = (/obj/structure/bed/chair{dir = 8},/turf/simulated/floor/plating,/area/vault/assistantlair)
"cU" = (/obj/effect/decal/cleanable/dirt,/obj/item/weapon/rack_parts,/turf/simulated/floor/plating,/area/vault/assistantlair)
"cV" = (/obj/structure/rack,/obj/item/weapon/glowstick/blue,/obj/item/weapon/glowstick/red,/obj/item/weapon/glowstick,/turf/simulated/floor/plating,/area/vault/assistantlair)
"cW" = (/obj/abstract/map/spawner/mobs/lizard,/turf/simulated/floor/plating,/area/vault/assistantlair)
"cX" = (/obj/structure/table,/obj/abstract/map/spawner/space/drinks,/obj/effect/decal/cleanable/cobweb,/turf/simulated/floor/plating,/area/vault/assistantlair)
"cY" = (/obj/structure/rack,/obj/item/clothing/mask/gas,/obj/machinery/light/small{dir = 1},/turf/simulated/floor/plating,/area/vault/assistantlair)
"cZ" = (/obj/item/weapon/crowbar,/obj/effect/decal/cleanable/dirt,/obj/item/trash/cigbutt,/turf/simulated/floor/plating{icon_state = "platingdmg1"},/area/vault/assistantlair)
"da" = (/obj/structure/closet/emcloset,/obj/effect/decal/cleanable/cobweb2,/turf/simulated/floor/plating{icon_state = "platingdmg1"},/area/vault/assistantlair)
"db" = (/obj/abstract/map/spawner/misc/seeds,/obj/effect/decal/cleanable/scattered_sand,/turf/simulated/floor/plating,/area/vault/assistantlair)
"dc" = (/obj/item/weapon/reagent_containers/glass/bucket,/turf/simulated/floor/plating,/area/vault/assistantlair)
"dd" = (/obj/abstract/map/spawner/misc/seeds,/turf/simulated/floor/plating,/area/vault/assistantlair)
"de" = (/obj/abstract/map/spawner/mobs/mouse,/turf/simulated/floor/plating,/area/vault/assistantlair)
"df" = (/obj/effect/decal/cleanable/dirt,/obj/machinery/light_construct/small{dir = 4},/obj/item/trash/cigbutt,/mob/living/carbon/monkey,/turf/simulated/floor/plating{icon_state = "platingdmg3"},/area/vault/assistantlair)
"dg" = (/obj/structure/rack,/obj/item/bodybag,/turf/simulated/floor/plating,/area/vault/assistantlair)
"dh" = (/obj/item/weapon/gun_barrel,/turf/simulated/floor/plating,/area/vault/assistantlair)
"di" = (/obj/structure/rack,/obj/item/clothing/suit/fire/firefighter,/turf/simulated/floor/plating,/area/vault/assistantlair)
"dj" = (/obj/structure/closet/emcloset,/obj/machinery/light/small,/turf/simulated/floor/plating,/area/vault/assistantlair)
"dk" = (/obj/machinery/portable_atmospherics/hydroponics/soil,/obj/abstract/map/spawner/misc/seeds,/obj/machinery/light,/turf/simulated/floor/plating,/area/vault/assistantlair)
"dl" = (/obj/machinery/portable_atmospherics/hydroponics/soil,/obj/abstract/map/spawner/misc/seeds,/obj/effect/decal/cleanable/scattered_sand,/turf/simulated/floor/plating,/area/vault/assistantlair)
"dm" = (/obj/machinery/biogenerator,/turf/simulated/floor/plating,/area/vault/assistantlair)
"dn" = (/obj/machinery/seed_extractor,/obj/machinery/light,/turf/simulated/floor/plating,/area/vault/assistantlair)
"do" = (/obj/machinery/photocopier,/turf/simulated/floor/plating,/area/vault/assistantlair)
"dp" = (/obj/structure/closet,/turf/simulated/floor/plating,/area/vault/assistantlair)
"dq" = (/obj/item/weapon/blunderbuss/flawless,/obj/structure/grille,/turf/simulated/floor/plating,/area/vault/assistantlair)
"dr" = (/obj/structure/grille/broken,/obj/item/stack/rods,/turf/simulated/floor/plating,/area/vault/assistantlair)
"ds" = (/obj/structure/rack,/obj/item/asteroid/goliath_hide,/obj/item/asteroid/goliath_hide,/turf/simulated/floor/plating,/area/vault/assistantlair)
"dt" = (/obj/structure/table,/obj/abstract/map/spawner/assistant/tools,/obj/abstract/map/spawner/assistant/tools,/turf/simulated/floor/plating,/area/vault/assistantlair)
"du" = (/obj/structure/table,/obj/abstract/map/spawner/assistant/materials,/turf/simulated/floor/plating,/area/vault/assistantlair)
"dv" = (/obj/structure/table,/obj/machinery/cell_charger,/obj/item/weapon/wrench,/obj/item/weapon/screwdriver{pixel_y = 16},/turf/simulated/floor/plating,/area/vault/assistantlair)
"dw" = (/obj/structure/rack,/obj/item/weapon/reagent_containers/food/drinks/thermos/full,/obj/item/weapon/reagent_containers/food/drinks/thermos/full,/turf/simulated/floor/plating,/area/vault/assistantlair)
"dx" = (/obj/effect/decal/cleanable/dirt,/obj/machinery/light/small{dir = 4},/turf/simulated/floor/plating,/area/vault/assistantlair)
"dy" = (/obj/effect/decal/cleanable/dirt,/obj/machinery/light/small{dir = 8; flickering = 1},/obj/effect/decal/warning_stripes{tag = "icon-warning"; icon_state = "warning"},/turf/simulated/floor/plating,/area/vault/assistantlair)
"dz" = (/obj/effect/decal/warning_stripes{tag = "icon-loading_area (EAST)"; icon_state = "loading_area"; dir = 4},/turf/simulated/floor/plating,/area/vault/assistantlair)
"dA" = (/obj/effect/step_trigger/thrower/east,/obj/machinery/door/airlock/maintenance_hatch,/turf/simulated/floor/plating,/area/vault/assistantlair)
"dB" = (/obj/effect/mine/stun,/obj/item/toy/gasha/skub,/turf/simulated/floor/plating,/area/vault/assistantlair)
"dC" = (/obj/machinery/door/airlock/external,/turf/simulated/floor/plating,/area/vault/assistantlair)
"dD" = (/obj/structure/rack,/obj/item/weapon/extinguisher,/turf/simulated/floor/plating,/area/vault/assistantlair)
"dE" = (/obj/structure/rack,/obj/item/weapon/cell/potato,/turf/simulated/floor/plating,/area/vault/assistantlair)
"dF" = (/obj/machinery/portable_atmospherics/canister/air,/obj/structure/window/reinforced{dir = 8},/turf/simulated/floor/plating,/area/vault/assistantlair)
"dG" = (/obj/machinery/portable_atmospherics/canister/oxygen,/turf/simulated/floor/plating,/area/vault/assistantlair)
"dH" = (/obj/machinery/portable_atmospherics/canister/nitrogen,/obj/structure/window/reinforced{dir = 4},/turf/simulated/floor/plating,/area/vault/assistantlair)
"dI" = (/obj/machinery/vending,/turf/simulated/floor/plating,/area/vault/assistantlair)
"dJ" = (/obj/machinery/space_heater/air_conditioner,/obj/structure/window/reinforced{dir = 8},/turf/simulated/floor/plating,/area/vault/assistantlair)
"dK" = (/obj/machinery/space_heater,/turf/simulated/floor/plating,/area/vault/assistantlair)
"dL" = (/obj/structure/rack,/obj/item/clothing/mask/gas,/obj/item/clothing/glasses/sunglasses,/obj/structure/window/reinforced{dir = 4},/turf/simulated/floor/plating,/area/vault/assistantlair)
"dM" = (/obj/structure/table,/obj/item/trash/cheesie,/obj/item/clothing/gloves/yellow,/turf/simulated/floor/plating{icon_state = "panelscorched"},/area/vault/assistantlair)

(1,1,1) = {"
aaaaaaaaaaaaaaaaaaaaaaaaaaaaaaaaaaaaaaaaaaaaaaaaaaaaaaaaaaab
aaacadaaaeafagahaiaaajahakaaalahamaaanaoapaaaoaoaqahahaoaaaa
aaaoahaaarasaaanaoaaataaahahauaaahaaaoaaaaaaahaaaoaaaoanavaa
aaahaoaaamaaaaahamaaahaaaaaaaaaaahaaaoaaawaxaqaaayaaazaaahaa
aaaaaAaaaBaaaCahaDaaaEaaaFaGaaaaaoaoaoaaahaaaaaaaHaaaaaaaoaa
aaaIaIaaaBaaaaaJaoaKaLaaahaoahaManaaaaaaahaqaNaaaoaoaoaoahaa
aaaOaOaaaPaQaaanahaaaaaaaaaaaaaaahaaaRaaaaaoaSaaaTaoaaaUaoaa
aaaVaWaMaXaoaYahaZaaambaahbbaaaaahaaahaobcahaSaabdaoaaaabeaa
aabfahaabgaoaaahaaaaahaaaaaAaaaaahanahaoaobhaoaYbibjaoaabkaa
aaamanaaanaaaablaabmahaabnaobnaaboaoaabpaaaaaaaaaaaabqaaahaa
aaaabraaahaaaoaaaabsaoaabtaobuaabvaoaaaoamaobwaobxaaaaaaaoaa
abaaaaaaaoaaaaanahahamaabnaobnaabybzaaaoaaaaaaaaaoaoaoaoaoaa
abaabAaaahbBaaahaaaaaaaaaabCaaaaaaaaaaaoahaKbDaaaaaaaaaaaaaa
abaabEaMbFbnaaahaabGbHbIbJbKbKbLbMbNaaaobOaHaobPaobQaKaobRaa
abaabSaaahbTaaaoaaaaaabUbVbWbKbKbXbYaaaobZaHbOaaaoahaacacbaa
abaaaaaaaoaaaaaAaaccbXbKcdbKbKbKbXceaaanaoaHbOaacfbZaaaocgaa
abababaaahaachahaacibXbKbKbKbKbKbXceaabOaoaHaoaacjahaaahckaa
aaaaaaaaclaacmcnaacobXbKbKbKbKbKbXbYaaaobOaHbOaaaaaoaaahcpaa
aacqcraaahaacsctaacubXcvcwbKbKcxbMbNaaaoanaHaocyaaahaabZczaa
aacAcBaabgaoahahaaaaaaaaaabpaaaaaaaaaaaobOaHbOaaaaanaaaoaoaa
aabycCaaaaaaaaaaaaaacDcEahaoaoaocFcGcHaoaoaKaoaacIahaaaaamaa
aacJahahaoaKahaoaoaoaoaoahahamahbzaoahaoaoaaaaahaoahcKaacLaa
aacMcNcOcPaaaoahambzanaaaaaaaaaaaaaKaaaaahcQaaaKaaaaaaaaaoaa
aaaabpaaaaaaaaaJcRaabCaacScTbbaabncUanaaahcVaaaocWaocXaaahaa
aacYcZaoahdaaadbdcddddaaaodeaoaaaJaJdfaaaodgaaaoaodhaaaaanaa
aadiahaaaodjaadkdldmdnaadoaodpaadqaJdraabgdsaadtduaaaadvaoaa
aaaaaKaaahaaaaaaaaaaaaaaaaaKaaaaaaaaaaaabpaaaaaaaaaaaoahcLaa
aadwdxaadydzagawahbwbQahahahaoaoaoaxaoaoahaoaoaxahdAdBaaaaaa
dCaoaoaabndDaadEaiaaaaaaaabydFdGdHaoaJdIdIdJdKdLdMaacyaaabab
aaaaaaaaaaaaaaaaaaaaababaaaaaaaaaaaaaaaaaaaaaaaaaaaaaaaaabab
"}
