//MAP CONVERTED BY dmm2tgm.py THIS HEADER COMMENT PREVENTS RECONVERSION, DO NOT REMOVE
"a" = (
/turf/space,
/area)
"b" = (
/turf/unsimulated/floor/asteroid,
/area/mine/unexplored)
"c" = (
/turf/unsimulated/mineral/random,
/area/mine/unexplored)
"d" = (
/turf/unsimulated/mineral/random/high_chance_clown,
/area/mine/unexplored)
"e" = (
/obj/item/stack/ore/phazon,
/obj/item/stack/ore/phazon,
/obj/item/stack/ore/phazon,
/obj/item/stack/ore/phazon,
/turf/unsimulated/floor/asteroid,
/area/mine/unexplored)
"f" = (
/obj/item/stack/ore/phazon,
/obj/item/stack/ore/phazon,
/obj/item/stack/ore/phazon,
/obj/item/stack/ore/phazon,
/mob/living/simple_animal/hostile/asteroid/basilisk,
/turf/unsimulated/floor/asteroid,
/area/mine/unexplored)
"g" = (
/obj/item/stack/ore/phazon,
/obj/item/stack/ore/phazon,
/obj/item/stack/ore/phazon,
/obj/item/stack/ore/phazon,
/mob/living/simple_animal/hostile/asteroid/goliath,
/turf/unsimulated/floor/asteroid,
/area/mine/unexplored)
"h" = (
/obj/item/stack/ore/phazon,
/obj/item/stack/ore/phazon,
/obj/item/stack/ore/phazon,
/obj/item/stack/ore/phazon,
/obj/item/weapon/pickaxe/drill/diamond,
/turf/unsimulated/floor/asteroid,
/area/mine/unexplored)
"i" = (
/obj/item/stack/ore/phazon,
/obj/item/stack/ore/phazon,
/obj/item/stack/ore/phazon,
/obj/item/stack/ore/phazon,
/mob/living/simple_animal/hostile/asteroid/hivelord,
/turf/unsimulated/floor/asteroid,
/area/mine/unexplored)
"j" = (
/obj/item/stack/ore/phazon,
/obj/item/stack/ore/phazon,
/obj/item/stack/ore/phazon,
/obj/item/stack/ore/phazon,
/obj/item/stack/sheet/mineral/diamond,
/turf/unsimulated/floor/asteroid,
/area/mine/unexplored)

(1,1,1) = {"
a
a
a
a
c
c
c
c
a
a
a
a
a
a
a
a
a
a
a
a
a
a
a
a
"}
(2,1,1) = {"
a
a
c
c
c
d
d
c
c
c
a
a
a
a
a
a
a
a
a
a
a
a
a
a
"}
(3,1,1) = {"
a
a
c
d
d
d
d
d
d
c
c
a
a
a
a
a
a
a
c
c
c
c
c
a
"}
(4,1,1) = {"
a
a
c
d
d
d
d
d
d
d
c
c
a
a
a
a
a
c
c
d
d
d
c
c
"}
(5,1,1) = {"
a
b
c
d
d
d
d
d
d
d
d
c
c
c
a
a
a
c
d
d
d
d
d
c
"}
(6,1,1) = {"
a
b
c
d
d
d
e
e
d
d
d
d
d
c
c
a
c
c
d
d
d
d
d
c
"}
(7,1,1) = {"
a
b
c
c
d
d
e
f
e
e
d
d
d
d
c
a
c
d
d
d
d
d
d
c
"}
(8,1,1) = {"
b
b
b
c
c
d
d
e
h
i
f
d
d
d
c
a
c
d
d
d
d
d
d
c
"}
(9,1,1) = {"
b
b
b
b
c
d
d
g
e
j
e
d
d
d
c
a
c
c
d
d
d
d
d
c
"}
(10,1,1) = {"
b
b
b
c
c
d
d
d
d
e
g
d
d
d
c
a
a
c
c
d
d
c
c
c
"}
(11,1,1) = {"
a
b
b
c
d
d
d
d
d
d
d
d
d
d
c
a
a
a
c
c
c
c
a
a
"}
(12,1,1) = {"
a
a
a
c
d
d
d
d
d
d
d
d
d
d
c
a
a
a
a
a
a
a
a
a
"}
(13,1,1) = {"
a
a
a
c
c
c
c
c
c
d
d
d
d
d
c
a
a
a
c
c
c
a
a
a
"}
(14,1,1) = {"
a
a
a
a
a
a
a
a
c
c
c
c
c
c
c
a
a
c
c
d
c
c
a
a
"}
(15,1,1) = {"
a
a
a
a
a
a
a
a
a
a
a
a
a
a
a
a
c
c
d
d
d
c
c
a
"}
(16,1,1) = {"
a
a
a
a
b
b
b
c
c
c
c
c
a
a
a
a
c
d
d
d
d
d
c
a
"}
(17,1,1) = {"
a
a
c
c
c
c
c
c
d
d
d
c
c
a
a
a
c
d
d
d
d
d
c
a
"}
(18,1,1) = {"
a
a
c
d
d
d
d
d
d
d
d
d
c
c
a
b
c
c
d
d
d
c
c
a
"}
(19,1,1) = {"
a
a
c
d
d
d
d
d
d
d
d
d
d
c
a
b
b
c
c
d
d
c
a
a
"}
(20,1,1) = {"
a
a
c
d
d
d
d
d
d
d
d
d
d
c
a
a
b
b
c
c
c
c
a
a
"}
(21,1,1) = {"
a
a
c
d
d
d
d
d
d
d
d
d
c
c
a
a
a
b
b
b
b
a
a
a
"}
(22,1,1) = {"
a
a
c
c
d
d
d
c
c
c
c
c
c
a
a
a
a
a
b
b
a
a
a
a
"}
(23,1,1) = {"
a
a
a
c
c
c
c
c
a
a
a
a
a
a
a
a
a
a
a
a
a
a
a
a
"}
