//MAP CONVERTED BY dmm2tgm.py THIS HEADER COMMENT PREVENTS RECONVERSION, DO NOT REMOVE
"a" = (
/turf/space,
/area)
"b" = (
/turf/unsimulated/mineral/random/high_chance_clown,
/area/vault/automap)
"c" = (
/obj/item/weapon/pickaxe/diamond,
/obj/item/weapon/storage/belt/mining,
/obj/item/weapon/storage/bag/ore,
/turf/unsimulated/floor/asteroid/air,
/area/vault/automap)
"d" = (
/obj/effect/landmark/corpse/clown,
/obj/item/weapon/paper/asteroidfield,
/turf/unsimulated/floor/asteroid/air,
/area/vault/automap)

(1,1,1) = {"
a
a
a
a
a
a
a
a
a
a
a
a
a
a
a
a
a
a
a
a
a
a
a
a
a
"}
(2,1,1) = {"
a
a
a
a
a
a
a
a
a
a
a
a
a
a
a
a
a
a
a
a
a
a
a
b
a
"}
(3,1,1) = {"
a
a
a
a
b
a
a
a
a
a
a
b
b
a
a
a
a
a
a
a
a
b
a
a
a
"}
(4,1,1) = {"
a
a
a
b
b
a
a
b
b
b
a
a
a
a
a
a
a
a
a
b
a
a
a
a
a
"}
(5,1,1) = {"
a
a
a
b
a
a
a
b
a
a
a
a
a
a
a
a
b
b
a
b
a
a
a
b
a
"}
(6,1,1) = {"
a
a
a
a
a
a
a
a
a
a
a
a
a
a
a
a
a
b
b
a
a
a
a
b
a
"}
(7,1,1) = {"
a
a
a
a
a
a
a
a
a
a
a
a
a
b
a
a
a
a
a
a
a
a
a
b
a
"}
(8,1,1) = {"
a
a
a
a
a
a
a
a
a
a
a
a
b
b
a
a
a
a
a
a
a
a
a
a
a
"}
(9,1,1) = {"
a
a
a
a
b
b
a
a
a
a
a
a
a
a
a
a
a
a
a
a
a
a
a
a
a
"}
(10,1,1) = {"
a
a
a
a
a
a
a
a
a
a
a
a
a
a
a
a
a
a
a
b
b
b
a
a
a
"}
(11,1,1) = {"
a
a
a
a
a
a
a
b
b
a
a
a
a
a
a
a
a
a
a
b
b
a
a
a
a
"}
(12,1,1) = {"
a
b
a
a
a
a
a
b
a
a
a
a
a
a
b
a
b
a
a
a
b
a
a
a
a
"}
(13,1,1) = {"
a
b
a
a
a
a
b
b
a
a
a
a
a
a
a
a
b
a
a
a
a
a
a
a
a
"}
(14,1,1) = {"
a
a
a
a
a
a
b
a
a
a
c
d
a
a
a
a
b
a
a
a
a
a
b
b
b
"}
(15,1,1) = {"
a
a
a
a
a
a
a
a
a
b
b
a
a
a
a
a
a
a
a
a
a
a
b
b
a
"}
(16,1,1) = {"
a
a
a
a
a
a
a
a
a
a
a
a
a
a
a
a
a
a
a
a
a
a
a
a
a
"}
(17,1,1) = {"
a
a
a
a
b
a
a
a
a
a
a
a
a
b
b
b
a
a
a
a
a
a
a
a
a
"}
(18,1,1) = {"
a
a
a
a
a
a
a
a
a
a
a
a
a
a
a
b
a
a
a
b
a
a
a
a
a
"}
(19,1,1) = {"
b
a
a
a
a
a
a
a
a
a
b
b
a
a
a
a
a
a
a
a
a
a
a
a
a
"}
(20,1,1) = {"
b
b
a
a
a
a
a
a
a
a
a
b
b
a
a
a
a
a
a
a
a
a
a
a
a
"}
(21,1,1) = {"
a
b
a
a
a
b
b
a
a
a
a
a
a
a
a
a
b
a
a
b
b
a
a
a
a
"}
(22,1,1) = {"
a
a
a
a
a
a
b
a
a
b
b
b
a
a
a
a
b
b
a
b
a
a
a
a
a
"}
(23,1,1) = {"
a
a
a
a
a
a
b
a
a
a
a
a
a
a
b
b
a
a
a
a
a
a
a
a
a
"}
(24,1,1) = {"
a
a
a
a
a
a
a
a
a
a
a
a
a
a
a
a
a
a
a
a
a
a
a
a
a
"}
(25,1,1) = {"
a
a
a
a
a
a
a
a
a
a
a
a
a
a
a
a
a
a
a
a
a
a
a
a
a
"}
