"aa" = (/turf/space,/area)
"ab" = (/obj/structure/shuttle/engine/propulsion{dir = 1},/turf/space,/area/vault/brokeufo)
"ac" = (/obj/effect/decal/warning_stripes{icon_state = "bot"},/obj/structure/cage,/obj/effect/landmark/corpse/clown,/turf/simulated/floor/engine,/area/vault/brokeufo)
"ad" = (/obj/structure/shuttle/engine/propulsion/left{dir = 1},/turf/space,/area/vault/brokeufo)
"ae" = (/obj/structure/shuttle/diag_wall/smooth{dir = 8},/turf/space,/area/vault/brokeufo)
"af" = (/obj/effect/decal/warning_stripes{icon_state = "2"},/turf/simulated/floor/engine,/area/vault/brokeufo)
"ag" = (/turf/simulated/floor{icon_state = "dark"},/area/vault/brokeufo)
"ai" = (/obj/structure/shuttle/engine/heater{dir = 1},/obj/structure/window/reinforced/plasma,/turf/simulated/floor{icon_state = "old_enginewarn"; tag = "icon-old_enginewarn"},/area/vault/brokeufo)
"ak" = (/obj/structure/shuttle/diag_wall/smooth{dir = 1},/turf/space,/area/vault/brokeufo)
"am" = (/obj/effect/decal/cleanable/dirt,/obj/effect/decal/warning_stripes{icon_state = "bot"},/obj/structure/cage,/obj/effect/landmark/corpse/nazi,/turf/simulated/floor/engine,/area/vault/brokeufo)
"an" = (/obj/effect/decal/cleanable/dirt,/obj/effect/decal/warning_stripes{icon_state = "bot"},/obj/structure/cage,/obj/effect/landmark/corpse/trader,/turf/simulated/floor/engine,/area/vault/brokeufo)
"ao" = (/obj/structure/table/reinforced,/obj/item/weapon/storage/toolbox/electrical,/obj/item/device/flashlight/flare/ever_bright,/turf/simulated/floor{dir = 9; icon_state = "yellowfull"},/area/vault/brokeufo)
"ap" = (/obj/machinery/light{dir = 8},/obj/machinery/vending/engivend,/turf/simulated/floor{dir = 9; icon_state = "yellowfull"},/area/vault/brokeufo)
"aq" = (/obj/structure/table/reinforced,/obj/item/stack/sheet/mineral/plastic{amount = 50},/obj/item/stack/sheet/metal{amount = 50},/obj/effect/decal/cleanable/dirt,/obj/item/weapon/storage/box/inflatables,/obj/machinery/power/apc{cell_type = 0; dir = 4; icon_state = "apc1"; opened = 1; pixel_x = 28},/turf/simulated/floor{dir = 9; icon_state = "yellowfull"},/area/vault/brokeufo)
"ar" = (/obj/structure/closet/crate,/obj/item/weapon/reagent_containers/food/snacks/zam_spiderslider/wrapped,/obj/item/weapon/reagent_containers/food/snacks/zamitos_stokjerky,/obj/item/weapon/reagent_containers/food/condiment/zamspices,/turf/simulated/floor/carpet,/area/vault/brokeufo)
"as" = (/obj/structure/bed,/obj/effect/decal/cleanable/dirt,/obj/item/trash/zam_sliderwrapper,/obj/item/weapon/bedsheet/green,/turf/simulated/floor/carpet,/area/vault/brokeufo)
"at" = (/obj/structure/shuttle/engine/propulsion/right{dir = 1},/turf/space,/area/vault/brokeufo)
"au" = (/obj/effect/decal/warning_stripes{icon_state = "3"},/turf/simulated/floor/engine,/area/vault/brokeufo)
"av" = (/obj/effect/decal/cleanable/dirt,/obj/machinery/door/airlock/vault{id_tag = "ufocell"; locked = 1; name = "Containment Cell"},/turf/simulated/floor/engine,/area/vault/brokeufo)
"aw" = (/obj/effect/decal/cleanable/dirt,/turf/simulated/floor{dir = 9; icon_state = "yellowfull"},/area/vault/brokeufo)
"ax" = (/obj/item/clothing/gloves/yellow,/turf/simulated/floor{dir = 9; icon_state = "yellowfull"},/area/vault/brokeufo)
"ay" = (/obj/effect/decal/cleanable/blood/oil{icon_state = "floor6"},/mob/living/simple_animal/hostile/humanoid/grey/space/melee/toolbox{name = "Klaatu"},/turf/simulated/floor{dir = 9; icon_state = "yellowfull"},/area/vault/brokeufo)
"aB" = (/obj/structure/bed,/obj/item/weapon/bedsheet/green,/turf/simulated/floor/carpet,/area/vault/brokeufo)
"aC" = (/obj/effect/decal/cleanable/dirt,/obj/machinery/door/unpowered/shuttle{name = "Crew Quarters"},/turf/simulated/floor/carpet,/area/vault/brokeufo)
"aD" = (/turf/simulated/floor/carpet,/area/vault/brokeufo)
"aE" = (/obj/structure/bed,/obj/machinery/light{dir = 4},/obj/item/weapon/bedsheet/green,/turf/simulated/floor/carpet,/area/vault/brokeufo)
"aF" = (/obj/effect/decal/cleanable/dirt,/mob/living/simple_animal/hostile/humanoid/grey/space/ranged{name = "Zorb"},/turf/simulated/floor/engine,/area/vault/brokeufo)
"aG" = (/turf/simulated/floor{icon_state = "white"; tag = "icon-white"},/area/vault/brokeufo)
"aH" = (/obj/structure/rack,/obj/item/weapon/handcuffs,/obj/item/weapon/handcuffs,/obj/item/weapon/handcuffs,/obj/item/device/flashlight/flare/ever_bright,/obj/effect/decal/warning_stripes{icon_state = "unloading"},/turf/simulated/floor/engine,/area/vault/brokeufo)
"aI" = (/obj/machinery/light/small,/turf/simulated/floor/carpet,/area/vault/brokeufo)
"aJ" = (/obj/effect/decal/warning_stripes{icon_state = "1"},/turf/simulated/floor/engine,/area/vault/brokeufo)
"aK" = (/obj/structure/dispenser/oxygen,/obj/machinery/light/small{dir = 1},/turf/simulated/floor/plating,/area/vault/brokeufo)
"aL" = (/obj/structure/shuttle/diag_wall/smooth,/turf/simulated/floor/plating,/area/vault/brokeufo)
"aM" = (/obj/structure/closet/walllocker/emerglocker{pixel_y = -30},/turf/simulated/floor/plating,/area/vault/brokeufo)
"aN" = (/obj/machinery/door/airlock/external,/turf/simulated/floor/plating,/area/vault/brokeufo)
"aO" = (/obj/machinery/light/small,/turf/simulated/floor/plating,/area/vault/brokeufo)
"aP" = (/obj/item/device/flashlight/flare/ever_bright,/obj/effect/decal/warning_stripes{dir = 8; icon_state = "loading_area"; tag = "icon-loading_area (WEST)"},/obj/effect/decal/cleanable/dirt,/turf/simulated/floor/plating,/area/vault/brokeufo)
"aQ" = (/obj/effect/decal/warning_stripes{dir = 4; icon_state = "loading_area"; tag = "icon-loading_area (EAST)"},/turf/simulated/floor/plating,/area/vault/brokeufo)
"aR" = (/turf/simulated/floor/plating,/area/vault/brokeufo)
"aT" = (/obj/effect/decal/cleanable/blood{icon_state = "floor3"},/turf/simulated/floor/engine,/area/vault/brokeufo)
"aU" = (/obj/structure/shuttle/diag_wall/smooth{dir = 1},/turf/simulated/floor/plating,/area/vault/brokeufo)
"aW" = (/obj/structure/table/reinforced,/obj/item/weapon/switchtool/surgery,/obj/item/organ/internal/lungs/filter,/obj/effect/decal/cleanable/dirt,/turf/simulated/floor{icon_state = "white"; tag = "icon-white"},/area/vault/brokeufo)
"aX" = (/obj/effect/decal/cleanable/dirt,/turf/simulated/floor{icon_state = "white"; tag = "icon-white"},/area/vault/brokeufo)
"aY" = (/obj/machinery/door/airlock/vault{id_tag = "ufostorage"; locked = 1; name = "Storage Room"},/turf/simulated/floor{icon_state = "dark"},/area/vault/brokeufo)
"aZ" = (/turf/simulated/wall/shuttle,/area/vault/brokeufo)
"ba" = (/obj/effect/decal/cleanable/dirt,/obj/effect/decal/cleanable/blood/gibs{icon_state = "gibleg"},/obj/item/device/flashlight/flare/ever_bright,/obj/item/organ/external/l_arm,/turf/simulated/floor{icon_state = "white"; tag = "icon-white"},/area/vault/brokeufo)
"bb" = (/obj/effect/decal/cleanable/blood/drip,/turf/simulated/floor{icon_state = "white"; tag = "icon-white"},/area/vault/brokeufo)
"bc" = (/obj/machinery/door/unpowered/shuttle{name = "Bridge"},/turf/simulated/floor{icon_state = "white"; tag = "icon-white"},/area/vault/brokeufo)
"bd" = (/obj/machinery/light/small{dir = 4},/obj/item/trash/zamitos_o,/turf/simulated/floor/engine,/area/vault/brokeufo)
"be" = (/obj/machinery/door/unpowered/shuttle{name = "Engine Room"},/turf/simulated/floor{dir = 9; icon_state = "yellowfull"},/area/vault/brokeufo)
"bf" = (/obj/structure/table/reinforced,/obj/machinery/microwave/upgraded{pixel_y = 5},/obj/item/trash/used_tray,/obj/item/weapon/kitchen/utensil/fork/teflon{pixel_x = 6},/turf/simulated/floor/carpet,/area/vault/brokeufo)
"bg" = (/obj/effect/decal/cleanable/dirt,/turf/simulated/floor/carpet,/area/vault/brokeufo)
"bh" = (/obj/structure/table/reinforced,/obj/item/stack/sheet/mineral/diamond{amount = 10},/turf/simulated/floor{dir = 8; icon_state = "whitered"},/area/vault/brokeufo)
"bi" = (/obj/item/trash/zam_notraisins,/turf/simulated/floor/carpet,/area/vault/brokeufo)
"bj" = (/obj/structure/bed,/obj/effect/decal/cleanable/dirt,/obj/item/weapon/soap,/obj/item/weapon/bedsheet/green,/turf/simulated/floor/carpet,/area/vault/brokeufo)
"by" = (/obj/effect/decal/cleanable/dirt,/turf/simulated/floor{icon_state = "dark"},/area/vault/brokeufo)
"ca" = (/obj/machinery/light/small{dir = 1},/turf/simulated/floor{icon_state = "darkredcorners"; tag = "icon-darkredcorners"},/area/vault/brokeufo)
"cq" = (/obj/machinery/light/small{dir = 1},/turf/simulated/floor/plating,/area/vault/brokeufo)
"cF" = (/obj/structure/grille,/obj/structure/window/reinforced,/obj/structure/window/reinforced{dir = 1},/obj/structure/window/full/reinforced,/obj/machinery/door/poddoor{id_tag = "ufobridge"; name = "Blast Shield Shutters"},/turf/simulated/floor{icon_state = "white"; tag = "icon-white"},/area/vault/brokeufo)
"cH" = (/mob/living/simple_animal/hostile/humanoid/grey/space/ranged{name = "Barada"},/turf/simulated/floor{icon_state = "white"; tag = "icon-white"},/area/vault/brokeufo)
"fd" = (/obj/structure/table/reinforced,/obj/machinery/door_control{id_tag = "ufostorage"; name = "Storage Bolt Control"; normaldoorcontrol = 1; pixel_x = 25; specialfunctions = 4},/obj/machinery/recharger,/obj/item/weapon/cell/super,/turf/simulated/floor{dir = 6; icon_state = "whitered"},/area/vault/brokeufo)
"gw" = (/obj/structure/shuttle/diag_wall/smooth,/turf/space,/area/vault/brokeufo)
"gO" = (/obj/structure/shuttle/diag_wall/smooth{dir = 4},/turf/simulated/floor/plating,/area/vault/brokeufo)
"gS" = (/obj/structure/grille,/obj/structure/window/reinforced,/obj/structure/window/reinforced{dir = 8},/obj/structure/window/reinforced{dir = 1},/obj/structure/window/full/reinforced,/obj/machinery/door/poddoor{id_tag = "ufobridge"; name = "Blast Shield Shutters"},/turf/simulated/floor{icon_state = "white"; tag = "icon-white"},/area/vault/brokeufo)
"gZ" = (/turf/simulated/floor/plating/airless{icon_state = "platingdmg1"},/area/vault/brokeufo)
"hl" = (/obj/structure/table/reinforced,/obj/item/weapon/circuitboard/communications,/obj/effect/decal/cleanable/dirt,/turf/simulated/floor{dir = 6; icon_state = "whitered"},/area/vault/brokeufo)
"hD" = (/obj/structure/rack,/obj/item/weapon/cell/super,/obj/item/weapon/cell/super,/obj/item/weapon/electrolyzer,/obj/item/tool/solder/pre_fueled,/obj/item/tool/weldingtool/hugetank,/obj/item/weapon/switchtool/swiss_army_knife,/obj/item/tool/crowbar/red,/obj/item/stack/sheet/glass/glass/bigstack,/obj/item/stack/sheet/metal/bigstack,/obj/item/device/radio,/obj/effect/decal/warning_stripes{icon_state = "unloading"},/obj/item/device/multitool,/obj/item/weapon/storage/firstaid/adv,/obj/item/device/flashlight,/turf/simulated/floor{icon_state = "dark"},/area/vault/brokeufo)
"hP" = (/obj/effect/decal/cleanable/dirt,/obj/structure/table/reinforced,/obj/machinery/light/small{dir = 8},/obj/item/weapon/storage/firstaid,/obj/item/weapon/storage/box/masks,/turf/simulated/floor{icon_state = "white"; tag = "icon-white"},/area/vault/brokeufo)
"iH" = (/obj/structure/dispenser/oxygen,/obj/machinery/light/small/broken,/turf/simulated/floor/plating,/area/vault/brokeufo)
"iW" = (/turf/simulated/floor/plating/airless,/area/vault/brokeufo)
"jP" = (/obj/structure/sign/poster{icon_state = "bsposter10"; pixel_x = -32},/turf/simulated/floor{dir = 1; icon_state = "darkredcorners"; tag = "icon-darkredcorners (NORTH)"},/area/vault/brokeufo)
"jZ" = (/obj/structure/shuttle/diag_wall/smooth{dir = 4},/turf/space,/area/vault/brokeufo)
"kc" = (/obj/structure/bed/chair/shuttle/red,/obj/item/stack/cable_coil/random,/turf/simulated/floor{icon_state = "white"; tag = "icon-white"},/area/vault/brokeufo)
"lv" = (/obj/effect/decal/cleanable/dirt,/obj/effect/decal/warning_stripes{dir = 1; icon_state = "loading_area"; tag = "icon-loading_area (NORTH)"},/turf/simulated/floor/plating,/area/vault/brokeufo)
"lK" = (/obj/structure/computerframe,/turf/simulated/floor{icon_state = "whitered"; tag = "icon-whitered"},/area/vault/brokeufo)
"lV" = (/obj/effect/decal/cleanable/dirt,/turf/simulated/floor{dir = 1; icon_state = "darkredcorners"; tag = "icon-darkredcorners (NORTH)"},/area/vault/brokeufo)
"mo" = (/obj/structure/shuttle/diag_wall/smooth{dir = 1},/turf/simulated/floor{icon_state = "darkredcorners"; tag = "icon-darkredcorners"},/area/vault/brokeufo)
"nG" = (/obj/effect/decal/cleanable/dirt,/obj/item/organ/external/l_hand,/obj/effect/decal/cleanable/blood{icon_state = "gibbl4"},/turf/simulated/floor{icon_state = "white"; tag = "icon-white"},/area/vault/brokeufo)
"ok" = (/obj/machinery/optable,/obj/machinery/light,/obj/effect/landmark/corpse/tajaran,/obj/effect/decal/cleanable/blood{icon_state = "floor4"},/turf/simulated/floor{icon_state = "white"; tag = "icon-white"},/area/vault/brokeufo)
"qo" = (/obj/structure/rack,/obj/item/weapon/storage/box/syringes,/obj/item/weapon/gun/syringe,/obj/effect/decal/warning_stripes{icon_state = "unloading"},/turf/simulated/floor/engine,/area/vault/brokeufo)
"rH" = (/obj/structure/shuttle/diag_wall/smooth,/turf/simulated/floor{icon_state = "darkredfull"; tag = "icon-darkredfull"},/area/vault/brokeufo)
"se" = (/obj/structure/table/reinforced,/obj/item/weapon/gun/projectile/flare,/turf/simulated/floor{dir = 10; icon_state = "whitered"},/area/vault/brokeufo)
"uN" = (/obj/machinery/light/small{dir = 1},/turf/simulated/floor{icon_state = "white"; tag = "icon-white"},/area/vault/brokeufo)
"vI" = (/obj/machinery/door/airlock/external{locked = 1},/turf/simulated/floor/plating,/area/vault/brokeufo)
"xT" = (/obj/structure/table/reinforced,/obj/item/tool/bonesetter,/obj/item/tool/bonegel,/turf/simulated/floor{icon_state = "white"; tag = "icon-white"},/area/vault/brokeufo)
"zX" = (/obj/structure/closet/crate/freezer/surgery,/obj/item/organ/internal/heart/insectoid,/obj/item/organ/internal/heart,/obj/item/organ/internal/heart,/obj/item/organ/internal/lungs,/obj/item/organ/internal/lungs/plasmaman,/obj/item/organ/internal/lungs/vox,/obj/item/organ/internal/lungs,/obj/item/organ/internal/liver,/obj/item/organ/internal/eyes/grey,/obj/item/organ/internal/eyes/tajaran,/obj/item/organ/internal/eyes/tajaran,/obj/item/organ/internal/kidneys,/obj/item/organ/internal/appendix,/obj/item/organ/internal/appendix,/obj/effect/decal/warning_stripes{icon_state = "unloading"},/turf/simulated/floor{icon_state = "dark"},/area/vault/brokeufo)
"Aw" = (/obj/item/toy/gasha/wizard,/turf/space,/area)
"CM" = (/obj/machinery/vending/medical{emagged = 1},/turf/simulated/floor/engine,/area/vault/brokeufo)
"DJ" = (/obj/effect/decal/cleanable/dirt,/turf/simulated/floor/plating,/area/vault/brokeufo)
"FC" = (/obj/effect/decal/cleanable/dirt,/turf/simulated/floor{icon_state = "darkredfull"; tag = "icon-darkredfull"},/area/vault/brokeufo)
"Gm" = (/obj/structure/closet/walllocker/emerglocker{pixel_y = 30},/turf/simulated/floor/plating,/area/vault/brokeufo)
"Gt" = (/obj/structure/table/reinforced,/obj/item/weapon/storage/fancy/flares,/obj/machinery/door_control{id_tag = "ufocell"; name = "Cell Bolt Control"; normaldoorcontrol = 1; pixel_x = -25; pixel_y = 5; specialfunctions = 4},/obj/machinery/door_control{id_tag = "ufobridge"; name = "Blast Shield Control"; pixel_x = -25; pixel_y = -5},/turf/simulated/floor{dir = 10; icon_state = "whitered"},/area/vault/brokeufo)
"IX" = (/obj/structure/table/reinforced,/obj/item/weapon/storage/pill_bottle/zambiscuits,/obj/item/weapon/reagent_containers/food/snacks/zambiscuit_butter,/obj/item/weapon/reagent_containers/food/snacks/zambiscuit,/obj/item/weapon/reagent_containers/food/snacks/zambiscuit,/turf/simulated/floor{dir = 4; icon_state = "whitered"},/area/vault/brokeufo)
"Ln" = (/turf/simulated/floor/glass/plasma,/area/vault/brokeufo)
"LK" = (/obj/structure/bed/chair{dir = 4},/turf/simulated/floor/carpet,/area/vault/brokeufo)
"Pb" = (/obj/machinery/light,/obj/structure/rack,/obj/item/clothing/shoes/magboots,/obj/item/clothing/head/helmet/space/nasavoid,/obj/item/clothing/suit/space/nasavoid,/obj/item/weapon/tank/jetpack/carbondioxide,/obj/effect/decal/warning_stripes{icon_state = "unloading"},/obj/item/weapon/gun/energy/smalldisintegrator,/turf/simulated/floor{icon_state = "dark"},/area/vault/brokeufo)
"RO" = (/obj/effect/decal/cleanable/blood/drip,/mob/living/simple_animal/hostile/humanoid/grey/space/melee/scalpel{name = "Nikto"},/obj/machinery/vending/wallmed1{pixel_x = 28},/turf/simulated/floor{icon_state = "white"; tag = "icon-white"},/area/vault/brokeufo)
"Tp" = (/obj/structure/table/reinforced,/obj/item/weapon/storage/bag/zam_food,/obj/item/weapon/reagent_containers/food/snacks/zamdinnerclassic,/obj/item/weapon/reagent_containers/food/snacks/zamdinnerclassic,/obj/item/weapon/reagent_containers/food/drinks/soda_cans/zam_sulphuricsplash,/obj/item/weapon/reagent_containers/food/drinks/soda_cans/zam_sulphuricsplash,/obj/effect/decal/cleanable/dirt,/obj/item/weapon/kitchen/utensil/fork/teflon,/obj/item/weapon/kitchen/utensil/fork/teflon,/turf/simulated/floor/carpet,/area/vault/brokeufo)
"TL" = (/obj/machinery/door/unpowered/shuttle{name = "Research Bay"},/turf/simulated/floor{icon_state = "white"; tag = "icon-white"},/area/vault/brokeufo)
"TS" = (/obj/effect/decal/cleanable/dirt,/obj/effect/decal/warning_stripes{icon_state = "loading_area"; tag = "icon-loading_area"},/turf/simulated/floor/plating,/area/vault/brokeufo)
"Ue" = (/obj/structure/closet/secure_closet/medical2,/obj/effect/decal/cleanable/dirt,/turf/simulated/floor{icon_state = "white"; tag = "icon-white"},/area/vault/brokeufo)
"XF" = (/obj/structure/shuttle/diag_wall/smooth{dir = 8},/turf/simulated/floor/plating,/area/vault/brokeufo)
"Zo" = (/obj/structure/shuttle/diag_wall/smooth{dir = 8},/turf/simulated/floor{icon_state = "white"; tag = "icon-white"},/area/vault/brokeufo)
"ZA" = (/obj/effect/decal/cleanable/dirt,/obj/item/device/flashlight/flare/ever_bright,/obj/machinery/light/small{dir = 1},/turf/simulated/floor{icon_state = "white"; tag = "icon-white"},/area/vault/brokeufo)

(1,1,1) = {"
aaaaaaaaaaaeaZatabadaZakaaaaaaaaaa
aaaaaaaeaZaZaZaiaiaiaZaZaZakaaaaaa
aaaaaeaZamanaZapaoaqaZarasaZakaaaa
aaaeaZacafauavawayaxaZaBaDaEaZakaa
aaaZaHaJaTbdaZaZbeaZaZbfbgbibjaZaa
aaaZaZaZqoaFCMaZaRaCaIbgaDLKTpaZaa
aeaZaKaZaZaZaZgOlvaLaZaZaZaZaZaZak
iWvIaMaNDJaOaRaPLnaQaRcqDJaNGmvIgZ
gwaZaZaZaZaZaZaUTSXFaZaZaZaZiHaZjZ
aaaZxTaWnGaGaXTLaRaYbyagcarHaZaZaa
aaaZhPbabbZoaZaZbcaZaZmoFClVzXaZaa
aagwaZUeROaZbhZAaGuNIXaZjPhDaZjZaa
aaaagwaZokaZseaXkccHhlaZPbaZjZaaaa
aaaaaagwaZaZaZGtlKfdaZaZaZjZaaaaaa
aaaaaaaaaagwaZgScFcFaZjZaaaaaaAwaa
"}
