//MAP CONVERTED BY dmm2tgm.py THIS HEADER COMMENT PREVENTS RECONVERSION, DO NOT REMOVE
"aa" = (
/turf/space,
/area)
"ab" = (
/turf/simulated/wall,
/area/vault/dancedance)
"ac" = (
/obj/machinery/door/airlock/external,
/turf/simulated/floor/carpet,
/area/vault/dancedance)
"ad" = (
/turf/simulated/floor/carpet,
/area/vault/dancedance)
"ae" = (
/obj/structure/coatrack,
/turf/simulated/floor/carpet,
/area/vault/dancedance)
"af" = (
/obj/machinery/light/small,
/turf/space,
/area)
"ag" = (
/turf/simulated/wall/r_wall,
/area/vault/dancedance)
"ah" = (
/obj/machinery/light{
	dir = 8
	},
/turf/simulated/floor/carpet,
/area/vault/dancedance)
"ai" = (
/obj/machinery/light{
	dir = 4
	},
/turf/simulated/floor/carpet,
/area/vault/dancedance)
"aj" = (
/obj/structure/table/woodentable,
/obj/item/weapon/reagent_containers/food/drinks/bottle/vodka,
/obj/item/weapon/reagent_containers/food/drinks/drinkingglass,
/obj/item/weapon/reagent_containers/food/drinks/drinkingglass,
/turf/simulated/floor/carpet,
/area/vault/dancedance)
"ak" = (
/obj/structure/flora/pottedplant,
/turf/simulated/floor/carpet,
/area/vault/dancedance)
"al" = (
/obj/machinery/light/small{
	dir = 4
	},
/turf/space,
/area)
"am" = (
/obj/machinery/door/airlock/glass,
/turf/simulated/floor/carpet,
/area/vault/dancedance)
"an" = (
/obj/machinery/light/small{
	dir = 8
	},
/turf/space,
/area)
"ao" = (
/turf/simulated/floor/light,
/area/vault/dancedance)
"ap" = (
/obj/item/device/maracas,
/turf/simulated/floor/light,
/area/vault/dancedance)
"aq" = (
/obj/machinery/light{
	dir = 1
	},
/turf/simulated/floor/wood,
/area/vault/dancedance)
"ar" = (
/turf/simulated/floor/wood,
/area/vault/dancedance)
"as" = (
/mob/living/simple_animal/hostile/humanoid/russian{
	name = "Breakdancin' Boris"
	},
/turf/simulated/floor/light,
/area/vault/dancedance)
"at" = (
/mob/living/simple_animal/hostile/humanoid/russian{
	name = "Polka Pjotr"
	},
/turf/simulated/floor/light,
/area/vault/dancedance)
"au" = (
/obj/machinery/light{
	dir = 8
	},
/turf/simulated/floor/wood,
/area/vault/dancedance)
"av" = (
/obj/structure/window/reinforced/plasma,
/turf/simulated/floor/wood,
/area/vault/dancedance)
"aw" = (
/obj/machinery/light{
	dir = 4
	},
/turf/simulated/floor/wood,
/area/vault/dancedance)
"ax" = (
/obj/structure/window/reinforced/plasma{
	dir = 4
	},
/turf/simulated/floor/wood,
/area/vault/dancedance)
"ay" = (
/turf/simulated/floor,
/area/vault/dancedance)
"az" = (
/obj/structure/window/reinforced/plasma{
	dir = 8
	},
/turf/simulated/floor/wood,
/area/vault/dancedance)
"aA" = (
/obj/effect/ddr_direction,
/turf/simulated/floor,
/area/vault/dancedance)
"aB" = (
/obj/structure/sign/shiggymemorial,
/turf/simulated/wall,
/area/vault/dancedance)
"aC" = (
/obj/structure/window/reinforced/plasma{
	dir = 1
	},
/turf/simulated/floor/wood,
/area/vault/dancedance)
"aD" = (
/mob/living/simple_animal/hostile/humanoid/russian{
	name = "Salsa Sergei"
	},
/turf/simulated/floor/light,
/area/vault/dancedance)
"aE" = (
/mob/living/simple_animal/hostile/humanoid/russian{
	name = "Moonwalkin' Mihail"
	},
/turf/simulated/floor/light,
/area/vault/dancedance)
"aF" = (
/obj/machinery/media/jukebox/superjuke,
/turf/simulated/floor/light,
/area/vault/dancedance)
"aG" = (
/obj/structure/dance_dance_revolution,
/turf/simulated/floor/light,
/area/vault/dancedance)
"aH" = (
/obj/effect/ddr_loot,
/turf/simulated/wall,
/area/vault/dancedance)
"aI" = (
/obj/structure/painting/narsie{
	pixel_x = -32
	},
/turf/simulated/floor/wood,
/area/vault/dancedance)
"aJ" = (
/obj/structure/mirror{
	pixel_y = 32
	},
/turf/simulated/floor/wood,
/area/vault/dancedance)
"aK" = (
/turf/simulated/wall,
/area/vault/dancedance/loot)
"aL" = (
/turf/simulated/wall/invulnerable,
/area/vault/dancedance/loot)
"aM" = (
/obj/effect/ddr_loot,
/turf/simulated/wall/invulnerable,
/area/vault/dancedance/loot)
"aN" = (
/turf/simulated/wall/invulnerable,
/area/vault/dancedance)
"aO" = (
/obj/structure/reagent_dispensers/water_cooler,
/turf/simulated/floor/wood,
/area/vault/dancedance)
"aP" = (
/obj/structure/bed/chair/comfy/brown{
	dir = 4
	},
/turf/simulated/floor/wood,
/area/vault/dancedance)
"aQ" = (
/obj/structure/table/woodentable,
/obj/item/weapon/reagent_containers/food/drinks/beer{
	pixel_x = -6;
	pixel_y = 12
	},
/obj/item/weapon/reagent_containers/food/drinks/beer,
/obj/item/weapon/reagent_containers/food/drinks/bottle/absinthe,
/obj/item/weapon/reagent_containers/food/drinks/drinkingglass,
/turf/simulated/floor/wood,
/area/vault/dancedance)
"aR" = (
/turf/simulated/floor/greengrid,
/area/vault/dancedance/loot)
"aS" = (
/obj/structure/rack,
/obj/item/clothing/shoes/clown_shoes/advanced,
/obj/item/clothing/head/clownpiece,
/obj/item/clothing/suit/clownpiece/flying,
/turf/simulated/floor/greengrid,
/area/vault/dancedance/loot)
"aT" = (
/obj/structure/rack,
/obj/item/device/camera/sepia,
/obj/item/weapon/staff/broom/horsebroom,
/turf/simulated/floor/greengrid,
/area/vault/dancedance/loot)
"aU" = (
/obj/structure/table,
/obj/item/weapon/reagent_containers/food/snacks/grown/watermelon,
/obj/item/weapon/reagent_containers/food/snacks/grown/watermelon,
/obj/item/weapon/reagent_containers/food/snacks/grown/watermelon,
/obj/item/weapon/reagent_containers/food/snacks/grown/watermelon,
/obj/item/weapon/reagent_containers/food/snacks/grown/apple,
/obj/item/weapon/reagent_containers/food/drinks/bottle/vodka,
/obj/item/weapon/reagent_containers/food/drinks/drinkingglass,
/turf/simulated/floor/wood,
/area/vault/dancedance)
"aV" = (
/obj/structure/table/woodentable,
/obj/item/ashtray/glass,
/obj/item/trash/cigbutt,
/turf/simulated/floor/wood,
/area/vault/dancedance)
"aW" = (
/obj/item/weapon/reagent_containers/food/drinks/golden_cup{
	name = "Dance Dance Revolution champion"
	},
/turf/simulated/floor/greengrid,
/area/vault/dancedance/loot)
"aX" = (
/obj/item/weapon/lipstick/random,
/turf/simulated/floor/greengrid,
/area/vault/dancedance/loot)
"aY" = (
/obj/structure/table,
/obj/item/weapon/reagent_containers/food/snacks/grown/lemon,
/obj/item/weapon/reagent_containers/food/snacks/grown/lemon,
/obj/item/weapon/reagent_containers/food/snacks/grown/lemon,
/obj/item/weapon/reagent_containers/food/snacks/grown/cherries,
/obj/item/weapon/reagent_containers/food/snacks/grown/cherries,
/obj/item/weapon/reagent_containers/food/snacks/grown/apple,
/obj/item/weapon/reagent_containers/food/drinks/bottle/vodka,
/turf/simulated/floor/wood,
/area/vault/dancedance)
"aZ" = (
/obj/structure/flora/pottedplant,
/turf/simulated/floor/wood,
/area/vault/dancedance)
"ba" = (
/obj/structure/bed/chair/comfy/brown{
	dir = 1
	},
/obj/machinery/light,
/turf/simulated/floor/wood,
/area/vault/dancedance)
"bb" = (
/obj/machinery/light,
/turf/simulated/floor/wood,
/area/vault/dancedance)
"bc" = (
/obj/structure/table,
/obj/item/weapon/reagent_containers/food/snacks/grown/grapes,
/obj/item/weapon/reagent_containers/food/snacks/grown/grapes,
/obj/item/weapon/reagent_containers/food/snacks/grown/grapes,
/obj/item/weapon/reagent_containers/food/snacks/grown/cherries,
/obj/item/weapon/reagent_containers/food/snacks/grown/cherries,
/obj/item/weapon/reagent_containers/food/snacks/grown/apple,
/obj/item/weapon/reagent_containers/food/snacks/grown/apple,
/turf/simulated/floor/wood,
/area/vault/dancedance)

(1,1,1) = {"
aa
aa
aa
aa
al
aa
aa
aa
aa
aa
aa
al
aa
aa
aa
aa
aa
aa
al
aa
"}
(2,1,1) = {"
aa
aa
aa
ag
ag
ag
ag
ag
ag
ag
ag
ag
ag
ag
ag
ag
ag
ag
ag
ag
"}
(3,1,1) = {"
aa
aa
af
ag
ab
ab
ab
ab
ab
ab
ab
ab
ab
ab
ab
ab
ab
ab
ab
ag
"}
(4,1,1) = {"
aa
aa
aa
ag
ab
ao
ap
au
ao
ao
au
ap
ao
aB
aI
aP
aP
aZ
ab
ag
"}
(5,1,1) = {"
aa
aa
ag
ag
ab
ap
ao
ar
ao
ao
ar
ao
ap
ab
aJ
aQ
aV
ba
ab
ag
"}
(6,1,1) = {"
ab
ac
ab
ag
ab
aq
ar
ar
ax
ax
ar
ar
ar
ar
ar
ar
ar
ar
ab
ag
"}
(7,1,1) = {"
ab
ad
ab
ag
ab
ao
as
av
ay
aA
aC
aD
ao
ab
aK
aK
aK
aK
ab
ag
"}
(8,1,1) = {"
ab
ac
ab
ab
ab
ao
ao
av
ay
ay
aC
ao
ao
ab
aL
aL
aL
aL
ab
ag
"}
(9,1,1) = {"
ab
ad
ah
ad
am
ar
ar
ar
az
az
ar
ar
ar
aH
aM
aR
aR
aL
ab
ag
"}
(10,1,1) = {"
ab
ae
ad
aj
ab
ao
ao
ar
ao
ao
ar
ao
aF
ab
aL
aS
aW
aL
ab
ag
"}
(11,1,1) = {"
ab
ae
ad
ak
ab
ao
ao
ar
ao
ao
ar
ao
aG
ab
aL
aT
aR
aL
ab
ag
"}
(12,1,1) = {"
ab
ad
ai
ad
am
ar
ar
ar
ax
ax
ar
ar
ar
aH
aM
aR
aX
aL
ab
ag
"}
(13,1,1) = {"
ab
ac
ab
ab
ab
ao
at
av
ay
aA
aC
aE
ao
ab
aN
aN
aN
aN
ab
ag
"}
(14,1,1) = {"
ab
ad
ab
ag
ab
ao
ao
av
ay
ay
aC
ao
ao
ab
ab
ab
ab
ab
ab
ag
"}
(15,1,1) = {"
ab
ac
ab
ag
ab
aq
ar
ar
az
az
ar
ar
ar
ar
ar
ar
ar
ar
ab
ag
"}
(16,1,1) = {"
aa
aa
ag
ag
ab
ap
ao
ar
ao
ao
ar
ao
ap
ab
ar
ar
ar
bb
ab
ag
"}
(17,1,1) = {"
aa
aa
aa
ag
ab
ao
ap
aw
ao
ao
aw
ap
ao
ab
aO
aU
aY
bc
ab
ag
"}
(18,1,1) = {"
aa
aa
af
ag
ab
ab
ab
ab
ab
ab
ab
ab
ab
ab
ab
ab
ab
ab
ab
ag
"}
(19,1,1) = {"
aa
aa
aa
ag
ag
ag
ag
ag
ag
ag
ag
ag
ag
ag
ag
ag
ag
ag
ag
ag
"}
(20,1,1) = {"
aa
aa
aa
aa
an
aa
aa
aa
aa
aa
aa
an
aa
aa
aa
aa
aa
aa
an
aa
"}
