"a" = (/turf/space,/area)
"b" = (/turf/unsimulated/floor/asteroid,/area/random_vault)
"c" = (/turf/unsimulated/mineral,/area/random_vault)
"d" = (/turf/unsimulated/mineral/erebite,/area/random_vault)
"e" = (/turf/unsimulated/mineral/cobryl,/area/random_vault)
"f" = (/turf/unsimulated/mineral/iron,/area/random_vault)
"g" = (/turf/unsimulated/mineral/molitz,/area/random_vault)
"h" = (/turf/unsimulated/mineral/bohrum,/area/random_vault)
"i" = (/turf/unsimulated/mineral/cytine,/area/random_vault)
"j" = (/turf/unsimulated/mineral/mauxite,/area/random_vault)
"k" = (/turf/unsimulated/mineral/pharosium,/area/random_vault)
"l" = (/turf/unsimulated/mineral/syreline,/area/random_vault)
"m" = (/turf/unsimulated/mineral/uqill,/area/random_vault)
"n" = (/turf/unsimulated/mineral/plasma,/area/random_vault)
"o" = (/turf/unsimulated/mineral/char,/area/random_vault)

(1,1,1) = {"
aaaaaaaaaaaaaaaaaaaaaaaaaaaaaaaaaaaaaaaaaaaaaaaaaaaaaaaaaaaa
aaaaaaaaaaaaaaaaaaaaaaaaaaaaaaaaaaaaaaaaaaaaaaaaaaaaaaaaaaaa
aaaaaaaaaaaaaaaaaaaaaaaaaaaaaaaaaaaaaaaaaaaaaaaaaaaaaaaaaaaa
aaaaaaaaaaaaaaaaaaaaaaaaaaaaaaaaaaaaaaaaaaaaaaaaaaaaaaaaaaaa
aaaaaaaaaaaaaaaaaaaaaaaaaaaaaaaaaaaaaaaaaaaaaaaaaaaaaaaaaaaa
aaaaaaaaaaaaaaaaaaaaaaaaaaaaaaaaaaaaaaaaaaaaaaaaaaaaaaaaaaaa
aaaaaaaaaaaaaaaaaaaaaaaaaaaaaaaaaaaaaaaaaaaaaaaaaaaaaaaaaaaa
aaaaaaaaaaaaaaaaaaaaaaaaaaaaaaaaaaaaabbaabaaaaaaaaaaaaaaaaaa
aaaaaaaaaaaaaaaaaaaaaaaaaaaaaaaaaabbbbbbbbaaaaaaaaaaaaaaaaaa
aaaaaaaaaaaaaaaaaaaaaaaaaaaaaaabbbbbbbbbbbbaaaaaaaaaaaaaaaaa
aaaaaaaaaaaaaaaaaaaaaaaaaaaaaacbbcbbbbbbbbbbbaaaaaaaaaaaaaaa
aaaaaaaaaaaaaaaaaaaaaaaaaaaaccccccccbbbbbbbbbbaaaaaaaaaaaaaa
aaaaaaaaaaaaabaaaaaaaaaaaaaccccccccbbcbcbbbbbbaaaaaaaaaaaaaa
aaaaaaaaaababbbaaaaaaccddddccccccccceeeeccbbbbbaaaaaaaaaaaaa
aaaaaaaaaabbbbbaafffcgcddddccccccccceeeeecccbbbbaaaaaaaaaaaa
aaaaaaaaabbbbbbfccccggcdddcccchhhcccccceeccccbbbaaaaaaaaaaaa
aaaaaaaabbbbbbbfcccggcdddcccccccchhcccccccccccbbaaaaaaaaaaaa
aaaaaabbbbbbbbcfccggccddccchhhcceehcccccccdccccaaaaaaaaaaaaa
aaaaaabbbbbbbbcgccgcccdcchhhhhhccehhccccccdcddcaaaaaaaaaaaaa
aaaaaaabbbbbbffggggcccccchccccchhhhhhccccccdddcaaaaaaaaaaaaa
aaaaaabbbbbbbcccggcccicchccccccccccchhcccccdddaaaaaaaaaaaaaa
aaaaaaabbbbbcccccgciiccchcccjjjjccccchcccccdcaaaaaaaaaaaaaaa
aaaaaaaabbbbcccccgiiccccccccjjjjjcccchchcccdaaaaaaaaaaaaaaaa
aaaaaaaaabbbdccicgccccccckkccjjjjjccchhhcclcaaaaaaaaaaaaaaaa
aaaaaaaaaaabdcciiccicccccckkccjjjcccccccccllcaaaaaaaaaaaaaaa
aaaaaaaaaaaaddcciiciicccccckkcccccccccccccccllaaaaaaaaaaaaaa
aaaaaaaaaaaadddccicciccccccckkkcccccccccccccclcaaaaaaaaaaaaa
aaaaaaaaaaaadddcccccccccclcccckkccccccccceecccccaaaaaaaaaaaa
aaaaaaaaaaaadddcccccccccllccccckccccceeeeeccciiccaaaaaaaaaaa
aaaaaaaaaaaaaddccmcccccclccnccckkccceeccecccciiiicaaaaaaaaaa
aaaaaaaaaaaaacdcmmcccccllcccncccccccecceeccccciiiiabaaaaaaaa
aaaaaaaaaaaaaadcmccccclllcccnncccnnceceecccccciiiibbaaaaaaaa
aaaaaaaaaaaaaaacmccccclllcccnncnnccceeeeecccciiicbbaaaaaaaaa
aaaaaaaaaaaabaaammccccllccnncnnncccceecceccciicccbbaaaaaaaaa
aaaaaaaaaaaabbabbmcllllcncnaaaaacccceccceeecicaaabbaaaaaaaaa
aaaaaaaaaaaabbbbbbllcccnncaaaaaabbcccceeecaaaaaaabbaaaaaaaaa
aaaaaaaaaaaabbbbbbbccnnnaaaaaaaabbbbbbceaaaaaaaaabbaaaaaaaaa
aaaaaaaaaaaabbbbbbbbbaaaaaaaaaaaabbbbbaaaaaaaaaaabbaaaaaaaaa
aaaaaaaaaaaaaabbbbbbbaaaaaaaaaaaabbbbbbaaaaaaaaabbbaaaaaaaaa
aaaaaaaaaaaaaabbbbbbbaaaaaaaaaaaabbbbbbbaaaaaaabbbbaaaaaaaaa
aaaaaaaaaaaaaabbbbbbaaaccaaaaaaaaabbbbbbbaaaaabbbbbaaaaaaaaa
aaaaaaaaaaaaaabbbbbbaaccccaaaaaaaabbbbbbbaaabbbbbbbbaaaaaaaa
aaaaaaaaaaaaaaabbbbbaccccccaaaaaaaaabbbbbabbbbbbbbbbaaaaaaaa
aaaaaaaaaaaaaaaabbbbccoocccccaaccccaabbbbbbbbbbbbbbbbaaaaaaa
aaaaaaaaaaaaaaaaaabboooocciccccllccccbbbbbbbbbbbbbbbbaaaaaaa
aaaaaaaaaaaaaaaaaaaooooocciicccccllccbbbbbaabbbbbbbaaaaaaaaa
aaaaaaaaaaaaaaaaaaaccccccccicdccccccccbbbbaaaaabbbbaaaaaaaaa
aaaaaaaaaaaaaaaaaaaaaaaccccccdddccccccccccaaaaaaaaaaaaaaaaaa
aaaaaaaaaaaaaaaaaaaaaaaccccccdddccnnncccccaaaaaaaaaaaaaaaaaa
aaaaaaaaaaaaaaaaaaaaaaaccnccdccccccccnciccaaaaaaaaaaaaaaaaaa
aaaaaaaaaaaaaaaaaaaaaaaccnccccccclccccniicaaaaaaaaaaaaaaaaaa
aaaaaaaaaaaaaaaaaaaaaaacncccccccclllccccicaaaaaaaaaaaaaaaaaa
aaaaaaaaaaaaaaaaaaaaaaccccccdccacccccccciicccaaaaaaaaaaaaaaa
aaaaaaaaaaaaaaaaaaaaaaaaaaacccaaaacccclllccccaaaaaaaaaaaaaaa
aaaaaaaaaaaaaaaaaaaaaaaaaaaaaaaaaaaaaaaaaccccaaaaaaaaaaaaaaa
aaaaaaaaaaaaaaaaaaaaaaaaaaaaaaaaaaaaaaaaaaaaaaaaaaaaaaaaaaaa
aaaaaaaaaaaaaaaaaaaaaaaaaaaaaaaaaaaaaaaaaaaaaaaaaaaaaaaaaaaa
aaaaaaaaaaaaaaaaaaaaaaaaaaaaaaaaaaaaaaaaaaaaaaaaaaaaaaaaaaaa
aaaaaaaaaaaaaaaaaaaaaaaaaaaaaaaaaaaaaaaaaaaaaaaaaaaaaaaaaaaa
aaaaaaaaaaaaaaaaaaaaaaaaaaaaaaaaaaaaaaaaaaaaaaaaaaaaaaaaaaaa
"}
