"a" = (/turf/space,/area)
"b" = (/turf/simulated/wall/invulnerable/ice,/area/vault/icecomet)
"c" = (/obj/structure/snow_pedestal,/obj/item/clothing/head/celtic,/turf/simulated/floor/plating/snow/ice,/area/vault/icecomet)
"d" = (/turf/simulated/floor/plating/snow/ice,/area/vault/icecomet)
"e" = (/obj/machinery/door/mineral/transparent/icicle/horizontal,/turf/simulated/floor/plating/snow/ice,/area/vault/icecomet)
"f" = (/mob/living/simple_animal/hostile/decoy/snowman/frostgolem/wizard,/turf/simulated/floor/plating/snow,/area/vault/icecomet)
"g" = (/turf/simulated/floor/plating/snow,/area/vault/icecomet)
"h" = (/mob/living/simple_animal/hostile/decoy/snowman/frostgolem/knight,/turf/simulated/floor/plating/snow,/area/vault/icecomet)
"i" = (/mob/living/simple_animal/hostile/humanoid/frostgolem{wander = 0},/turf/simulated/floor/plating/snow/ice,/area/vault/icecomet)

(1,1,1) = {"
aaaaaaaaaabbbbbaaaaaaaaaa
aaaaaaaabbbbcbbbbaaaaaaaa
aaaaaaabbddbebddbbaaaaaaa
aaaaaabbfgdddddgfbbaaaaaa
aaaaaabhgggdddggghbaaaaaa
aaaaaabgggggdgggggbaaaaaa
aaaaaabhggggdgggghbaaaaaa
aaaaaabbgggdddgggbbaaaaaa
aaaaaaabggdddddggbaaaaaaa
aaaaaaabbdddddddbbaaaaaaa
aaaaaaabbbbbebbbbbaaaaaaa
aaaaaaaabbidddibbaaaaaaaa
aaaaaaaabbgdddgbbaaaaaaaa
aaaaaaaabbggdggbbaaaaaaaa
aaaaaaaaabggdggbaaaaaaaaa
aaaaaaaaabggdggbaaaaaaaaa
aaaaaaaaabggdggbaaaaaaaaa
aaaaaaaaabbgdgbbaaaaaaaaa
aaaaaaaaaabgdgbaaaaaaaaaa
aaaaaaaaaabgdgbaaaaaaaaaa
aaaaaaaaaabdddbaaaaaaaaaa
aaaaaaaaaabbdbbaaaaaaaaaa
aaaaaaaaaaabdbaaaaaaaaaaa
aaaaaaaaaaabdbaaaaaaaaaaa
aaaaaaaaaaabebaaaaaaaaaaa
"}
