//MAP CONVERTED BY dmm2tgm.py THIS HEADER COMMENT PREVENTS RECONVERSION, DO NOT REMOVE
"a" = (
/turf/space,
/area)
"b" = (
/turf/simulated/wall/invulnerable/ice,
/area/vault/icecomet)
"c" = (
/obj/structure/snow_pedestal{
	light_power = 5;
	light_range = 10
	},
/obj/item/clothing/head/celtic,
/turf/simulated/floor/plating/snow/ice,
/area/vault/icecomet)
"d" = (
/turf/simulated/floor/plating/snow/ice{
	light_power = 5;
	light_range = 10
	},
/area/vault/icecomet)
"e" = (
/turf/simulated/floor/plating/snow/ice,
/area/vault/icecomet)
"f" = (
/obj/machinery/door/mineral/transparent/icicle/horizontal,
/turf/simulated/floor/plating/snow/ice,
/area/vault/icecomet)
"g" = (
/mob/living/simple_animal/hostile/decoy/snowman/frostgolem/wizard,
/turf/simulated/floor/plating/snow,
/area/vault/icecomet)
"h" = (
/obj/structure/snow,
/obj/structure/snow,
/turf/simulated/floor/plating/snow,
/area/vault/icecomet)
"i" = (
/mob/living/simple_animal/hostile/decoy/snowman/frostgolem/knight,
/turf/simulated/floor/plating/snow,
/area/vault/icecomet)
"j" = (
/mob/living/simple_animal/hostile/humanoid/frostgolem{
	wander = 0
	},
/turf/simulated/floor/plating/snow/ice,
/area/vault/icecomet)

(1,1,1) = {"
a
a
a
a
a
a
a
a
a
a
a
a
a
a
a
a
a
a
a
a
a
a
a
a
a
"}
(2,1,1) = {"
a
a
a
a
a
a
a
a
a
a
a
a
a
a
a
a
a
a
a
a
a
a
a
a
a
"}
(3,1,1) = {"
a
a
a
a
a
a
a
a
a
a
a
a
a
a
a
a
a
a
a
a
a
a
a
a
a
"}
(4,1,1) = {"
a
a
a
a
a
a
a
a
a
a
a
a
a
a
a
a
a
a
a
a
a
a
a
a
a
"}
(5,1,1) = {"
a
a
a
a
a
a
a
a
a
a
a
a
a
a
a
a
a
a
a
a
a
a
a
a
a
"}
(6,1,1) = {"
a
a
a
a
a
a
a
a
a
a
a
a
a
a
a
a
a
a
a
a
a
a
a
a
a
"}
(7,1,1) = {"
a
a
a
b
b
b
b
b
a
a
a
a
a
a
a
a
a
a
a
a
a
a
a
a
a
"}
(8,1,1) = {"
a
a
b
b
i
h
i
b
b
b
b
a
a
a
a
a
a
a
a
a
a
a
a
a
a
"}
(9,1,1) = {"
a
b
b
g
h
h
h
h
h
b
b
b
b
b
a
a
a
a
a
a
a
a
a
a
a
"}
(10,1,1) = {"
a
b
d
h
h
h
h
h
h
e
b
b
b
b
b
b
b
b
a
a
a
a
a
a
a
"}
(11,1,1) = {"
b
b
e
e
h
h
h
h
e
e
b
j
h
h
h
h
h
b
b
b
b
b
a
a
a
"}
(12,1,1) = {"
b
b
b
e
e
h
h
e
e
e
b
e
e
h
h
h
h
h
h
h
e
b
b
b
b
"}
(13,1,1) = {"
b
c
f
e
e
e
e
e
e
e
f
e
e
e
e
e
e
e
e
e
e
e
e
e
f
"}
(14,1,1) = {"
b
b
b
e
e
h
h
e
e
e
b
e
e
h
h
h
h
h
h
h
e
b
b
b
b
"}
(15,1,1) = {"
b
b
e
e
h
h
h
h
e
e
b
j
h
h
h
h
h
b
b
b
b
b
a
a
a
"}
(16,1,1) = {"
a
b
d
h
h
h
h
h
h
e
b
b
b
b
b
b
b
b
a
a
a
a
a
a
a
"}
(17,1,1) = {"
a
b
b
g
h
h
h
h
h
b
b
b
b
b
a
a
a
a
a
a
a
a
a
a
a
"}
(18,1,1) = {"
a
a
b
b
i
h
i
b
b
b
b
a
a
a
a
a
a
a
a
a
a
a
a
a
a
"}
(19,1,1) = {"
a
a
a
b
b
b
b
b
a
a
a
a
a
a
a
a
a
a
a
a
a
a
a
a
a
"}
(20,1,1) = {"
a
a
a
a
a
a
a
a
a
a
a
a
a
a
a
a
a
a
a
a
a
a
a
a
a
"}
(21,1,1) = {"
a
a
a
a
a
a
a
a
a
a
a
a
a
a
a
a
a
a
a
a
a
a
a
a
a
"}
(22,1,1) = {"
a
a
a
a
a
a
a
a
a
a
a
a
a
a
a
a
a
a
a
a
a
a
a
a
a
"}
(23,1,1) = {"
a
a
a
a
a
a
a
a
a
a
a
a
a
a
a
a
a
a
a
a
a
a
a
a
a
"}
(24,1,1) = {"
a
a
a
a
a
a
a
a
a
a
a
a
a
a
a
a
a
a
a
a
a
a
a
a
a
"}
(25,1,1) = {"
a
a
a
a
a
a
a
a
a
a
a
a
a
a
a
a
a
a
a
a
a
a
a
a
a
"}
