"aa" = (/turf/space,/area)
"ab" = (/turf/simulated/wall/r_wall,/area/vault/ironchef)
"ac" = (/turf/simulated/wall/invulnerable,/area/vault/ironchef)
"ad" = (/obj/machinery/vending/hydronutrients,/turf/simulated/floor{icon_state = "showroomfloor"},/area/vault/ironchef)
"ae" = (/obj/machinery/vending/hydroseeds,/turf/simulated/floor{icon_state = "showroomfloor"},/area/vault/ironchef)
"af" = (/obj/machinery/vending/voxseeds,/obj/machinery/light{dir = 1},/turf/simulated/floor{icon_state = "showroomfloor"},/area/vault/ironchef)
"ag" = (/obj/structure/table/reinforced,/turf/simulated/floor{icon_state = "showroomfloor"},/area/vault/ironchef)
"ah" = (/obj/structure/closet/crate/hydroponics,/obj/item/weapon/reagent_containers/glass/bucket,/obj/item/weapon/minihoe,/obj/item/weapon/storage/bag/plants,/obj/item/weapon/wirecutters/clippers,/turf/simulated/floor{icon_state = "showroomfloor"},/area/vault/ironchef)
"ai" = (/obj/structure/table/reinforced,/obj/item/weapon/reagent_containers/food/condiment/honey{pixel_x = -9},/obj/item/weapon/reagent_containers/food/condiment/hotsauce{pixel_x = -3},/obj/item/weapon/reagent_containers/food/condiment/coldsauce{pixel_x = 3},/obj/item/weapon/reagent_containers/food/condiment/ketchup{pixel_x = 9},/turf/simulated/floor{icon_state = "showroomfloor"},/area/vault/ironchef)
"aj" = (/obj/structure/table/reinforced,/obj/item/weapon/reagent_containers/food/condiment/gravy/gravybig{pixel_x = -9},/obj/item/weapon/reagent_containers/food/condiment/cornoil{pixel_x = -3},/obj/item/weapon/reagent_containers/food/condiment/cinnamon{pixel_x = 3},/obj/item/weapon/reagent_containers/food/condiment/soysauce{pixel_x = 9},/turf/simulated/floor{icon_state = "showroomfloor"},/area/vault/ironchef)
"ak" = (/obj/structure/table/reinforced,/obj/item/weapon/reagent_containers/food/condiment/vinegar{pixel_x = -9},/obj/item/weapon/reagent_containers/food/drinks/ice,/obj/item/weapon/reagent_containers/food/drinks/discount_sauce{pixel_x = 9},/turf/simulated/floor{icon_state = "showroomfloor"},/area/vault/ironchef)
"al" = (/obj/structure/table/reinforced,/obj/item/weapon/reagent_containers/food/dipping_sauce/queso{pixel_y = 18},/obj/item/weapon/reagent_containers/food/dipping_sauce/salsa{pixel_y = 13},/obj/item/weapon/reagent_containers/food/dipping_sauce/hummus{pixel_y = 8},/obj/item/weapon/reagent_containers/food/dipping_sauce/guacamole,/turf/simulated/floor{icon_state = "showroomfloor"},/area/vault/ironchef)
"am" = (/obj/machinery/light{dir = 1},/turf/simulated/floor{icon_state = "showroomfloor"},/area/vault/ironchef)
"an" = (/obj/effect/decal/warning_stripes{dir = 4; icon_state = "warning"},/turf/simulated/floor{icon_state = "showroomfloor"},/area/vault/ironchef)
"ao" = (/turf/simulated/floor/grass,/area/vault/ironchef)
"ap" = (/obj/structure/sink/puddle,/obj/item/weapon/reagent_containers/glass/bucket,/turf/simulated/floor/grass,/area/vault/ironchef)
"aq" = (/obj/structure/largecrate/cow,/turf/simulated/floor/grass,/area/vault/ironchef)
"ar" = (/turf/simulated/floor{dir = 5; icon_state = "checker"},/area/vault/ironchef)
"as" = (/turf/simulated/floor{icon_state = "showroomfloor"},/area/vault/ironchef)
"at" = (/obj/machinery/portable_atmospherics/hydroponics,/turf/simulated/floor{icon_state = "showroomfloor"},/area/vault/ironchef)
"au" = (/obj/structure/largecrate/chick,/turf/simulated/floor/grass,/area/vault/ironchef)
"av" = (/obj/structure/table/woodentable,/obj/item/clothing/gloves/ironchefgauntlets,/obj/item/weapon/reagent_containers/glass/beaker/vial/flavor,/turf/simulated/floor{dir = 5; icon_state = "checker"},/area/vault/ironchef)
"aw" = (/obj/machinery/door/airlock/vault{icon_state = "door_locked"; locked = 1; req_access_txt = "53"},/turf/simulated/floor{icon_state = "showroomfloor"},/area/vault/ironchef)
"ax" = (/obj/machinery/bot/farmbot,/turf/simulated/floor{icon_state = "showroomfloor"},/area/vault/ironchef)
"ay" = (/obj/machinery/apiary,/obj/item/queen_bee,/obj/item/queen_bee/chill,/obj/item/weapon/reagent_containers/food/snacks/beezeez,/turf/simulated/floor{icon_state = "showroomfloor"},/area/vault/ironchef)
"az" = (/obj/structure/rack,/obj/item/weapon/fishtools/fish_egg_scoop,/obj/item/weapon/fishtools/fish_food,/obj/item/weapon/fishtools/fish_net,/obj/item/weapon/fishtools/fish_tank_brush,/obj/item/weapon/crowbar,/obj/effect/decal/warning_stripes{dir = 4; icon_state = "warning"},/obj/item/weapon/hatchet,/obj/item/weapon/extinguisher,/turf/simulated/floor/plating,/area/vault/ironchef)
"aA" = (/obj/structure/window/reinforced,/obj/machinery/egg_incubator,/turf/simulated/floor/grass,/area/vault/ironchef)
"aB" = (/obj/structure/window/reinforced,/turf/simulated/floor/grass,/area/vault/ironchef)
"aC" = (/obj/structure/window/reinforced,/obj/structure/largecrate/goat,/turf/simulated/floor/grass,/area/vault/ironchef)
"aD" = (/obj/structure/window/reinforced{dir = 1; name = "reinforced one-way window"; one_way = 1},/turf/simulated/floor{dir = 9; icon_state = "darkblue"},/area/vault/ironchef)
"aE" = (/obj/structure/window/reinforced{dir = 1; name = "reinforced one-way window"; one_way = 1},/turf/simulated/floor{tag = "icon-darkblue (NORTH)"; icon_state = "darkblue"; dir = 1},/area/vault/ironchef)
"aF" = (/obj/structure/window/reinforced{dir = 1; name = "reinforced one-way window"; one_way = 1},/turf/simulated/floor{dir = 5; icon_state = "darkblue"},/area/vault/ironchef)
"aG" = (/obj/machinery/biogenerator,/turf/simulated/floor{icon_state = "showroomfloor"},/area/vault/ironchef)
"aH" = (/obj/machinery/light,/turf/simulated/floor{icon_state = "showroomfloor"},/area/vault/ironchef)
"aI" = (/turf/simulated/floor{dir = 10; icon_state = "darkblue"},/area/vault/ironchef)
"aJ" = (/turf/simulated/floor{dir = 8; icon_state = "darkbluecorners"},/area/vault/ironchef)
"aK" = (/obj/machinery/fishtank/wall,/obj/item/fish_eggs/shrimp,/obj/item/fish_eggs/shrimp,/obj/item/fish_eggs/salmon,/obj/item/fish_eggs/salmon,/turf/simulated/floor{tag = "icon-vault (NORTH)"; icon_state = "vault"; dir = 1},/area/vault/ironchef)
"aL" = (/turf/simulated/floor{dir = 4; icon_state = "darkblue"},/area/vault/ironchef)
"aM" = (/turf/simulated/wall,/area/vault/ironchef)
"aN" = (/obj/machinery/smartfridge,/turf/simulated/floor{blocks_air = 0; icon_state = "dark"},/area/vault/ironchef)
"aO" = (/obj/machinery/door/airlock/glass{name = "Storage"},/turf/simulated/floor{icon_state = "showroomfloor"},/area/vault/ironchef)
"aP" = (/obj/structure/sink/kitchen,/turf/simulated/wall,/area/vault/ironchef)
"aQ" = (/turf/simulated/floor{dir = 2; icon_state = "darkblue"},/area/vault/ironchef)
"aR" = (/turf/simulated/floor{dir = 6; icon_state = "darkblue"},/area/vault/ironchef)
"aS" = (/obj/structure/rack,/obj/item/clothing/head/wizard,/obj/item/slime_extract/purple,/obj/item/slime_extract/purple,/obj/item/weapon/ectoplasm,/obj/item/weapon/ectoplasm,/obj/item/weapon/ectoplasm,/obj/item/clothing/mask/fakemoustache,/obj/item/slime_extract/grey,/obj/item/slime_extract/grey,/obj/item/stack/sheet/snow{amount = 5},/turf/simulated/floor/plating,/area/vault/ironchef)
"aT" = (/obj/structure/rack,/obj/item/stack/teeth/shark,/obj/item/weapon/reagent_containers/food/snacks/monkeycube,/obj/item/weapon/reagent_containers/food/snacks/meat/diona,/obj/item/weapon/reagent_containers/food/snacks/meat/hive,/obj/item/weapon/reagent_containers/food/snacks/meat/bearmeat,/obj/item/weapon/reagent_containers/food/snacks/meat/box,/obj/item/weapon/reagent_containers/food/snacks/meat/box,/obj/item/weapon/reagent_containers/food/snacks/meat/box,/obj/item/weapon/reagent_containers/food/snacks/meat/box,/obj/item/weapon/reagent_containers/food/snacks/meat/box/pig,/obj/item/weapon/reagent_containers/food/snacks/meat/box/pig,/turf/simulated/floor/plating,/area/vault/ironchef)
"aU" = (/obj/machinery/cooking,/turf/simulated/floor{blocks_air = 0; icon_state = "dark"},/area/vault/ironchef)
"aV" = (/obj/structure/closet/secure_closet/freezer/kitchen{req_access = null},/turf/simulated/floor{blocks_air = 0; icon_state = "dark"},/area/vault/ironchef)
"aW" = (/turf/simulated/floor{blocks_air = 0; icon_state = "dark"},/area/vault/ironchef)
"aX" = (/obj/structure/closet/secure_closet/freezer/fridge,/obj/item/weapon/reagent_containers/food/snacks/meat/carpmeat,/obj/item/weapon/reagent_containers/food/snacks/meat/crabmeat,/turf/simulated/floor{blocks_air = 0; icon_state = "dark"},/area/vault/ironchef)
"aY" = (/obj/structure/closet/secure_closet/freezer/fridge,/obj/item/weapon/reagent_containers/food/snacks/meat/spiderleg,/obj/item/weapon/reagent_containers/food/snacks/meat/spiderleg,/obj/item/weapon/reagent_containers/food/snacks/spidereggs,/obj/item/weapon/reagent_containers/food/snacks/spidereggs,/obj/item/weapon/reagent_containers/food/snacks/meat/roach,/turf/simulated/floor{blocks_air = 0; icon_state = "dark"},/area/vault/ironchef)
"aZ" = (/obj/structure/closet/secure_closet/freezer/fridge,/obj/item/weapon/reagent_containers/food/snacks/meat/xenomeat,/obj/item/weapon/reagent_containers/food/snacks/meat/xenomeat,/obj/item/weapon/reagent_containers/food/snacks/meat/xenomeat,/obj/item/weapon/reagent_containers/food/snacks/meat/xenomeat,/obj/item/weapon/reagent_containers/food/snacks/meat/xenomeat,/turf/simulated/floor{blocks_air = 0; icon_state = "dark"},/area/vault/ironchef)
"ba" = (/obj/structure/kitchenspike,/turf/simulated/floor{blocks_air = 0; icon_state = "dark"},/area/vault/ironchef)
"bb" = (/obj/structure/rack,/obj/item/robot_parts/head,/obj/item/weapon/handcuffs,/obj/item/weapon/paper,/obj/item/stack/rods,/obj/item/pipe,/obj/item/stack/sheet/mineral/plasma,/obj/item/toy/crayon/blue,/obj/item/toy/crayon/blue,/obj/item/toy/crayon/blue,/obj/item/stack/sheet/cardboard{amount = 10},/obj/item/weapon/aiModule/core/asimov,/obj/item/stack/sheet/metal,/obj/item/weapon/cell,/obj/item/stack/cable_coil/yellow,/obj/item/stack/ore/glass,/obj/item/stack/ore/glass,/turf/simulated/floor/plating,/area/vault/ironchef)
"bc" = (/turf/simulated/floor/plating,/area/vault/ironchef)
"bd" = (/obj/machinery/door/airlock/glass{name = "Special Ingredients"},/turf/simulated/floor/plating,/area/vault/ironchef)
"be" = (/obj/structure/disposalpipe/segment,/obj/machinery/atmospherics/pipe/simple/supply/hidden,/obj/structure/cable{d1 = 1; d2 = 4; icon_state = "1-4"},/turf/simulated/floor{blocks_air = 0; icon_state = "dark"},/area/vault/ironchef)
"bf" = (/obj/machinery/bot/cleanbot,/turf/simulated/floor{blocks_air = 0; icon_state = "dark"},/area/vault/ironchef)
"bg" = (/obj/structure/rack,/obj/item/clothing/suit/chef,/obj/item/clothing/under/rank/chef,/obj/item/clothing/head/chefhat,/turf/simulated/floor{icon_state = "showroomfloor"},/area/vault/ironchef)
"bh" = (/obj/structure/rack,/obj/item/weapon/reagent_containers/food/drinks/bottle/customizable/vodka,/obj/item/weapon/reagent_containers/food/snacks/pimiento,/obj/item/weapon/reagent_containers/food/snacks/grown/kudzupod,/obj/item/weapon/reagent_containers/food/snacks/bustanuts,/obj/item/weapon/reagent_containers/food/drinks/coloring,/obj/item/weapon/reagent_containers/glass/beaker/vial/uranium,/obj/item/weapon/reagent_containers/glass/beaker/vial/radium,/turf/simulated/floor/plating,/area/vault/ironchef)
"bi" = (/obj/structure/rack,/obj/item/organ/internal/brain,/obj/item/clothing/head/butt,/obj/item/organ/internal/appendix,/obj/item/organ/internal/heart,/turf/simulated/floor/plating,/area/vault/ironchef)
"bj" = (/obj/machinery/cooking/grill,/turf/simulated/floor{blocks_air = 0; icon_state = "dark"},/area/vault/ironchef)
"bk" = (/obj/machinery/atmospherics/pipe/simple/supply/hidden{dir = 4},/turf/simulated/floor{blocks_air = 0; icon_state = "dark"},/area/vault/ironchef)
"bl" = (/obj/structure/disposalpipe/segment{dir = 1; icon_state = "pipe-c"},/obj/machinery/atmospherics/pipe/manifold/supply/hidden,/turf/simulated/floor{blocks_air = 0; icon_state = "dark"},/area/vault/ironchef)
"bm" = (/obj/structure/disposalpipe/segment{dir = 4},/obj/machinery/atmospherics/pipe/simple/supply/hidden{dir = 10},/turf/simulated/floor{blocks_air = 0; icon_state = "dark"},/area/vault/ironchef)
"bn" = (/obj/structure/disposalpipe/segment{dir = 2; icon_state = "pipe-c"},/turf/simulated/floor{blocks_air = 0; icon_state = "dark"},/area/vault/ironchef)
"bo" = (/obj/machinery/door/airlock/mining{name = "Employees Only"},/turf/simulated/floor{icon_state = "showroomfloor"},/area/vault/ironchef)
"bp" = (/obj/machinery/light/small{dir = 4},/turf/simulated/floor{icon_state = "showroomfloor"},/area/vault/ironchef)
"bq" = (/obj/machinery/cooking/deepfryer,/obj/machinery/light{dir = 8},/turf/simulated/floor{blocks_air = 0; icon_state = "dark"},/area/vault/ironchef)
"br" = (/obj/effect/decal/warning_stripes{tag = "icon-warning (NORTHWEST)"; icon_state = "warning"; dir = 9},/turf/simulated/floor{blocks_air = 0; icon_state = "dark"},/area/vault/ironchef)
"bs" = (/obj/effect/decal/warning_stripes{tag = "icon-warning (NORTHEAST)"; icon_state = "warning"; dir = 5},/turf/simulated/floor{blocks_air = 0; icon_state = "dark"},/area/vault/ironchef)
"bt" = (/obj/structure/disposalpipe/segment,/obj/effect/decal/warning_stripes{tag = "icon-warning (NORTHWEST)"; icon_state = "warning"; dir = 9},/turf/simulated/floor{blocks_air = 0; icon_state = "dark"},/area/vault/ironchef)
"bu" = (/obj/machinery/processor,/obj/machinery/light{dir = 4},/turf/simulated/floor{blocks_air = 0; icon_state = "dark"},/area/vault/ironchef)
"bv" = (/mob/living/simple_animal/mouse/common,/turf/simulated/floor/plating,/area/vault/ironchef)
"bw" = (/obj/machinery/cooking/candy,/turf/simulated/floor{blocks_air = 0; icon_state = "dark"},/area/vault/ironchef)
"bx" = (/obj/item/weapon/reagent_containers/food/condiment/enzyme,/obj/item/weapon/reagent_containers/food/condiment/saltshaker{pixel_x = -3},/obj/item/weapon/reagent_containers/food/condiment/peppermill,/obj/structure/table/reinforced,/obj/item/weapon/reagent_containers/glass/beaker{pixel_x = 5},/obj/item/weapon/reagent_containers/dropper/baster,/turf/simulated/floor{blocks_air = 0; icon_state = "dark"},/area/vault/ironchef)
"by" = (/obj/item/weapon/kitchen/rollingpin,/obj/item/weapon/kitchen/utensil/knife/large/butch/meatcleaver,/obj/structure/table/reinforced,/turf/simulated/floor{blocks_air = 0; icon_state = "dark"},/area/vault/ironchef)
"bz" = (/obj/structure/table/reinforced,/obj/machinery/microwave{pixel_x = -3; pixel_y = 6},/turf/simulated/floor{blocks_air = 0; icon_state = "dark"},/area/vault/ironchef)
"bA" = (/obj/machinery/microwave{pixel_x = -3; pixel_y = 6},/obj/structure/table/reinforced,/turf/simulated/floor{blocks_air = 0; icon_state = "dark"},/area/vault/ironchef)
"bB" = (/obj/machinery/reagentgrinder,/obj/structure/table/reinforced,/turf/simulated/floor{blocks_air = 0; icon_state = "dark"},/area/vault/ironchef)
"bC" = (/obj/machinery/door/airlock/mining{name = "Employees Only"},/turf/simulated/floor/plating,/area/vault/ironchef)
"bD" = (/obj/machinery/atmospherics/pipe/simple/scrubbers/hidden{dir = 4},/obj/machinery/cooking/cerealmaker,/turf/simulated/floor{blocks_air = 0; icon_state = "dark"},/area/vault/ironchef)
"bE" = (/obj/machinery/atmospherics/pipe/simple/scrubbers/hidden,/obj/effect/decal/warning_stripes{icon_state = "1"},/turf/simulated/floor{blocks_air = 0; icon_state = "dark"},/area/vault/ironchef)
"bF" = (/obj/machinery/bot/chefbot,/turf/simulated/floor{blocks_air = 0; icon_state = "dark"},/area/vault/ironchef)
"bG" = (/obj/machinery/atmospherics/pipe/simple/supply/hidden,/turf/simulated/floor{blocks_air = 0; icon_state = "dark"},/area/vault/ironchef)
"bH" = (/obj/structure/disposalpipe/segment,/turf/simulated/floor{blocks_air = 0; icon_state = "dark"},/area/vault/ironchef)
"bI" = (/obj/effect/decal/warning_stripes{icon_state = "2"},/turf/simulated/floor{blocks_air = 0; icon_state = "dark"},/area/vault/ironchef)
"bJ" = (/obj/machinery/gibber,/turf/simulated/floor{blocks_air = 0; icon_state = "dark"},/area/vault/ironchef)
"bK" = (/obj/machinery/power/apc{dir = 8; pixel_x = -24},/turf/simulated/floor/plating,/area/vault/ironchef)
"bL" = (/obj/structure/window/full/reinforced,/turf/simulated/floor/plating,/area/vault/ironchef)
"bM" = (/obj/machinery/light{dir = 8},/turf/simulated/floor/plating,/area/vault/ironchef)
"bN" = (/obj/structure/table/woodentable,/obj/item/weapon/paper{info = "Guest List - Please Sign!<br>"; name = "Guest List"},/turf/simulated/floor/carpet,/area/vault/ironchef)
"bO" = (/obj/structure/table/woodentable,/obj/structure/table/woodentable,/obj/item/weapon/storage/photo_album,/turf/simulated/floor/carpet,/area/vault/ironchef)
"bP" = (/obj/structure/table/woodentable,/obj/item/device/camera/huge_photos,/turf/simulated/floor/carpet,/area/vault/ironchef)
"bQ" = (/obj/machinery/computer/security/telescreen/entertainment{pixel_y = 32},/turf/simulated/floor{dir = 5; icon_state = "checker"},/area/vault/ironchef)
"bR" = (/obj/structure/bed/chair/comfy/brown{dir = 1},/turf/simulated/floor{dir = 5; icon_state = "checker"},/area/vault/ironchef)
"bS" = (/obj/item/clothing/accessory/armband/cargo,/obj/item/clothing/gloves/brown/cargo,/obj/item/device/pda/cargo,/obj/structure/table,/turf/simulated/floor/plating,/area/vault/ironchef)
"bT" = (/obj/structure/table,/obj/machinery/cell_charger,/obj/item/weapon/disk/shuttle_coords/vault/ironchef,/turf/simulated/floor/plating,/area/vault/ironchef)
"bU" = (/obj/structure/window/reinforced,/turf/simulated/floor/plating,/area/vault/ironchef)
"bV" = (/obj/effect/decal/warning_stripes{tag = "icon-loading_area (NORTH)"; icon_state = "loading_area"; dir = 1},/turf/simulated/floor/plating,/area/vault/ironchef)
"bW" = (/obj/machinery/light/small{dir = 8},/turf/simulated/floor/carpet,/area/vault/ironchef)
"bX" = (/turf/simulated/floor/carpet{icon_state = "carpetsymbol"},/area/vault/ironchef)
"bY" = (/turf/simulated/floor/carpet,/area/vault/ironchef)
"bZ" = (/obj/machinery/door/airlock/glass{name = "Audience"},/turf/simulated/floor/carpet,/area/vault/ironchef)
"ca" = (/obj/structure/window/reinforced{dir = 4},/turf/simulated/floor/plating,/area/vault/ironchef)
"cb" = (/obj/effect/decal/warning_stripes{tag = "icon-warning (NORTHWEST)"; icon_state = "warning"; dir = 9},/turf/simulated/floor/plating,/area/vault/ironchef)
"cc" = (/obj/effect/decal/warning_stripes{tag = "icon-warning (NORTH)"; icon_state = "warning"; dir = 1},/turf/simulated/floor/plating,/area/vault/ironchef)
"cd" = (/obj/effect/decal/warning_stripes{icon_state = "unloading"},/obj/structure/plasticflaps/mining,/turf/simulated/floor/engine,/area/vault/ironchef)
"ce" = (/obj/machinery/light,/turf/simulated/floor{dir = 5; icon_state = "checker"},/area/vault/ironchef)
"cf" = (/obj/machinery/cart/cargo,/turf/simulated/floor/plating,/area/vault/ironchef)
"cg" = (/obj/structure/closet/crate/freezer,/turf/simulated/floor/plating,/area/vault/ironchef)
"ch" = (/obj/effect/decal/warning_stripes{tag = "icon-loading_area (EAST)"; icon_state = "loading_area"; dir = 4},/turf/simulated/floor/plating,/area/vault/ironchef)
"ci" = (/obj/effect/decal/warning_stripes{tag = "icon-warning (SOUTHWEST)"; icon_state = "warning"; dir = 10},/obj/spacepod/taxi{dir = 8},/turf/simulated/floor/plating,/area/vault/ironchef)
"cj" = (/obj/effect/decal/warning_stripes{tag = "icon-warning"; icon_state = "warning"},/turf/simulated/floor/plating,/area/vault/ironchef)
"ck" = (/obj/machinery/door/airlock/external,/obj/docking_port/destination/vault/ironchef{dir = 2},/turf/simulated/floor/carpet,/area/vault/ironchef)

(1,1,1) = {"
aaaaabababababababababababababababababababababaaaa
aaaaabacacacacadaeafagahaiajakalamanaoapaoaqabaaaa
aaaaabacararacasatatatasasasasasasanaoaoaoauabaaaa
aaaaabacavarawasaxayasasasasasasasazaAaBaBaCabaaaa
aaaaabacararacasatatatasasasasasasanaDaEaEaFabaaaa
aaaaabacacacacaGasaHasasasasasasaHanaIaJaKaLabaaaa
aaaaabababaMaMaMaMaMaNaOaOaPaMaMaMaMaMaIaQaRabaaaa
aaaaabaSaTaMaUaVaVaVaWaWaWaWaXaYaZbaaMaMaMaMabaaaa
aaaaabbbbcbdaWaWaWaWbeaWaWaWaWaWbfaWaMbgasasabaaaa
aaaaabbhbiaMbjaWbkbkblaWbmbnaWaWaWaWboasasbpabaaaa
aaaaabaMaMaMbqaWbraWbsaWaWbtaWbsbnbuaMbgasasabaaaa
aaaaabbvbvaMbwaWbxbybzaWaWbxbybAaWbBabababbCabaaaa
aaaaabbvbvaMbDaWaWbEaWbFbGbHbIaWbfbJabbKbcbcabaaaa
aaaaababababababbLbLbLbLbLbLbLbLabababbMbcbcabaaaa
aaaaaMbNbObPaMbQbRbRbRbRbRbRbRbRabbSbTbcbUbVabaaaa
aaaaaMbWbXbYbZarararararararararbCbcbccacbcccdaaaa
aaaaaMbYbYbYaMararcearararceararabcfcgchcicjcdaaaa
aaaaaMaMckaMaMaMaMaMaMaMaMaMaMaMabababababababaaaa
aaaaaaaaaaaaaaaaaaaaaaaaaaaaaaaaaaaaaaaaaaaaaaaaaa
aaaaaaaaaaaaaaaaaaaaaaaaaaaaaaaaaaaaaaaaaaaaaaaaaa
"}
