//MAP CONVERTED BY dmm2tgm.py THIS HEADER COMMENT PREVENTS RECONVERSION, DO NOT REMOVE
"aa" = (
/turf/space,
/area)
"ab" = (
/turf/simulated/wall/r_wall,
/area/vault/ironchef)
"ac" = (
/turf/simulated/wall/invulnerable,
/area/vault/ironchef)
"ad" = (
/obj/machinery/vending/hydronutrients,
/turf/simulated/floor{
	icon_state = "showroomfloor"
	},
/area/vault/ironchef)
"ae" = (
/obj/effect/decal/warning_stripes{
	dir = 4;
	icon_state = "warning"
	},
/obj/structure/table/reinforced,
/obj/machinery/reagentgrinder,
/turf/simulated/floor{
	icon_state = "showroomfloor"
	},
/area/vault/ironchef)
"af" = (
/obj/machinery/power/apc{
	dir = 8;
	pixel_x = -24
	},
/turf/simulated/floor{
	icon_state = "showroomfloor"
	},
/area/vault/ironchef)
"ag" = (
/obj/machinery/gibber,
/obj/machinery/light/he,
/turf/simulated/floor{
	icon_state = "dark"
	},
/area/vault/ironchef)
"ah" = (
/obj/structure/closet/crate/hydroponics,
/obj/item/weapon/reagent_containers/glass/bucket,
/obj/item/weapon/minihoe,
/obj/item/weapon/storage/bag/plants,
/obj/item/tool/wirecutters/clippers,
/turf/simulated/floor{
	icon_state = "showroomfloor"
	},
/area/vault/ironchef)
"ai" = (
/obj/machinery/cooking/deepfryer,
/turf/simulated/floor{
	icon_state = "dark"
	},
/area/vault/ironchef)
"aj" = (
/obj/structure/windoor_assembly/secure{
	dir = 2
	},
/obj/structure/windoor_assembly/secure,
/turf/simulated/floor{
	icon_state = "dark"
	},
/area/vault/ironchef)
"ak" = (
/obj/structure/closet/secure_closet/freezer/fridge,
/obj/item/weapon/reagent_containers/food/snacks/meat/carpmeat,
/obj/item/weapon/reagent_containers/food/snacks/meat/crabmeat,
/turf/simulated/floor{
	icon_state = "showroomfloor"
	},
/area/vault/ironchef)
"am" = (
/obj/structure/rack,
/obj/item/stack/teeth/shark,
/obj/item/weapon/reagent_containers/food/snacks/monkeycube,
/obj/item/weapon/reagent_containers/food/snacks/meat/diona,
/obj/item/weapon/reagent_containers/food/snacks/meat/hive,
/obj/item/weapon/reagent_containers/food/snacks/meat/bearmeat,
/obj/item/weapon/reagent_containers/food/snacks/meat/box,
/obj/item/weapon/reagent_containers/food/snacks/meat/box,
/obj/item/weapon/reagent_containers/food/snacks/meat/box,
/obj/item/weapon/reagent_containers/food/snacks/meat/box,
/obj/item/weapon/reagent_containers/food/snacks/meat/box/pig,
/obj/item/weapon/reagent_containers/food/snacks/meat/box/pig,
/turf/simulated/floor{
	icon_state = "showroomfloor"
	},
/area/vault/ironchef)
"an" = (
/obj/effect/decal/warning_stripes{
	dir = 4;
	icon_state = "warning"
	},
/turf/simulated/floor{
	icon_state = "showroomfloor"
	},
/area/vault/ironchef)
"ao" = (
/turf/simulated/floor/grass,
/area/vault/ironchef)
"ap" = (
/obj/structure/sink/puddle,
/obj/item/weapon/reagent_containers/glass/bucket,
/turf/simulated/floor/grass,
/area/vault/ironchef)
"aq" = (
/obj/structure/largecrate/cow,
/turf/simulated/floor/grass,
/area/vault/ironchef)
"ar" = (
/turf/simulated/floor{
	dir = 5;
	icon_state = "checker"
	},
/area/vault/ironchef)
"as" = (
/turf/simulated/floor{
	icon_state = "showroomfloor"
	},
/area/vault/ironchef)
"at" = (
/obj/machinery/portable_atmospherics/hydroponics,
/turf/simulated/floor{
	icon_state = "showroomfloor"
	},
/area/vault/ironchef)
"au" = (
/obj/structure/largecrate/chick,
/turf/simulated/floor/grass,
/area/vault/ironchef)
"av" = (
/obj/structure/rack,
/obj/item/organ/internal/brain,
/obj/item/clothing/head/butt,
/obj/item/organ/internal/appendix,
/obj/item/organ/internal/heart,
/turf/simulated/floor{
	icon_state = "showroomfloor"
	},
/area/vault/ironchef)
"aw" = (
/obj/machinery/door/airlock/vault{
	icon_state = "door_locked";
	locked = 1;
	req_access_txt = "53"
	},
/turf/simulated/floor{
	icon_state = "showroomfloor"
	},
/area/vault/ironchef)
"ax" = (
/obj/structure/table,
/obj/item/device/crank_charger,
/obj/item/weapon/cell,
/obj/item/clothing/accessory/stethoscope,
/turf/simulated/floor{
	icon_state = "showroomfloor"
	},
/area/vault/ironchef)
"ay" = (
/obj/machinery/vending/voxseeds,
/turf/simulated/floor{
	icon_state = "showroomfloor"
	},
/area/vault/ironchef)
"az" = (
/obj/item/clothing/accessory/armband/cargo,
/obj/item/clothing/gloves/brown/cargo,
/obj/item/device/pda/cargo,
/obj/structure/table,
/turf/simulated/floor{
	icon_state = "showroomfloor"
	},
/area/vault/ironchef)
"aB" = (
/obj/structure/sink/puddle,
/turf/simulated/floor/grass,
/area/vault/ironchef)
"aC" = (
/obj/structure/safe,
/turf/simulated/floor{
	dir = 5;
	icon_state = "checker"
	},
/area/vault/ironchef)
"aD" = (
/obj/structure/rack,
/obj/item/robot_parts/head,
/obj/item/weapon/handcuffs,
/obj/item/weapon/paper,
/obj/item/stack/rods,
/obj/item/pipe,
/obj/item/stack/sheet/mineral/plasma,
/obj/item/toy/crayon/blue,
/obj/item/toy/crayon/blue,
/obj/item/toy/crayon/blue,
/obj/item/stack/sheet/cardboard{
	amount = 10
	},
/obj/item/weapon/aiModule/core/asimov,
/obj/item/stack/sheet/metal,
/obj/item/stack/cable_coil/yellow,
/obj/item/stack/ore/glass,
/obj/item/stack/ore/glass,
/turf/simulated/floor{
	icon_state = "showroomfloor"
	},
/area/vault/ironchef)
"aE" = (
/mob/living/carbon/monkey,
/turf/simulated/floor/grass,
/area/vault/ironchef)
"aF" = (
/obj/machinery/chem_master/condimaster,
/turf/simulated/floor{
	icon_state = "showroomfloor"
	},
/area/vault/ironchef)
"aG" = (
/obj/machinery/biogenerator,
/turf/simulated/floor{
	icon_state = "showroomfloor"
	},
/area/vault/ironchef)
"aH" = (
/obj/machinery/chem_dispenser,
/turf/simulated/floor{
	icon_state = "showroomfloor"
	},
/area/vault/ironchef)
"aI" = (
/obj/machinery/egg_incubator,
/turf/simulated/floor/grass,
/area/vault/ironchef)
"aJ" = (
/obj/machinery/cooking/grill,
/obj/machinery/light/he{
	dir = 8
	},
/obj/machinery/camera{
	name = "Iron Chef 1"
	},
/turf/simulated/floor{
	icon_state = "dark"
	},
/area/vault/ironchef)
"aK" = (
/obj/machinery/fishtank/wall,
/obj/item/fish_eggs/shrimp,
/obj/item/fish_eggs/shrimp,
/obj/item/fish_eggs/salmon,
/obj/item/fish_eggs/salmon,
/turf/simulated/floor{
	icon_state = "dark"
	},
/area/vault/ironchef)
"aL" = (
/obj/structure/largecrate/goat,
/turf/simulated/floor/grass,
/area/vault/ironchef)
"aM" = (
/turf/simulated/wall,
/area/vault/ironchef)
"aO" = (
/obj/machinery/door/airlock/glass{
	name = "Storage"
	},
/turf/simulated/floor{
	icon_state = "dark"
	},
/area/vault/ironchef)
"aP" = (
/obj/structure/sink/kitchen,
/turf/simulated/wall,
/area/vault/ironchef)
"aQ" = (
/obj/structure/reagent_dispensers/corn_oil_tank,
/turf/simulated/floor{
	icon_state = "showroomfloor"
	},
/area/vault/ironchef)
"aS" = (
/obj/machinery/light/he{
	dir = 1
	},
/turf/simulated/floor{
	icon_state = "showroomfloor"
	},
/area/vault/ironchef)
"aT" = (
/obj/structure/table/reinforced,
/obj/item/weapon/reagent_containers/food/drinks/shaker,
/obj/machinery/chem_dispenser/soda_dispenser/mapping,
/turf/simulated/floor{
	icon_state = "showroomfloor"
	},
/area/vault/ironchef)
"aU" = (
/obj/structure/kitchenspike,
/turf/simulated/floor/grass,
/area/vault/ironchef)
"aV" = (
/obj/structure/closet/secure_closet/freezer/kitchen{
	req_access = null
	},
/turf/simulated/floor{
	icon_state = "dark"
	},
/area/vault/ironchef)
"aW" = (
/turf/simulated/floor{
	icon_state = "dark"
	},
/area/vault/ironchef)
"aX" = (
/obj/item/weapon/reagent_containers/food/snacks/beezeez,
/obj/item/queen_bee/chill,
/obj/item/queen_bee,
/turf/simulated/floor/grass,
/area/vault/ironchef)
"aY" = (
/obj/machinery/light/he,
/turf/simulated/floor{
	dir = 5;
	icon_state = "checker"
	},
/area/vault/ironchef)
"aZ" = (
/obj/machinery/computer/security/telescreen/entertainment{
	pixel_x = 32
	},
/obj/structure/bed/chair/comfy/brown{
	dir = 1
	},
/turf/simulated/floor{
	dir = 5;
	icon_state = "checker"
	},
/area/vault/ironchef)
"ba" = (
/obj/machinery/cooking,
/obj/machinery/light/he{
	dir = 4
	},
/obj/machinery/camera{
	name = "Iron Chef 2"
	},
/turf/simulated/floor{
	icon_state = "dark"
	},
/area/vault/ironchef)
"bb" = (
/obj/machinery/vending/meat,
/turf/simulated/floor{
	icon_state = "showroomfloor"
	},
/area/vault/ironchef)
"bc" = (
/turf/simulated/floor/plating,
/area/vault/ironchef)
"bd" = (
/obj/machinery/door/airlock/glass{
	name = "Special Ingredients"
	},
/turf/simulated/floor/plating,
/area/vault/ironchef)
"bf" = (
/obj/machinery/bot/cleanbot{
	auto_patrol = 0
	},
/turf/simulated/floor{
	icon_state = "dark"
	},
/area/vault/ironchef)
"bg" = (
/obj/machinery/vending/zamsnax,
/turf/simulated/floor{
	icon_state = "showroomfloor"
	},
/area/vault/ironchef)
"bh" = (
/obj/machinery/light/he,
/obj/machinery/bot/farmbot,
/turf/simulated/floor{
	icon_state = "showroomfloor"
	},
/area/vault/ironchef)
"bi" = (
/obj/effect/decal/warning_stripes{
	icon_state = "1"
	},
/turf/simulated/floor{
	icon_state = "dark"
	},
/area/vault/ironchef)
"bj" = (
/obj/structure/closet/secure_closet/freezer/fridge,
/obj/item/weapon/reagent_containers/food/snacks/meat/spiderleg,
/obj/item/weapon/reagent_containers/food/snacks/meat/spiderleg,
/obj/item/weapon/reagent_containers/food/snacks/spidereggs,
/obj/item/weapon/reagent_containers/food/snacks/spidereggs,
/obj/item/weapon/reagent_containers/food/snacks/meat/roach,
/obj/effect/decal/warning_stripes{
	dir = 4;
	icon_state = "warning"
	},
/turf/simulated/floor{
	icon_state = "showroomfloor"
	},
/area/vault/ironchef)
"bk" = (
/obj/structure/table/reinforced,
/obj/machinery/chem_dispenser/booze_dispenser/mapping,
/turf/simulated/floor{
	icon_state = "showroomfloor"
	},
/area/vault/ironchef)
"bl" = (
/obj/structure/closet/crate/freezer,
/turf/simulated/floor{
	icon_state = "showroomfloor"
	},
/area/vault/ironchef)
"bm" = (
/obj/structure/rack,
/obj/item/clothing/head/wizard,
/obj/item/slime_extract/purple,
/obj/item/slime_extract/purple,
/obj/item/weapon/ectoplasm,
/obj/item/weapon/ectoplasm,
/obj/item/weapon/ectoplasm,
/obj/item/clothing/mask/fakemoustache,
/obj/item/slime_extract/grey,
/obj/item/slime_extract/grey,
/obj/item/stack/sheet/snow{
	amount = 5
	},
/turf/simulated/floor{
	icon_state = "showroomfloor"
	},
/area/vault/ironchef)
"bn" = (
/obj/structure/rack,
/obj/item/weapon/fishtools/fish_egg_scoop,
/obj/item/weapon/fishtools/fish_food,
/obj/item/weapon/fishtools/fish_net,
/obj/item/weapon/fishtools/fish_tank_brush,
/obj/item/tool/crowbar,
/obj/item/weapon/hatchet,
/obj/item/weapon/extinguisher,
/turf/simulated/floor/grass,
/area/vault/ironchef)
"bo" = (
/obj/structure/table/woodentable,
/obj/item/clothing/gloves/ironchefgauntlets,
/obj/item/weapon/reagent_containers/glass/beaker/vial/flavor,
/obj/machinery/light/small{
	dir = 8
	},
/turf/simulated/floor{
	dir = 5;
	icon_state = "checker"
	},
/area/vault/ironchef)
"bp" = (
/obj/machinery/light/small{
	dir = 4
	},
/turf/simulated/floor{
	icon_state = "showroomfloor"
	},
/area/vault/ironchef)
"br" = (
/obj/machinery/processor,
/turf/simulated/floor{
	icon_state = "dark"
	},
/area/vault/ironchef)
"bs" = (
/obj/structure/table/reinforced,
/obj/item/clothing/head/chefhat,
/obj/item/clothing/under/rank/chef,
/obj/item/clothing/suit/chef,
/turf/simulated/floor{
	icon_state = "dark"
	},
/area/vault/ironchef)
"bt" = (
/obj/machinery/door/airlock/glass{
	name = "Audience"
	},
/turf/simulated/floor{
	icon_state = "showroomfloor"
	},
/area/vault/ironchef)
"bu" = (
/obj/machinery/vending/dinnerware,
/turf/simulated/floor{
	icon_state = "showroomfloor"
	},
/area/vault/ironchef)
"bv" = (
/obj/machinery/cooking/cerealmaker,
/obj/machinery/light/he,
/turf/simulated/floor{
	icon_state = "dark"
	},
/area/vault/ironchef)
"bw" = (
/obj/machinery/cooking/candy,
/turf/simulated/floor{
	icon_state = "dark"
	},
/area/vault/ironchef)
"bx" = (
/obj/item/weapon/reagent_containers/food/condiment/enzyme,
/obj/item/weapon/reagent_containers/food/condiment/saltshaker{
	pixel_x = -3
	},
/obj/item/weapon/reagent_containers/food/condiment/peppermill,
/obj/structure/table/reinforced,
/obj/item/weapon/reagent_containers/glass/beaker{
	pixel_x = 5
	},
/obj/item/weapon/reagent_containers/dropper/baster,
/turf/simulated/floor{
	icon_state = "dark"
	},
/area/vault/ironchef)
"by" = (
/obj/item/weapon/kitchen/rollingpin,
/obj/item/weapon/kitchen/utensil/knife/large/butch/meatcleaver,
/obj/structure/table/reinforced,
/turf/simulated/floor{
	icon_state = "dark"
	},
/area/vault/ironchef)
"bz" = (
/obj/structure/table/reinforced,
/obj/machinery/microwave{
	pixel_x = -3;
	pixel_y = 6
	},
/turf/simulated/floor{
	icon_state = "dark"
	},
/area/vault/ironchef)
"bA" = (
/obj/machinery/microwave{
	pixel_x = -3;
	pixel_y = 6
	},
/obj/structure/table/reinforced,
/turf/simulated/floor{
	icon_state = "dark"
	},
/area/vault/ironchef)
"bB" = (
/obj/machinery/reagentgrinder,
/obj/structure/table/reinforced,
/turf/simulated/floor{
	icon_state = "dark"
	},
/area/vault/ironchef)
"bC" = (
/obj/structure/window/full/reinforced,
/turf/simulated/floor{
	icon_state = "dark"
	},
/area/vault/ironchef)
"bD" = (
/obj/structure/window/reinforced,
/obj/structure/table/reinforced,
/obj/item/trash/plate/clean/stack,
/turf/simulated/floor{
	icon_state = "dark"
	},
/area/vault/ironchef)
"bE" = (
/obj/structure/table/reinforced,
/obj/structure/window/reinforced,
/turf/simulated/floor{
	icon_state = "dark"
	},
/area/vault/ironchef)
"bF" = (
/obj/machinery/bot/chefbot,
/turf/simulated/floor{
	icon_state = "dark"
	},
/area/vault/ironchef)
"bG" = (
/obj/structure/table/reinforced,
/obj/structure/window/reinforced,
/obj/structure/window/reinforced{
	dir = 8
	},
/turf/simulated/floor{
	icon_state = "dark"
	},
/area/vault/ironchef)
"bH" = (
/obj/structure/closet/secure_closet/freezer/fridge,
/obj/item/weapon/reagent_containers/food/snacks/meat/xenomeat,
/obj/item/weapon/reagent_containers/food/snacks/meat/xenomeat,
/obj/item/weapon/reagent_containers/food/snacks/meat/xenomeat,
/obj/item/weapon/reagent_containers/food/snacks/meat/xenomeat,
/obj/item/weapon/reagent_containers/food/snacks/meat/xenomeat,
/obj/machinery/light/he{
	dir = 1
	},
/turf/simulated/floor{
	icon_state = "showroomfloor"
	},
/area/vault/ironchef)
"bI" = (
/obj/effect/decal/warning_stripes{
	icon_state = "2"
	},
/turf/simulated/floor{
	icon_state = "dark"
	},
/area/vault/ironchef)
"bJ" = (
/obj/structure/rack,
/obj/item/weapon/reagent_containers/food/drinks/bottle/customizable/vodka,
/obj/item/weapon/reagent_containers/food/snacks/pimiento,
/obj/item/weapon/reagent_containers/food/snacks/grown/kudzupod,
/obj/item/weapon/reagent_containers/food/snacks/bustanuts,
/obj/item/weapon/reagent_containers/food/drinks/coloring,
/obj/item/weapon/reagent_containers/glass/beaker/vial/uranium,
/obj/item/weapon/reagent_containers/glass/beaker/vial/radium,
/obj/item/weapon/cell/high{
	charge = 100;
	maxcharge = 15000
	},
/turf/simulated/floor{
	icon_state = "showroomfloor"
	},
/area/vault/ironchef)
"bK" = (
/obj/structure/table/reinforced,
/obj/structure/window/reinforced,
/obj/structure/window/reinforced{
	dir = 4
	},
/turf/simulated/floor{
	icon_state = "dark"
	},
/area/vault/ironchef)
"bL" = (
/obj/structure/window/full/reinforced,
/turf/simulated/floor/plating,
/area/vault/ironchef)
"bM" = (
/obj/machinery/light{
	dir = 8
	},
/turf/simulated/floor/plating,
/area/vault/ironchef)
"bN" = (
/obj/structure/table/woodentable,
/obj/item/weapon/paper{
	info = "Guest List - Please Sign!<br>";
	name = "Guest List"
	},
/turf/simulated/floor/carpet,
/area/vault/ironchef)
"bO" = (
/obj/structure/table/woodentable,
/obj/structure/table/woodentable,
/obj/item/weapon/storage/photo_album,
/turf/simulated/floor/carpet,
/area/vault/ironchef)
"bP" = (
/obj/structure/table/woodentable,
/obj/item/device/camera,
/turf/simulated/floor/carpet,
/area/vault/ironchef)
"bQ" = (
/obj/structure/table/reinforced,
/obj/machinery/chem_dispenser/brewer/mapping,
/turf/simulated/floor{
	icon_state = "showroomfloor"
	},
/area/vault/ironchef)
"bR" = (
/obj/structure/bed/chair/comfy/brown{
	dir = 1
	},
/turf/simulated/floor{
	dir = 5;
	icon_state = "checker"
	},
/area/vault/ironchef)
"bS" = (
/obj/machinery/door/airlock/glass{
	name = "Audience"
	},
/turf/simulated/floor/plating,
/area/vault/ironchef)
"bT" = (
/obj/machinery/computer/security/telescreen/entertainment{
	pixel_x = -32
	},
/obj/structure/bed/chair/comfy/brown{
	dir = 1
	},
/turf/simulated/floor{
	dir = 5;
	icon_state = "checker"
	},
/area/vault/ironchef)
"bV" = (
/obj/machinery/chem_master,
/turf/simulated/floor{
	icon_state = "showroomfloor"
	},
/area/vault/ironchef)
"bW" = (
/obj/machinery/light/small{
	dir = 8
	},
/turf/simulated/floor/carpet,
/area/vault/ironchef)
"bX" = (
/turf/simulated/floor/carpet{
	icon_state = "carpetsymbol"
	},
/area/vault/ironchef)
"bY" = (
/turf/simulated/floor/carpet,
/area/vault/ironchef)
"bZ" = (
/obj/machinery/door/airlock/glass{
	name = "Audience"
	},
/turf/simulated/floor/carpet,
/area/vault/ironchef)
"ca" = (
/obj/machinery/apiary,
/turf/simulated/floor/grass,
/area/vault/ironchef)
"cb" = (
/obj/effect/decal/warning_stripes{
	dir = 9;
	icon_state = "warning";
	tag = "icon-warning (NORTHWEST)"
	},
/turf/simulated/floor/plating,
/area/vault/ironchef)
"cc" = (
/obj/effect/decal/warning_stripes{
	dir = 1;
	icon_state = "warning";
	tag = "icon-warning (NORTH)"
	},
/turf/simulated/floor/plating,
/area/vault/ironchef)
"cd" = (
/obj/effect/decal/warning_stripes{
	icon_state = "unloading"
	},
/obj/structure/plasticflaps/mining,
/turf/simulated/floor/engine,
/area/vault/ironchef)
"ce" = (
/obj/machinery/cart/cargo,
/turf/simulated/floor{
	icon_state = "showroomfloor"
	},
/area/vault/ironchef)
"cf" = (
/obj/machinery/vending/hydroseeds,
/obj/machinery/light/he{
	dir = 1
	},
/turf/simulated/floor{
	icon_state = "showroomfloor"
	},
/area/vault/ironchef)
"cg" = (
/obj/structure/reagent_dispensers/sacid,
/turf/simulated/floor{
	icon_state = "showroomfloor"
	},
/area/vault/ironchef)
"ch" = (
/obj/structure/table,
/obj/machinery/cell_charger,
/obj/item/weapon/disk/shuttle_coords/vault/ironchef,
/turf/simulated/floor{
	icon_state = "showroomfloor"
	},
/area/vault/ironchef)
"ci" = (
/obj/effect/decal/warning_stripes{
	dir = 10;
	icon_state = "warning";
	tag = "icon-warning (SOUTHWEST)"
	},
/obj/spacepod/taxi{
	dir = 8
	},
/turf/simulated/floor/plating,
/area/vault/ironchef)
"cj" = (
/obj/effect/decal/warning_stripes{
	icon_state = "warning";
	tag = "icon-warning"
	},
/turf/simulated/floor/plating,
/area/vault/ironchef)
"ck" = (
/obj/machinery/door/airlock/external,
/obj/docking_port/destination/vault/ironchef{
	dir = 2
	},
/turf/simulated/floor/carpet,
/area/vault/ironchef)
"dt" = (
/obj/structure/grille/window_spawner/reinforced,
/turf/simulated/floor/plating,
/area/vault/ironchef)
"jl" = (
/obj/machinery/vending/wallmed2{
	pixel_x = 30
	},
/turf/simulated/floor{
	icon_state = "showroomfloor"
	},
/area/vault/ironchef)
"vi" = (
/obj/structure/closet/crate/hydroponics,
/obj/item/weapon/reagent_containers/glass/bucket,
/obj/item/weapon/minihoe,
/obj/item/weapon/storage/bag/plants,
/obj/item/tool/wirecutters/clippers,
/obj/item/weapon/fishtools/fish_egg_scoop,
/obj/item/weapon/fishtools/fish_food,
/obj/item/weapon/fishtools/fish_net,
/obj/item/weapon/fishtools/fishtank_helper,
/turf/simulated/floor{
	icon_state = "showroomfloor"
	},
/area/vault/ironchef)
"Rr" = (
/obj/machinery/smartfridge/condiments,
/turf/simulated/floor{
	icon_state = "dark"
	},
/area/vault/ironchef)

(1,1,1) = {"
aa
aa
aa
aa
aa
aa
aa
aa
aa
aa
aa
aa
aa
aa
aa
aa
aa
aa
aa
aa
"}
(2,1,1) = {"
aa
ab
ab
ab
ab
ab
ab
ab
ab
ab
ab
ab
ab
ab
ab
ab
aa
aa
aa
aa
"}
(3,1,1) = {"
aa
ab
ac
ac
ac
ac
aM
aD
bJ
av
am
bm
aM
bN
bW
ab
aa
aa
aa
aa
"}
(4,1,1) = {"
aa
ab
ac
bo
aC
ac
aM
aS
as
as
as
as
aM
bO
bX
ck
aa
aa
aa
aa
"}
(5,1,1) = {"
aa
ab
ac
ar
ar
ac
aM
aM
bd
bL
bL
bL
aM
bP
bY
ab
aa
aa
aa
aa
"}
(6,1,1) = {"
aa
ab
ac
aw
ac
ac
aM
aJ
aW
ai
bw
bv
aM
aM
bZ
ab
aa
aa
aa
aa
"}
(7,1,1) = {"
aa
ab
ad
as
as
aG
bC
aV
aW
aW
aW
aW
bD
bT
ar
dt
aa
aa
aa
aa
"}
(8,1,1) = {"
aa
ab
cf
at
at
aQ
bC
aV
aW
aW
bz
aW
bE
bR
ar
dt
aa
aa
aa
aa
"}
(9,1,1) = {"
aa
ab
ay
at
at
cg
bC
aW
aW
aW
bx
bi
bE
bR
ar
dt
aa
aa
aa
aa
"}
(10,1,1) = {"
aa
ab
bQ
at
at
ah
Rr
aW
aW
aW
by
aW
bE
bR
ar
dt
aa
aa
aa
aa
"}
(11,1,1) = {"
aa
ab
bk
as
as
as
aO
aW
aW
aW
bs
aW
bK
bR
ar
dt
aa
aa
aa
aa
"}
(12,1,1) = {"
aa
ab
aT
as
as
bh
aP
aW
aW
aW
aW
aW
aj
ar
aY
ab
aa
aa
aa
aa
"}
(13,1,1) = {"
aa
ab
bb
as
as
as
aO
bF
aW
aW
bs
aW
bG
bR
ar
dt
aa
aa
aa
aa
"}
(14,1,1) = {"
aa
ab
bu
at
at
vi
aK
aW
aW
aW
by
aW
bE
bR
ar
dt
aa
aa
aa
aa
"}
(15,1,1) = {"
aa
ab
bg
at
at
aF
bC
aW
aW
aW
bx
bI
bE
bR
ar
dt
aa
aa
aa
aa
"}
(16,1,1) = {"
aa
ab
ak
at
at
bV
bC
aV
aW
aW
bA
aW
bE
bR
ar
dt
aa
aa
aa
aa
"}
(17,1,1) = {"
aa
ab
bH
as
as
aH
bC
aV
aW
aW
aW
bf
bD
aZ
ar
dt
aa
aa
aa
aa
"}
(18,1,1) = {"
aa
ab
bj
an
an
ae
bC
ba
aW
br
bB
ag
aM
aM
bS
ab
aa
aa
aa
aa
"}
(19,1,1) = {"
aa
ab
aU
ao
ao
aI
aM
aM
bt
aM
aM
aM
aM
bM
bc
ab
aa
aa
aa
aa
"}
(20,1,1) = {"
aa
ab
aX
aB
aE
au
aM
az
as
af
as
bS
bc
bc
bc
ab
aa
aa
aa
aa
"}
(21,1,1) = {"
aa
ab
ca
ao
ap
aq
aM
ch
as
as
ce
aM
bc
cb
ci
ab
aa
aa
aa
aa
"}
(22,1,1) = {"
aa
ab
bn
aE
ao
aL
aM
ax
bp
jl
bl
aM
bc
cc
cj
ab
aa
aa
aa
aa
"}
(23,1,1) = {"
aa
ab
ab
ab
ab
ab
ab
ab
ab
ab
ab
ab
ab
cd
cd
ab
aa
aa
aa
aa
"}
(24,1,1) = {"
aa
aa
aa
aa
aa
aa
aa
aa
aa
aa
aa
aa
aa
aa
aa
aa
aa
aa
aa
aa
"}
(25,1,1) = {"
aa
aa
aa
aa
aa
aa
aa
aa
aa
aa
aa
aa
aa
aa
aa
aa
aa
aa
aa
aa
"}
