//MAP CONVERTED BY dmm2tgm.py THIS HEADER COMMENT PREVENTS RECONVERSION, DO NOT REMOVE
"aa" = (
/turf/space,
/area)
"ab" = (
/turf/simulated/wall/r_wall,
/area/vault/ironchef)
"ac" = (
/turf/simulated/wall/invulnerable,
/area/vault/ironchef)
"ad" = (
/obj/machinery/vending/hydronutrients,
/turf/simulated/floor{
	icon_state = "showroomfloor"
	},
/area/vault/ironchef)
"ae" = (
/obj/item/clothing/accessory/armband/cargo,
/obj/item/clothing/gloves/brown/cargo,
/obj/item/device/pda/cargo,
/obj/structure/table,
/turf/simulated/floor{
	icon_state = "showroomfloor"
	},
/area/vault/ironchef)
"af" = (
/obj/structure/kitchenspike,
/turf/simulated/floor/grass,
/area/vault/ironchef)
"ag" = (
/obj/structure/table/reinforced,
/obj/item/weapon/reagent_containers/food/condiment/gravy/gravybig{
	pixel_x = -9
	},
/obj/item/weapon/reagent_containers/food/condiment/cornoil{
	pixel_x = -3
	},
/obj/item/weapon/reagent_containers/food/condiment/cinnamon{
	pixel_x = 3
	},
/obj/item/weapon/reagent_containers/food/condiment/soysauce{
	pixel_x = 9
	},
/turf/simulated/floor{
	blocks_air = 0;
	icon_state = "dark"
	},
/area/vault/ironchef)
"ah" = (
/obj/structure/closet/crate/hydroponics,
/obj/item/weapon/reagent_containers/glass/bucket,
/obj/item/weapon/minihoe,
/obj/item/weapon/storage/bag/plants,
/obj/item/tool/wirecutters/clippers,
/turf/simulated/floor{
	icon_state = "showroomfloor"
	},
/area/vault/ironchef)
"ai" = (
/obj/machinery/vending/voxseeds,
/turf/simulated/floor{
	icon_state = "showroomfloor"
	},
/area/vault/ironchef)
"aj" = (
/obj/structure/table/woodentable,
/obj/item/clothing/gloves/ironchefgauntlets,
/obj/item/weapon/reagent_containers/glass/beaker/vial/flavor,
/obj/machinery/light/small{
	dir = 8
	},
/turf/simulated/floor{
	dir = 5;
	icon_state = "checker"
	},
/area/vault/ironchef)
"ak" = (
/obj/structure/rack,
/obj/item/clothing/head/wizard,
/obj/item/slime_extract/purple,
/obj/item/slime_extract/purple,
/obj/item/weapon/ectoplasm,
/obj/item/weapon/ectoplasm,
/obj/item/weapon/ectoplasm,
/obj/item/clothing/mask/fakemoustache,
/obj/item/slime_extract/grey,
/obj/item/slime_extract/grey,
/obj/item/stack/sheet/snow{
	amount = 5
	},
/turf/simulated/floor{
	icon_state = "showroomfloor"
	},
/area/vault/ironchef)
"al" = (
/obj/structure/table/reinforced,
/obj/item/weapon/reagent_containers/food/drinks/shaker,
/obj/machinery/chem_dispenser/soda_dispenser/mapping,
/turf/simulated/floor{
	icon_state = "showroomfloor"
	},
/area/vault/ironchef)
"am" = (
/obj/machinery/power/apc{
	dir = 8;
	pixel_x = -24
	},
/obj/structure/closet/crate/freezer,
/turf/simulated/floor/plating,
/area/vault/ironchef)
"an" = (
/obj/effect/decal/warning_stripes{
	dir = 4;
	icon_state = "warning"
	},
/turf/simulated/floor{
	icon_state = "showroomfloor"
	},
/area/vault/ironchef)
"ao" = (
/turf/simulated/floor/grass,
/area/vault/ironchef)
"ap" = (
/obj/structure/sink/puddle,
/obj/item/weapon/reagent_containers/glass/bucket,
/turf/simulated/floor/grass,
/area/vault/ironchef)
"aq" = (
/obj/structure/largecrate/cow,
/turf/simulated/floor/grass,
/area/vault/ironchef)
"ar" = (
/turf/simulated/floor{
	dir = 5;
	icon_state = "checker"
	},
/area/vault/ironchef)
"as" = (
/turf/simulated/floor{
	icon_state = "showroomfloor"
	},
/area/vault/ironchef)
"at" = (
/obj/machinery/portable_atmospherics/hydroponics,
/turf/simulated/floor{
	icon_state = "showroomfloor"
	},
/area/vault/ironchef)
"au" = (
/obj/structure/largecrate/chick,
/turf/simulated/floor/grass,
/area/vault/ironchef)
"av" = (
/obj/structure/rack,
/obj/item/weapon/fishtools/fish_egg_scoop,
/obj/item/weapon/fishtools/fish_food,
/obj/item/weapon/fishtools/fish_net,
/obj/item/weapon/fishtools/fish_tank_brush,
/obj/item/tool/crowbar,
/obj/item/weapon/hatchet,
/obj/item/weapon/extinguisher,
/turf/simulated/floor/grass,
/area/vault/ironchef)
"aw" = (
/obj/machinery/door/airlock/vault{
	icon_state = "door_locked";
	locked = 1;
	req_access_txt = "53"
	},
/turf/simulated/floor{
	icon_state = "showroomfloor"
	},
/area/vault/ironchef)
"ax" = (
/obj/machinery/gibber,
/obj/machinery/light/he,
/turf/simulated/floor{
	blocks_air = 0;
	icon_state = "dark"
	},
/area/vault/ironchef)
"ay" = (
/obj/structure/table/reinforced,
/obj/item/weapon/reagent_containers/food/condiment/vinegar{
	pixel_x = -9
	},
/obj/item/weapon/reagent_containers/food/drinks/ice,
/obj/item/weapon/reagent_containers/food/drinks/discount_sauce{
	pixel_x = 9
	},
/turf/simulated/floor{
	blocks_air = 0;
	icon_state = "dark"
	},
/area/vault/ironchef)
"az" = (
/obj/machinery/computer/security/telescreen/entertainment{
	pixel_x = -32
	},
/obj/structure/bed/chair/comfy/brown{
	dir = 1
	},
/turf/simulated/floor{
	dir = 5;
	icon_state = "checker"
	},
/area/vault/ironchef)
"aA" = (
/obj/machinery/vending/meat,
/turf/simulated/floor{
	icon_state = "showroomfloor"
	},
/area/vault/ironchef)
"aB" = (
/obj/structure/sink/puddle,
/turf/simulated/floor/grass,
/area/vault/ironchef)
"aC" = (
/mob/living/carbon/monkey,
/turf/simulated/floor/grass,
/area/vault/ironchef)
"aD" = (
/obj/machinery/vending/zamsnax,
/turf/simulated/floor{
	icon_state = "showroomfloor"
	},
/area/vault/ironchef)
"aE" = (
/obj/machinery/door/airlock/glass{
	name = "Audience"
	},
/turf/simulated/floor{
	icon_state = "showroomfloor"
	},
/area/vault/ironchef)
"aF" = (
/obj/structure/table,
/obj/machinery/cell_charger,
/obj/item/weapon/disk/shuttle_coords/vault/ironchef,
/turf/simulated/floor{
	icon_state = "showroomfloor"
	},
/area/vault/ironchef)
"aG" = (
/obj/machinery/biogenerator,
/turf/simulated/floor{
	icon_state = "showroomfloor"
	},
/area/vault/ironchef)
"aH" = (
/obj/machinery/chem_dispenser,
/turf/simulated/floor{
	icon_state = "showroomfloor"
	},
/area/vault/ironchef)
"aI" = (
/obj/machinery/egg_incubator,
/turf/simulated/floor/grass,
/area/vault/ironchef)
"aJ" = (
/obj/structure/table/reinforced,
/obj/structure/window/reinforced,
/obj/structure/window/reinforced{
	dir = 4
	},
/turf/simulated/floor{
	blocks_air = 0;
	icon_state = "dark"
	},
/area/vault/ironchef)
"aK" = (
/obj/machinery/fishtank/wall,
/obj/item/fish_eggs/shrimp,
/obj/item/fish_eggs/shrimp,
/obj/item/fish_eggs/salmon,
/obj/item/fish_eggs/salmon,
/turf/simulated/floor{
	dir = 1;
	icon_state = "vault";
	tag = "icon-vault (NORTH)"
	},
/area/vault/ironchef)
"aL" = (
/obj/structure/largecrate/goat,
/turf/simulated/floor/grass,
/area/vault/ironchef)
"aM" = (
/turf/simulated/wall,
/area/vault/ironchef)
"aN" = (
/obj/machinery/smartfridge,
/turf/simulated/floor{
	blocks_air = 0;
	icon_state = "dark"
	},
/area/vault/ironchef)
"aO" = (
/obj/machinery/door/airlock/glass{
	name = "Storage"
	},
/turf/simulated/floor{
	icon_state = "showroomfloor"
	},
/area/vault/ironchef)
"aP" = (
/obj/structure/sink/kitchen,
/turf/simulated/wall,
/area/vault/ironchef)
"aQ" = (
/obj/machinery/light/he,
/turf/simulated/floor{
	dir = 5;
	icon_state = "checker"
	},
/area/vault/ironchef)
"aR" = (
/obj/structure/rack,
/obj/item/organ/internal/brain,
/obj/item/clothing/head/butt,
/obj/item/organ/internal/appendix,
/obj/item/organ/internal/heart,
/turf/simulated/floor{
	icon_state = "showroomfloor"
	},
/area/vault/ironchef)
"aS" = (
/obj/machinery/light/he{
	dir = 1
	},
/turf/simulated/floor{
	icon_state = "showroomfloor"
	},
/area/vault/ironchef)
"aT" = (
/obj/machinery/vending/dinnerware,
/turf/simulated/floor{
	icon_state = "showroomfloor"
	},
/area/vault/ironchef)
"aU" = (
/obj/machinery/cooking/deepfryer,
/turf/simulated/floor{
	blocks_air = 0;
	icon_state = "dark"
	},
/area/vault/ironchef)
"aV" = (
/obj/structure/closet/secure_closet/freezer/kitchen{
	req_access = null
	},
/turf/simulated/floor{
	blocks_air = 0;
	icon_state = "dark"
	},
/area/vault/ironchef)
"aW" = (
/turf/simulated/floor{
	blocks_air = 0;
	icon_state = "dark"
	},
/area/vault/ironchef)
"aX" = (
/obj/structure/reagent_dispensers/sacid,
/turf/simulated/floor{
	icon_state = "showroomfloor"
	},
/area/vault/ironchef)
"aY" = (
/obj/structure/rack,
/obj/item/robot_parts/head,
/obj/item/weapon/handcuffs,
/obj/item/weapon/paper,
/obj/item/stack/rods,
/obj/item/pipe,
/obj/item/stack/sheet/mineral/plasma,
/obj/item/toy/crayon/blue,
/obj/item/toy/crayon/blue,
/obj/item/toy/crayon/blue,
/obj/item/stack/sheet/cardboard{
	amount = 10
	},
/obj/item/weapon/aiModule/core/asimov,
/obj/item/stack/sheet/metal,
/obj/item/weapon/cell,
/obj/item/stack/cable_coil/yellow,
/obj/item/stack/ore/glass,
/obj/item/stack/ore/glass,
/turf/simulated/floor{
	icon_state = "showroomfloor"
	},
/area/vault/ironchef)
"ba" = (
/obj/machinery/cooking,
/obj/machinery/light/he{
	dir = 4
	},
/obj/machinery/camera{
	name = "Iron Chef 2"
	},
/turf/simulated/floor{
	blocks_air = 0;
	icon_state = "dark"
	},
/area/vault/ironchef)
"bb" = (
/obj/machinery/cooking/cerealmaker,
/obj/machinery/light/he,
/turf/simulated/floor{
	blocks_air = 0;
	icon_state = "dark"
	},
/area/vault/ironchef)
"bc" = (
/turf/simulated/floor/plating,
/area/vault/ironchef)
"bd" = (
/obj/machinery/door/airlock/glass{
	name = "Special Ingredients"
	},
/turf/simulated/floor/plating,
/area/vault/ironchef)
"be" = (
/obj/structure/table/reinforced,
/obj/item/weapon/reagent_containers/food/condiment/honey{
	pixel_x = -9
	},
/obj/item/weapon/reagent_containers/food/condiment/hotsauce{
	pixel_x = -3
	},
/obj/item/weapon/reagent_containers/food/condiment/coldsauce{
	pixel_x = 3
	},
/obj/item/weapon/reagent_containers/food/condiment/ketchup{
	pixel_x = 9
	},
/turf/simulated/floor{
	blocks_air = 0;
	icon_state = "dark"
	},
/area/vault/ironchef)
"bf" = (
/obj/machinery/bot/cleanbot{
	auto_patrol = 0
	},
/turf/simulated/floor{
	blocks_air = 0;
	icon_state = "dark"
	},
/area/vault/ironchef)
"bg" = (
/obj/machinery/vending/hydroseeds,
/obj/machinery/light/he{
	dir = 1
	},
/turf/simulated/floor{
	icon_state = "showroomfloor"
	},
/area/vault/ironchef)
"bh" = (
/obj/structure/closet/secure_closet/freezer/fridge,
/obj/item/weapon/reagent_containers/food/snacks/meat/carpmeat,
/obj/item/weapon/reagent_containers/food/snacks/meat/crabmeat,
/turf/simulated/floor{
	icon_state = "showroomfloor"
	},
/area/vault/ironchef)
"bi" = (
/obj/machinery/light/he,
/obj/machinery/bot/farmbot,
/turf/simulated/floor{
	icon_state = "showroomfloor"
	},
/area/vault/ironchef)
"bj" = (
/obj/machinery/computer/security/telescreen/entertainment{
	pixel_x = 32
	},
/obj/structure/bed/chair/comfy/brown{
	dir = 1
	},
/turf/simulated/floor{
	dir = 5;
	icon_state = "checker"
	},
/area/vault/ironchef)
"bk" = (
/obj/machinery/chem_master,
/turf/simulated/floor{
	icon_state = "showroomfloor"
	},
/area/vault/ironchef)
"bm" = (
/obj/structure/safe,
/turf/simulated/floor{
	dir = 5;
	icon_state = "checker"
	},
/area/vault/ironchef)
"bn" = (
/obj/structure/rack,
/obj/item/weapon/reagent_containers/food/drinks/bottle/customizable/vodka,
/obj/item/weapon/reagent_containers/food/snacks/pimiento,
/obj/item/weapon/reagent_containers/food/snacks/grown/kudzupod,
/obj/item/weapon/reagent_containers/food/snacks/bustanuts,
/obj/item/weapon/reagent_containers/food/drinks/coloring,
/obj/item/weapon/reagent_containers/glass/beaker/vial/uranium,
/obj/item/weapon/reagent_containers/glass/beaker/vial/radium,
/obj/item/weapon/cell/high{
	charge = 100;
	maxcharge = 15000
	},
/turf/simulated/floor{
	icon_state = "showroomfloor"
	},
/area/vault/ironchef)
"bo" = (
/obj/structure/table/reinforced,
/obj/machinery/chem_dispenser/booze_dispenser/mapping,
/turf/simulated/floor{
	icon_state = "showroomfloor"
	},
/area/vault/ironchef)
"bp" = (
/obj/machinery/light/small{
	dir = 4
	},
/turf/simulated/floor{
	icon_state = "showroomfloor"
	},
/area/vault/ironchef)
"br" = (
/obj/machinery/apiary,
/turf/simulated/floor/grass,
/area/vault/ironchef)
"bs" = (
/obj/structure/table/reinforced,
/obj/item/clothing/head/chefhat,
/obj/item/clothing/under/rank/chef,
/obj/item/clothing/suit/chef,
/turf/simulated/floor{
	blocks_air = 0;
	icon_state = "dark"
	},
/area/vault/ironchef)
"bt" = (
/obj/item/weapon/reagent_containers/food/snacks/beezeez,
/obj/item/queen_bee/chill,
/obj/item/queen_bee,
/turf/simulated/floor/grass,
/area/vault/ironchef)
"bu" = (
/obj/machinery/cooking/grill,
/obj/machinery/light/he{
	dir = 8
	},
/obj/machinery/camera{
	name = "Iron Chef 1"
	},
/turf/simulated/floor{
	blocks_air = 0;
	icon_state = "dark"
	},
/area/vault/ironchef)
"bv" = (
/obj/structure/closet/secure_closet/freezer/fridge,
/obj/item/weapon/reagent_containers/food/snacks/meat/spiderleg,
/obj/item/weapon/reagent_containers/food/snacks/meat/spiderleg,
/obj/item/weapon/reagent_containers/food/snacks/spidereggs,
/obj/item/weapon/reagent_containers/food/snacks/spidereggs,
/obj/item/weapon/reagent_containers/food/snacks/meat/roach,
/obj/effect/decal/warning_stripes{
	dir = 4;
	icon_state = "warning"
	},
/turf/simulated/floor{
	icon_state = "showroomfloor"
	},
/area/vault/ironchef)
"bw" = (
/obj/machinery/cooking/candy,
/turf/simulated/floor{
	blocks_air = 0;
	icon_state = "dark"
	},
/area/vault/ironchef)
"bx" = (
/obj/item/weapon/reagent_containers/food/condiment/enzyme,
/obj/item/weapon/reagent_containers/food/condiment/saltshaker{
	pixel_x = -3
	},
/obj/item/weapon/reagent_containers/food/condiment/peppermill,
/obj/structure/table/reinforced,
/obj/item/weapon/reagent_containers/glass/beaker{
	pixel_x = 5
	},
/obj/item/weapon/reagent_containers/dropper/baster,
/turf/simulated/floor{
	blocks_air = 0;
	icon_state = "dark"
	},
/area/vault/ironchef)
"by" = (
/obj/item/weapon/kitchen/rollingpin,
/obj/item/weapon/kitchen/utensil/knife/large/butch/meatcleaver,
/obj/structure/table/reinforced,
/turf/simulated/floor{
	blocks_air = 0;
	icon_state = "dark"
	},
/area/vault/ironchef)
"bz" = (
/obj/structure/table/reinforced,
/obj/machinery/microwave{
	pixel_x = -3;
	pixel_y = 6
	},
/turf/simulated/floor{
	blocks_air = 0;
	icon_state = "dark"
	},
/area/vault/ironchef)
"bA" = (
/obj/machinery/microwave{
	pixel_x = -3;
	pixel_y = 6
	},
/obj/structure/table/reinforced,
/turf/simulated/floor{
	blocks_air = 0;
	icon_state = "dark"
	},
/area/vault/ironchef)
"bB" = (
/obj/machinery/reagentgrinder,
/obj/structure/table/reinforced,
/turf/simulated/floor{
	blocks_air = 0;
	icon_state = "dark"
	},
/area/vault/ironchef)
"bC" = (
/obj/structure/table/reinforced,
/obj/machinery/chem_dispenser/brewer/mapping,
/turf/simulated/floor{
	icon_state = "showroomfloor"
	},
/area/vault/ironchef)
"bD" = (
/obj/structure/window/reinforced,
/obj/structure/table/reinforced,
/turf/simulated/floor{
	blocks_air = 0;
	icon_state = "dark"
	},
/area/vault/ironchef)
"bE" = (
/obj/structure/table/reinforced,
/obj/structure/window/reinforced,
/turf/simulated/floor{
	blocks_air = 0;
	icon_state = "dark"
	},
/area/vault/ironchef)
"bF" = (
/obj/machinery/bot/chefbot,
/turf/simulated/floor{
	blocks_air = 0;
	icon_state = "dark"
	},
/area/vault/ironchef)
"bG" = (
/obj/structure/table/reinforced,
/obj/structure/window/reinforced,
/obj/structure/window/reinforced{
	dir = 8
	},
/turf/simulated/floor{
	blocks_air = 0;
	icon_state = "dark"
	},
/area/vault/ironchef)
"bH" = (
/obj/structure/reagent_dispensers/corn_oil_tank,
/turf/simulated/floor{
	icon_state = "showroomfloor"
	},
/area/vault/ironchef)
"bI" = (
/obj/effect/decal/warning_stripes{
	icon_state = "2"
	},
/turf/simulated/floor{
	blocks_air = 0;
	icon_state = "dark"
	},
/area/vault/ironchef)
"bJ" = (
/obj/machinery/processor,
/turf/simulated/floor{
	blocks_air = 0;
	icon_state = "dark"
	},
/area/vault/ironchef)
"bK" = (
/obj/effect/decal/warning_stripes{
	icon_state = "1"
	},
/turf/simulated/floor{
	blocks_air = 0;
	icon_state = "dark"
	},
/area/vault/ironchef)
"bL" = (
/obj/structure/window/full/reinforced,
/turf/simulated/floor/plating,
/area/vault/ironchef)
"bM" = (
/obj/machinery/light{
	dir = 8
	},
/turf/simulated/floor/plating,
/area/vault/ironchef)
"bN" = (
/obj/structure/table/woodentable,
/obj/item/weapon/paper{
	info = "Guest List - Please Sign!<br>";
	name = "Guest List"
	},
/turf/simulated/floor/carpet,
/area/vault/ironchef)
"bO" = (
/obj/structure/table/woodentable,
/obj/structure/table/woodentable,
/obj/item/weapon/storage/photo_album,
/turf/simulated/floor/carpet,
/area/vault/ironchef)
"bP" = (
/obj/structure/table/woodentable,
/obj/item/device/camera,
/turf/simulated/floor/carpet,
/area/vault/ironchef)
"bR" = (
/obj/structure/bed/chair/comfy/brown{
	dir = 1
	},
/turf/simulated/floor{
	dir = 5;
	icon_state = "checker"
	},
/area/vault/ironchef)
"bS" = (
/obj/machinery/door/airlock/glass{
	name = "Audience"
	},
/turf/simulated/floor/plating,
/area/vault/ironchef)
"bT" = (
/obj/structure/closet/secure_closet/freezer/fridge,
/obj/item/weapon/reagent_containers/food/snacks/meat/xenomeat,
/obj/item/weapon/reagent_containers/food/snacks/meat/xenomeat,
/obj/item/weapon/reagent_containers/food/snacks/meat/xenomeat,
/obj/item/weapon/reagent_containers/food/snacks/meat/xenomeat,
/obj/item/weapon/reagent_containers/food/snacks/meat/xenomeat,
/obj/machinery/light/he{
	dir = 1
	},
/turf/simulated/floor{
	icon_state = "showroomfloor"
	},
/area/vault/ironchef)
"bU" = (
/obj/structure/rack,
/obj/item/stack/teeth/shark,
/obj/item/weapon/reagent_containers/food/snacks/monkeycube,
/obj/item/weapon/reagent_containers/food/snacks/meat/diona,
/obj/item/weapon/reagent_containers/food/snacks/meat/hive,
/obj/item/weapon/reagent_containers/food/snacks/meat/bearmeat,
/obj/item/weapon/reagent_containers/food/snacks/meat/box,
/obj/item/weapon/reagent_containers/food/snacks/meat/box,
/obj/item/weapon/reagent_containers/food/snacks/meat/box,
/obj/item/weapon/reagent_containers/food/snacks/meat/box,
/obj/item/weapon/reagent_containers/food/snacks/meat/box/pig,
/obj/item/weapon/reagent_containers/food/snacks/meat/box/pig,
/turf/simulated/floor{
	icon_state = "showroomfloor"
	},
/area/vault/ironchef)
"bV" = (
/obj/structure/table/reinforced,
/obj/item/weapon/reagent_containers/food/dipping_sauce/queso{
	pixel_y = 18
	},
/obj/item/weapon/reagent_containers/food/dipping_sauce/salsa{
	pixel_y = 13
	},
/obj/item/weapon/reagent_containers/food/dipping_sauce/hummus{
	pixel_y = 8
	},
/obj/item/weapon/reagent_containers/food/dipping_sauce/guacamole,
/turf/simulated/floor{
	blocks_air = 0;
	icon_state = "dark"
	},
/area/vault/ironchef)
"bW" = (
/obj/machinery/light/small{
	dir = 8
	},
/turf/simulated/floor/carpet,
/area/vault/ironchef)
"bX" = (
/turf/simulated/floor/carpet{
	icon_state = "carpetsymbol"
	},
/area/vault/ironchef)
"bY" = (
/turf/simulated/floor/carpet,
/area/vault/ironchef)
"bZ" = (
/obj/machinery/door/airlock/glass{
	name = "Audience"
	},
/turf/simulated/floor/carpet,
/area/vault/ironchef)
"ca" = (
/obj/structure/windoor_assembly/secure{
	dir = 2
	},
/obj/structure/windoor_assembly/secure,
/turf/simulated/floor{
	blocks_air = 0;
	icon_state = "dark"
	},
/area/vault/ironchef)
"cb" = (
/obj/effect/decal/warning_stripes{
	dir = 9;
	icon_state = "warning";
	tag = "icon-warning (NORTHWEST)"
	},
/turf/simulated/floor/plating,
/area/vault/ironchef)
"cc" = (
/obj/effect/decal/warning_stripes{
	dir = 1;
	icon_state = "warning";
	tag = "icon-warning (NORTH)"
	},
/turf/simulated/floor/plating,
/area/vault/ironchef)
"cd" = (
/obj/effect/decal/warning_stripes{
	icon_state = "unloading"
	},
/obj/structure/plasticflaps/mining,
/turf/simulated/floor/engine,
/area/vault/ironchef)
"ce" = (
/obj/machinery/chem_master/condimaster,
/turf/simulated/floor{
	icon_state = "showroomfloor"
	},
/area/vault/ironchef)
"cf" = (
/obj/machinery/cart/cargo,
/turf/simulated/floor/plating,
/area/vault/ironchef)
"cg" = (
/obj/effect/decal/warning_stripes{
	dir = 4;
	icon_state = "warning"
	},
/obj/structure/table/reinforced,
/obj/machinery/reagentgrinder,
/turf/simulated/floor{
	icon_state = "showroomfloor"
	},
/area/vault/ironchef)
"ci" = (
/obj/effect/decal/warning_stripes{
	dir = 10;
	icon_state = "warning";
	tag = "icon-warning (SOUTHWEST)"
	},
/obj/spacepod/taxi{
	dir = 8
	},
/turf/simulated/floor/plating,
/area/vault/ironchef)
"cj" = (
/obj/effect/decal/warning_stripes{
	icon_state = "warning";
	tag = "icon-warning"
	},
/turf/simulated/floor/plating,
/area/vault/ironchef)
"ck" = (
/obj/machinery/door/airlock/external,
/obj/docking_port/destination/vault/ironchef{
	dir = 2
	},
/turf/simulated/floor/carpet,
/area/vault/ironchef)

(1,1,1) = {"
aa
aa
aa
aa
aa
aa
aa
aa
aa
aa
aa
aa
aa
aa
aa
aa
aa
aa
aa
aa
"}
(2,1,1) = {"
aa
ab
ab
ab
ab
ab
ab
ab
ab
ab
ab
ab
ab
ab
ab
ab
aa
aa
aa
aa
"}
(3,1,1) = {"
aa
ab
ac
ac
ac
ac
aM
aY
bn
aR
bU
ak
aM
bN
bW
ab
aa
aa
aa
aa
"}
(4,1,1) = {"
aa
ab
ac
aj
bm
ac
aM
aS
as
as
as
as
aM
bO
bX
ck
aa
aa
aa
aa
"}
(5,1,1) = {"
aa
ab
ac
ar
ar
ac
aM
aM
bd
bL
bL
bL
aM
bP
bY
ab
aa
aa
aa
aa
"}
(6,1,1) = {"
aa
ab
ac
aw
ac
ac
aM
bu
aW
aU
bw
bb
aM
aM
bZ
ab
aa
aa
aa
aa
"}
(7,1,1) = {"
aa
ab
ad
as
as
aG
bL
aV
aW
aW
aW
aW
bD
az
ar
ab
aa
aa
aa
aa
"}
(8,1,1) = {"
aa
ab
bg
at
at
bH
bL
aV
aW
aW
bz
aW
bE
bR
ar
ab
aa
aa
aa
aa
"}
(9,1,1) = {"
aa
ab
ai
at
at
aX
bL
aW
aW
aW
bx
bK
bE
bR
ar
ab
aa
aa
aa
aa
"}
(10,1,1) = {"
aa
ab
bC
at
at
ah
aN
aW
be
aW
by
aW
bE
bR
ar
ab
aa
aa
aa
aa
"}
(11,1,1) = {"
aa
ab
bo
as
as
as
aO
aW
be
aW
bs
aW
aJ
bR
ar
ab
aa
aa
aa
aa
"}
(12,1,1) = {"
aa
ab
al
as
as
bi
aP
aW
ag
aW
aW
aW
ca
ar
aQ
ab
aa
aa
aa
aa
"}
(13,1,1) = {"
aa
ab
aA
as
as
as
aO
bF
ay
aW
bs
aW
bG
bR
ar
ab
aa
aa
aa
aa
"}
(14,1,1) = {"
aa
ab
aT
at
at
ah
bL
aW
bV
aW
by
aW
bE
bR
ar
ab
aa
aa
aa
aa
"}
(15,1,1) = {"
aa
ab
aD
at
at
ce
bL
aW
aW
aW
bx
bI
bE
bR
ar
ab
aa
aa
aa
aa
"}
(16,1,1) = {"
aa
ab
bh
at
at
bk
bL
aV
aW
aW
bA
aW
bE
bR
ar
ab
aa
aa
aa
aa
"}
(17,1,1) = {"
aa
ab
bT
as
as
aH
bL
aV
aW
aW
aW
bf
bD
bj
ar
ab
aa
aa
aa
aa
"}
(18,1,1) = {"
aa
ab
bv
an
an
cg
bL
ba
aW
bJ
bB
ax
aM
aM
bS
ab
aa
aa
aa
aa
"}
(19,1,1) = {"
aa
ab
af
ao
ao
aI
aK
bL
aE
aM
aM
aM
aM
bc
bc
ab
aa
aa
aa
aa
"}
(20,1,1) = {"
aa
ab
bt
aB
aC
ao
ao
bL
as
ae
aM
am
bM
bc
bc
ab
aa
aa
aa
aa
"}
(21,1,1) = {"
aa
ab
br
ao
ap
ao
aq
bL
as
aF
aM
cf
bc
cb
ci
ab
aa
aa
aa
aa
"}
(22,1,1) = {"
aa
ab
av
aC
ao
aL
au
bL
bp
as
bS
bc
bc
cc
cj
ab
aa
aa
aa
aa
"}
(23,1,1) = {"
aa
ab
ab
ab
ab
ab
ab
ab
ab
ab
ab
ab
ab
cd
cd
ab
aa
aa
aa
aa
"}
(24,1,1) = {"
aa
aa
aa
aa
aa
aa
aa
aa
aa
aa
aa
aa
aa
aa
aa
aa
aa
aa
aa
aa
"}
(25,1,1) = {"
aa
aa
aa
aa
aa
aa
aa
aa
aa
aa
aa
aa
aa
aa
aa
aa
aa
aa
aa
aa
"}
