//MAP CONVERTED BY dmm2tgm.py THIS HEADER COMMENT PREVENTS RECONVERSION, DO NOT REMOVE
"a" = (
/turf/simulated/wall/invulnerable/r_wall,
/area/vault/keycard)
"h" = (
/turf/portal,
/area/vault/keycard)
"m" = (
/obj/machinery/door/airlock/highsecurity/keycard,
/turf/simulated/floor/plating,
/area/vault/keycard)
"M" = (
/turf/simulated/floor/plating,
/area/vault/keycard)

(1,1,1) = {"
a
a
a
a
"}
(2,1,1) = {"
a
h
M
m
"}
(3,1,1) = {"
a
h
a
a
"}
(4,1,1) = {"
a
a
a
a
"}
