"a" = (/turf/simulated/wall/invulnerable/r_wall,/area)
"b" = (/turf/simulated/floor/carpet,/area)
"c" = (/obj/structure/bed,/turf/simulated/floor/carpet,/area)
"d" = (/turf/simulated/wall,/area)
"e" = (/turf/simulated/floor,/area)
"f" = (/turf/simulated/floor{icon_state = "whitegreen"},/area)
"g" = (/turf/simulated/floor{icon_state = "cafeteria"; dir = 5},/area)
"h" = (/obj/structure/table/reinforced,/turf/simulated/floor{icon_state = "cafeteria"; dir = 5},/area)
"i" = (/turf/simulated/floor/wood,/area)
"j" = (/turf/simulated/floor/plating,/area)
"k" = (/obj/structure/disposalpipe/segment{dir = 4},/obj/structure/cable{d1 = 4; d2 = 8; icon_state = "4-8"},/turf/simulated/floor{icon_state = "dark"},/area)
"l" = (/obj/machinery/door/mineral/wood,/turf/simulated/floor/carpet,/area)
"m" = (/turf/simulated/floor{icon_state = "dark"},/area)
"n" = (/turf/simulated/floor{icon_state = "whitehall"},/area)
"o" = (/obj/structure/window/barricade,/turf/simulated/floor{icon_state = "whitehall"},/area)
"p" = (/turf/simulated/wall/mineral/uranium,/area)
"q" = (/obj/structure/window/reinforced,/obj/structure/window/reinforced{dir = 4},/obj/structure/window/reinforced{dir = 8},/obj/structure/window/reinforced{dir = 1},/obj/structure/grille,/obj/structure/window/full/reinforced,/obj/structure/window/barricade/full/block,/turf/simulated/floor/plating,/area)
"r" = (/obj/structure/window/reinforced,/obj/structure/window/reinforced{dir = 4},/obj/structure/window/reinforced{dir = 8},/obj/structure/window/reinforced{dir = 1},/obj/structure/grille,/obj/structure/window/full/reinforced,/turf/simulated/floor/plating,/area)
"s" = (/obj/machinery/door/airlock/glass_medical{id_tag = ""; name = "Medical Research"; req_access_txt = "5"},/turf/simulated/floor/plating,/area)
"t" = (/turf/simulated/floor/mineral/uranium,/area)
"u" = (/obj/structure/bed,/obj/item/weapon/bedsheet/medical,/obj/structure/curtain/open/left,/turf/simulated/floor{dir = 5; icon_state = "bluefull"},/area)
"v" = (/obj/structure/bed,/obj/item/weapon/bedsheet/medical,/obj/structure/curtain/open/right,/turf/simulated/floor{dir = 5; icon_state = "bluefull"},/area)
"w" = (/turf/simulated/floor{dir = 5; icon_state = "bluefull"},/area)
"x" = (/obj/item/weapon/storage/firstaid/internalbleed,/turf/simulated/floor{dir = 5; icon_state = "bluefull"},/area)
"y" = (/obj/machinery/sleeper{dir = 1; icon_state = "sleeper_0"},/turf/simulated/floor{dir = 5; icon_state = "bluefull"},/area)
"z" = (/obj/machinery/sleeper,/turf/simulated/floor{dir = 5; icon_state = "bluefull"},/area)
"A" = (/obj/structure/table,/obj/item/weapon/storage/firstaid/toxin{pixel_x = 2; pixel_y = 6},/obj/item/weapon/storage/firstaid/radiation,/turf/simulated/floor{dir = 5; icon_state = "bluefull"},/area)
"B" = (/obj/item/weapon/storage/firstaid/toxin{pixel_x = -2; pixel_y = 4},/turf/simulated/floor{dir = 5; icon_state = "bluefull"},/area)
"C" = (/obj/structure/rack,/obj/item/clothing/suit/straight_jacket,/obj/item/clothing/mask/muzzle,/turf/simulated/floor{dir = 5; icon_state = "bluefull"},/area)
"D" = (/obj/item/weapon/storage/firstaid/radiation,/turf/simulated/floor/plating,/area)
"E" = (/obj/item/weapon/storage/firstaid/toxin,/turf/simulated/floor{dir = 5; icon_state = "bluefull"},/area)
"F" = (/obj/structure/rack,/obj/item/clothing/suit/straight_jacket,/obj/item/clothing/mask/muzzle,/turf/simulated/floor/plating,/area)
"G" = (/obj/structure/altar,/turf/simulated/floor/mineral/uranium,/area)
"H" = (/obj/structure/bed,/obj/structure/curtain/medical,/obj/item/weapon/bedsheet/medical,/mob/living/simple_animal/hostile/giant_spider/hunter,/turf/simulated/floor{dir = 5; icon_state = "bluefull"},/area)
"I" = (/obj/machinery/iv_drip,/turf/simulated/floor{dir = 5; icon_state = "bluefull"},/area)
"J" = (/obj/structure/rack,/obj/item/clothing/suit/straight_jacket,/obj/item/clothing/mask/muzzle,/turf/simulated/floor{icon_state = "whitebluecorner"; dir = 1},/area)
"K" = (/turf/unsimulated/floor/airless,/area)
"L" = (/obj/item/weapon/shard,/turf/simulated/floor{dir = 5; icon_state = "bluefull"},/area)
"M" = (/obj/structure/window/reinforced,/obj/structure/window/reinforced{dir = 4},/obj/structure/window/reinforced{dir = 1},/obj/structure/grille,/obj/structure/window/full/reinforced,/obj/structure/window/barricade/full/block,/obj/item/weapon/shard,/turf/simulated/floor/plating,/area)
"N" = (/obj/structure/window/barricade{dir = 8},/turf/simulated/floor/plating,/area)
"O" = (/obj/structure/ladder/mutant_den/bottom,/turf/unsimulated/floor/airless,/area)
"P" = (/obj/structure/rack,/turf/simulated/floor{dir = 5; icon_state = "bluefull"},/area)
"Q" = (/obj/item/weapon/storage/firstaid/toxin,/obj/structure/rack,/turf/simulated/floor{dir = 5; icon_state = "bluefull"},/area)
"R" = (/obj/machinery/smartfridge/bloodbank,/turf/simulated/floor{dir = 5; icon_state = "bluefull"},/area)
"S" = (/obj/machinery/bodyscanner,/turf/simulated/floor{dir = 5; icon_state = "bluefull"},/area)
"T" = (/obj/machinery/bodyscanner{dir = 1},/turf/simulated/floor{dir = 5; icon_state = "bluefull"},/area)
"U" = (/obj/machinery/smartfridge/chemistry,/turf/simulated/floor{dir = 5; icon_state = "bluefull"},/area)
"V" = (/turf/space,/area)
"W" = (/obj/structure/bed,/obj/structure/curtain/medical,/obj/item/device/radio/intercom{freerange = 1; name = "Station Intercom (General)"; pixel_x = 30},/obj/item/weapon/bedsheet/medical,/turf/simulated/floor/plating,/area)
"X" = (/turf/simulated/wall/invulnerable/r_wall,/area/maintenance/aft)

(1,1,1) = {"
aaaaaaaaaaaaaaaaaaaaaaaaaaaaaaaaaaaaaaaaaaaaaaaaaa
abcdbcdbcdeeedbbbdeeedfffffffffdggggghiiiiiiiiiiia
abbdbbdbbdeeebbbcdeeedfffffffffgggggghiiiiiiiiiiia
abddbddbddeeedbbbdeeedfffffffffdggggghiiiiiiiiiiia
aeeeeeeeeeeeedddddeeedfffffffffdggggghiiiiiiiiiiia
aeeeeeeeeeeeedcbcdeeedfffffffffdggggghiiiiiiiiiiia
abddbddbddeeedcbcdeeedfffffffffgggggggiiiiiiiiiiia
abbdbbdbbdeeedcbcdeeedfffffffffdggggghiiiiiiiiiiia
abcdbcdbcdeeedbbbdeeedfffffffffdggggghiiiiiiiiiiia
adddddddddeeebbbbbeeedddddddddddddddddddddddddddda
abcdbcdbcdeeedbbbdeeeeeeeeeeeeeeeeeeeeeeeeeeeeeeea
abbdbbdbbdeeedcbcdeeeeeeeeeeeeeeeeeeeeeeeeeeeeeeea
abddbddbddeeedcbcdeeeeeeeeeeeeeeeeeeeeeeeeeeeeeeea
aeeeeeeeeeeeedcbcdeeeddddddddddddddddddddddddjddda
aeeeeeeeeeeeedddddeeedjjjddjdjjjdjdjjjdjjjjdjjjdda
aeeeeeeeeeeeeeeeeeeeedjjjddjjjjjdjjjjjjjjjjdjjjdda
addbddbdddddddddddeeeddjdddjdjjjdjddjjdjjjjdjjjdda
aedbbdbbdbbdbbdbcdeejjjjjjdjdddddjdjjddjdjjddjddda
akdbcdbcdbcdbcdbbdedjddddjdjjjjjjjddjddjdjjddjddda
addddddddlddlddlddddmdjjdjdjdddddjdddddjdjjdjjjdda
aeeeeeeejmmmmjjmjjdmmdjjjjdjdjjjdjdjjjdjjjjdjjjdda
aeeeeeemmjjjmjjmmjdmjdjjdjdjjjjjdjdjjjdjdjjdjjjdda
annonnnmjjjjjjmmmmmmjddddjdjdjjjdjdjjjdjdppppjpppa
addqddddrdddddsdddmmjdjjjjjjdddddjdjjjjjdpttttttta
aujvwxdywzdABjjjCdjmjdjjddjjdjjjjjdddddjdpttttttta
awDwjddEjwddjwwFdddjdddddddjdjjjjddjddjjdptttGttta
aHjjjdIjjjjwwwjJdKKKKKdjjjjjdjjjjdjjjdjddpttttttta
awwjLMNjDwwaaaaaaKKOKKdjjjjjdjjjjdjjjjjddpttttttta
aHjPQdRSITUaVVVVaKKKKKdjjjjddjjjjjjjjdjddpttttttta
aaaaaaaaaaaaVVWVaaXaaaaaaaaaaaaaaaaaaaaaaaaaaaaaaa
"}
