"aa" = (/turf/space,/area)
"ab" = (/turf/simulated/wall/invulnerable/r_wall,/area)
"ac" = (/obj/machinery/computer/fluff/medical,/turf/simulated/floor/carpet,/area)
"ad" = (/obj/structure/table/woodentable,/obj/item/weapon/folder/white,/turf/simulated/floor/carpet,/area)
"ae" = (/obj/structure/table/woodentable,/obj/item/weapon/paper_bin{pixel_x = 1; pixel_y = 9},/obj/item/weapon/pen,/turf/simulated/floor/carpet,/area)
"af" = (/turf/simulated/floor/carpet,/area)
"ag" = (/obj/structure/bed,/obj/item/weapon/bedsheet/black,/obj/structure/curtain/open/bed,/turf/simulated/floor/carpet,/area)
"ah" = (/obj/machinery/computer/fluff/communications,/turf/simulated/floor/carpet,/area)
"ai" = (/obj/structure/bed/chair/office/light{dir = 8},/turf/simulated/floor/carpet,/area)
"aj" = (/obj/effect/gibspawner/blood,/turf/simulated/floor/carpet,/area)
"ak" = (/obj/structure/table/woodentable,/turf/simulated/floor/carpet,/area)
"al" = (/turf/simulated/wall,/area)
"am" = (/obj/structure/bed,/obj/structure/curtain/open/left,/turf/simulated/floor/plating,/area)
"an" = (/obj/structure/sign/chinese/notice{pixel_y = 32},/turf/simulated/floor,/area)
"ao" = (/turf/simulated/floor,/area)
"ap" = (/obj/structure/bed,/obj/structure/curtain/open/right,/turf/simulated/floor/plating,/area)
"aq" = (/obj/structure/closet/secure_closet/personal/cabinet,/obj/item/clothing/under/rank/research_director,/turf/simulated/floor/carpet,/area)
"ar" = (/obj/structure/bed,/obj/structure/curtain/open/left,/turf/simulated/floor,/area)
"as" = (/turf/simulated/floor/plating,/area)
"at" = (/obj/structure/bed,/obj/structure/curtain/open/right,/turf/simulated/floor,/area)
"au" = (/obj/structure/flora/pottedplant/random,/turf/simulated/floor/wood,/area)
"av" = (/obj/structure/table/woodentable,/obj/machinery/microwave,/turf/simulated/floor/wood,/area)
"aw" = (/obj/structure/table/woodentable,/obj/item/weapon/storage/box/donkpockets,/obj/item/weapon/storage/box/donkpockets{pixel_x = 2; pixel_y = 3},/turf/simulated/floor/wood,/area)
"ax" = (/obj/machinery/light/small{dir = 1},/obj/machinery/vending/coffee,/turf/simulated/floor/wood,/area)
"ay" = (/turf/simulated/floor/wood,/area)
"az" = (/turf/simulated/floor{icon_state = "dark"},/area)
"aA" = (/obj/machinery/light/small{dir = 4; on = 1},/turf/simulated/floor/plating,/area)
"aB" = (/obj/structure/table/woodentable,/obj/item/clothing/mask/scarf,/turf/simulated/floor/carpet,/area)
"aC" = (/mob/living/simple_animal/hostile/frog/snork,/turf/simulated/floor,/area)
"aD" = (/obj/structure/bed,/obj/structure/curtain/closed,/turf/simulated/floor,/area)
"aE" = (/obj/structure/table/woodentable,/obj/item/device/flashlight/lamp/green{on = 0; pixel_x = -3; pixel_y = 8},/turf/simulated/floor/wood,/area)
"aF" = (/turf/simulated/floor/glass,/area)
"aG" = (/obj/structure/bed,/obj/item/weapon/bedsheet/brown,/obj/structure/curtain/open/bed,/turf/simulated/floor/carpet,/area)
"aH" = (/obj/structure/table/woodentable,/obj/machinery/computer/security/telescreen/entertainment{pixel_x = -32},/obj/item/weapon/reagent_containers/food/drinks/coffee,/turf/simulated/floor/wood,/area)
"aI" = (/obj/structure/bed/chair/comfy/black{dir = 4},/turf/simulated/floor/glass,/area)
"aJ" = (/obj/structure/bed/chair/comfy/couch/right/black{dir = 8},/turf/simulated/floor/glass,/area)
"aK" = (/obj/effect/landmark/corpse/scientist,/turf/simulated/floor{icon_state = "dark"},/area)
"aL" = (/obj/structure/coatrack,/turf/simulated/floor/carpet,/area)
"aM" = (/obj/structure/closet/secure_closet/personal/cabinet,/obj/item/clothing/under/rank/scientist,/turf/simulated/floor/carpet,/area)
"aN" = (/obj/structure/sign/chinese/notice{pixel_x = 0; pixel_y = -32},/turf/simulated/floor,/area)
"aO" = (/obj/structure/table/woodentable,/obj/machinery/light/small{dir = 8; flickering = 1},/turf/simulated/floor/wood,/area)
"aP" = (/obj/structure/bed/chair/comfy/couch/left/black{dir = 8},/turf/simulated/floor/glass,/area)
"aQ" = (/obj/effect/decal/cleanable/blood,/turf/simulated/floor{icon_state = "dark"},/area)
"aR" = (/obj/machinery/door/mineral/wood{name = "Wooden Door"},/turf/simulated/floor/carpet,/area)
"aS" = (/obj/machinery/door/airlock/security{name = "Subject Residence"},/turf/simulated/floor/plating,/area)
"aT" = (/obj/abstract/map/spawner/maint,/turf/simulated/floor/plating,/area)
"aU" = (/obj/structure/rack,/obj/abstract/map/spawner/assistant/tools,/obj/item/weapon/spear/wooden,/turf/simulated/floor/plating,/area)
"aV" = (/obj/abstract/map/spawner/assistant/materials,/mob/living/simple_animal/hostile/frog/snork,/turf/simulated/floor/plating,/area)
"aW" = (/obj/structure/girder,/turf/simulated/floor/plating,/area)
"aX" = (/obj/abstract/map/spawner/assistant/tools,/turf/simulated/floor/plating,/area)
"aY" = (/obj/machinery/light/small{dir = 4},/turf/simulated/floor/plating,/area)
"aZ" = (/obj/machinery/light{dir = 1},/turf/simulated/floor/plating,/area)
"ba" = (/mob/living/simple_animal/hostile/frog/snork,/turf/simulated/floor/plating,/area)
"bb" = (/obj/structure/rack,/obj/item/weapon/storage/firstaid/radiation,/turf/simulated/floor/plating,/area)
"bc" = (/obj/structure/rack,/obj/item/weapon/spear,/turf/simulated/floor/plating,/area)
"bd" = (/obj/effect/decal/cleanable/blood,/turf/simulated/floor/plating,/area)
"be" = (/obj/abstract/map/spawner/assistant/materials,/turf/simulated/floor/plating,/area)
"bf" = (/obj/structure/window/barricade,/turf/simulated/floor/plating,/area)
"bg" = (/obj/abstract/map/spawner/misc/trash,/turf/simulated/floor/plating,/area)
"bh" = (/obj/structure/window/barricade/full,/turf/simulated/floor/plating,/area)
"bi" = (/obj/machinery/door/poddoor{desc = "A pair of heavy reinforced plasteel doors."; id_tag = "maintblastdoor"; name = "Blast Door"},/turf/simulated/floor/plating,/area)
"bj" = (/obj/item/device/flashlight/lantern/on,/turf/simulated/floor/plating,/area)
"bk" = (/obj/structure/rack,/obj/abstract/map/spawner/assistant/tools,/turf/simulated/floor/plating,/area)
"bl" = (/obj/structure/rack,/obj/abstract/map/spawner/assistant/materials,/turf/simulated/floor/plating,/area)
"bm" = (/turf/simulated/floor{icon_state = "cafeteria"; dir = 5},/area)
"bn" = (/obj/item/weapon/paper{info = "This was a mistake.  I'm so sorry for what I've taken part in."; name = "suicide note"},/turf/simulated/floor/carpet,/area)
"bo" = (/obj/item/weapon/pen,/obj/item/ammo_casing/a357,/turf/simulated/floor/carpet,/area)
"bp" = (/obj/item/clothing/under/maid,/turf/simulated/floor/carpet,/area)
"bq" = (/obj/structure/closet/secure_closet/personal/cabinet,/obj/item/clothing/suit/wintercoat/cmo,/turf/simulated/floor/carpet,/area)
"br" = (/obj/structure/bed,/obj/item/weapon/bedsheet/red,/obj/structure/curtain/open/bed,/obj/item/weapon/paper{info = "Remember: feed the assistants on time so they don't go feral.  Last time there was nearly a breach."; name = "note"},/turf/simulated/floor/carpet,/area)
"bs" = (/obj/structure/closet/secure_closet/personal/cabinet,/obj/item/clothing/under/bluepants,/turf/simulated/floor/carpet,/area)
"bt" = (/obj/structure/bed,/obj/item/weapon/bedsheet/red,/obj/structure/curtain/open/bed,/turf/simulated/floor/carpet,/area)
"bu" = (/obj/structure/closet/secure_closet/personal/cabinet,/obj/item/clothing/under/custom/N3X15/robotics,/turf/simulated/floor/carpet,/area)
"bv" = (/obj/machinery/door_control{desc = "escape button"; id_tag = "escapebutton"; name = "Escape button"; pixel_x = 27; pixel_y = 27; req_access_txt = "0"},/turf/simulated/floor/plating,/area)
"bw" = (/obj/machinery/door/poddoor{desc = "A pair of heavy reinforced plasteel doors."; id_tag = "maintblastdoor"; name = "Blast Door"},/turf/simulated/floor{icon_state = "dark"},/area)
"bx" = (/obj/structure/mirror{pixel_x = -32},/obj/structure/sink{dir = 8; pixel_x = -12; pixel_y = 2},/turf/simulated/floor{icon_state = "cafeteria"; dir = 5},/area)
"by" = (/obj/structure/closet/secure_closet/personal/cabinet,/obj/item/clothing/under/rank/scientist,/obj/item/clothing/under/rank/scientist,/turf/simulated/floor/carpet,/area)
"bz" = (/obj/structure/bed,/obj/item/weapon/bedsheet/green,/obj/structure/curtain/open/bed,/obj/effect/landmark/corpse/scientist,/obj/item/weapon/gun/projectile/detective,/turf/simulated/floor/carpet,/area)
"bA" = (/obj/item/weapon/bedsheet/green,/turf/simulated/floor/carpet,/area)
"bB" = (/obj/structure/bed,/obj/structure/curtain/open/bed,/turf/simulated/floor/carpet,/area)
"bC" = (/obj/machinery/light/small{dir = 8},/turf/simulated/floor{icon_state = "dark"},/area)
"bD" = (/obj/item/weapon/pen,/turf/simulated/floor/carpet,/area)
"bE" = (/obj/machinery/light/small{dir = 4; on = 1},/obj/structure/sign/chinese/restricted_area{pixel_x = 32},/turf/simulated/floor/plating,/area)
"bF" = (/obj/abstract/map/spawner/misc/trash,/obj/item/weapon/soap,/obj/abstract/map/spawner/misc/trash,/turf/simulated/floor/plating,/area)
"bG" = (/obj/structure/window/barricade{dir = 8},/turf/simulated/floor/plating,/area)
"bH" = (/obj/machinery/light/small,/turf/simulated/floor/plating,/area)
"bI" = (/obj/structure/toilet{dir = 1},/turf/simulated/floor/plating,/area)
"bJ" = (/obj/machinery/light/small{dir = 1},/turf/simulated/floor/plating,/area)
"bK" = (/obj/structure/table,/obj/machinery/computer/med_data/laptop,/turf/simulated/floor/plating,/area)
"bL" = (/obj/machinery/light/small{dir = 1},/turf/simulated/floor{icon_state = "dark"},/area)
"bM" = (/obj/effect/landmark/corpse/scientist,/obj/effect/gibspawner/blood,/turf/simulated/floor/plating,/area)
"bN" = (/obj/abstract/map/spawner/misc/trash,/turf/simulated/floor{icon_state = "dark"},/area)
"bO" = (/obj/machinery/light/small{dir = 1},/obj/abstract/map/spawner/misc/trash,/turf/simulated/floor{icon_state = "dark"},/area)
"bP" = (/obj/structure/table/flipped,/turf/simulated/floor/plating,/area)
"bQ" = (/obj/machinery/light/small{dir = 1},/obj/abstract/map/spawner/misc/trash,/turf/simulated/floor/plating,/area)
"bR" = (/obj/machinery/light/small{dir = 1},/obj/structure/table,/turf/simulated/floor/plating,/area)
"bS" = (/obj/abstract/map/spawner/maint,/mob/living/simple_animal/hostile/frog/snork,/turf/simulated/floor/plating,/area)
"bT" = (/obj/structure/table,/obj/abstract/map/spawner/highrisk,/turf/simulated/floor/plating,/area)
"bU" = (/obj/machinery/door_control{desc = "Danger within."; id_tag = "maintblastdoor"; name = "Containment Control"; pixel_x = 27; pixel_y = 27; req_access_txt = "0"},/obj/abstract/map/spawner/assistant/materials,/obj/structure/table,/turf/simulated/floor/plating,/area)
"bV" = (/obj/structure/table,/turf/simulated/floor/plating,/area)
"bW" = (/obj/structure/table,/obj/item/weapon/paper_bin{pixel_x = 1; pixel_y = 9},/obj/item/weapon/pen,/turf/simulated/floor{icon_state = "dark"},/area)
"bX" = (/obj/item/weapon/extinguisher,/obj/abstract/map/spawner/misc/trash,/turf/simulated/floor/plating,/area)
"bY" = (/obj/abstract/map/spawner/assistant/materials,/obj/abstract/map/spawner/assistant/materials,/turf/simulated/floor/plating,/area)
"bZ" = (/obj/structure/rack,/obj/abstract/map/spawner/assistant/materials,/obj/item/weapon/spear/wooden,/turf/simulated/floor/plating,/area)
"ca" = (/obj/abstract/map/spawner/misc/trash,/turf/simulated/floor{icon_state = "whitehall"},/area)
"cb" = (/obj/structure/window/barricade,/obj/abstract/map/spawner/misc/trash,/turf/simulated/floor/plating,/area)
"cc" = (/obj/structure/table/flipped,/turf/simulated/floor{icon_state = "dark"},/area)
"cd" = (/obj/structure/sign/redcross{pixel_y = -32},/obj/abstract/map/spawner/misc/trash,/turf/simulated/floor/plating,/area)
"ce" = (/obj/structure/sign/redcross{pixel_y = -32},/obj/abstract/map/spawner/misc/trash,/turf/simulated/floor{icon_state = "dark"},/area)
"cf" = (/obj/effect/plantsegment,/turf/simulated/floor{icon_state = "dark"},/area)
"cg" = (/turf/simulated/wall/mineral/uranium,/area)
"ch" = (/obj/structure/window/reinforced,/obj/structure/window/reinforced{dir = 4},/obj/structure/window/reinforced{dir = 8},/obj/structure/window/reinforced{dir = 1},/obj/structure/grille,/obj/structure/window/full/reinforced,/obj/structure/window/barricade/full/block,/turf/simulated/floor/plating,/area)
"ci" = (/obj/structure/window/reinforced,/obj/structure/window/reinforced{dir = 4},/obj/structure/window/reinforced{dir = 8},/obj/structure/window/reinforced{dir = 1},/obj/structure/grille,/obj/structure/window/full/reinforced,/turf/simulated/floor/plating,/area)
"cj" = (/obj/machinery/door/airlock/glass_medical{id_tag = ""; name = "Medical Research"; req_access_txt = "5"},/turf/simulated/floor/plating,/area)
"ck" = (/obj/structure/sign/chinese/medbay{pixel_x = -32; pixel_y = 0},/obj/effect/plantsegment,/turf/simulated/floor{icon_state = "dark"},/area)
"cl" = (/turf/simulated/floor/mineral/uranium,/area)
"cm" = (/obj/structure/bed,/obj/item/weapon/bedsheet/medical,/obj/structure/curtain/open/left,/turf/simulated/floor{dir = 5; icon_state = "bluefull"},/area)
"cn" = (/obj/structure/bed,/obj/item/weapon/bedsheet/medical,/obj/structure/curtain/open/right,/turf/simulated/floor{dir = 5; icon_state = "bluefull"},/area)
"co" = (/turf/simulated/floor{dir = 5; icon_state = "bluefull"},/area)
"cp" = (/obj/item/weapon/storage/firstaid/internalbleed,/turf/simulated/floor{dir = 5; icon_state = "bluefull"},/area)
"cq" = (/obj/machinery/sleeper{dir = 1; icon_state = "sleeper_0"},/turf/simulated/floor{dir = 5; icon_state = "bluefull"},/area)
"cr" = (/obj/machinery/sleeper,/turf/simulated/floor{dir = 5; icon_state = "bluefull"},/area)
"cs" = (/obj/structure/table,/obj/item/weapon/storage/firstaid/toxin{pixel_x = 2; pixel_y = 6},/obj/item/weapon/storage/firstaid/radiation,/turf/simulated/floor{dir = 5; icon_state = "bluefull"},/area)
"ct" = (/obj/item/weapon/storage/firstaid/toxin{pixel_x = -2; pixel_y = 4},/turf/simulated/floor{dir = 5; icon_state = "bluefull"},/area)
"cu" = (/obj/structure/rack,/obj/item/clothing/suit/straight_jacket,/obj/item/clothing/mask/muzzle,/turf/simulated/floor{dir = 5; icon_state = "bluefull"},/area)
"cv" = (/obj/effect/plantsegment,/obj/machinery/light/small{dir = 8},/turf/simulated/floor/plating,/area)
"cw" = (/obj/structure/flora/pottedplant/random,/turf/simulated/floor/plating,/area)
"cx" = (/obj/structure/closet/crate/radiation,/obj/item/weapon/dnainjector/nofail/radioactive,/turf/simulated/floor/mineral/uranium,/area)
"cy" = (/obj/structure/closet/crate/radiation,/obj/item/weapon/dnainjector/nofail/randompower,/turf/simulated/floor/mineral/uranium,/area)
"cz" = (/obj/machinery/light{dir = 8},/turf/simulated/floor{dir = 5; icon_state = "bluefull"},/area)
"cA" = (/obj/item/weapon/storage/firstaid/radiation,/turf/simulated/floor/plating,/area)
"cB" = (/obj/item/weapon/storage/firstaid/toxin,/turf/simulated/floor{dir = 5; icon_state = "bluefull"},/area)
"cC" = (/obj/effect/landmark/corpse/scientist,/turf/simulated/floor{dir = 5; icon_state = "bluefull"},/area)
"cD" = (/obj/structure/rack,/obj/item/clothing/suit/straight_jacket,/obj/item/clothing/mask/muzzle,/turf/simulated/floor/plating,/area)
"cE" = (/obj/structure/table,/obj/abstract/map/spawner/theater/costumes,/turf/simulated/floor/plating,/area)
"cF" = (/obj/abstract/map/spawner/assistant/tools,/mob/living/simple_animal/hostile/frog/snork,/turf/simulated/floor/plating,/area)
"cG" = (/obj/structure/altar,/turf/simulated/floor/mineral/uranium,/area)
"cH" = (/obj/structure/bed,/obj/structure/curtain/medical,/obj/item/weapon/bedsheet/medical,/mob/living/simple_animal/hostile/frog/snork,/turf/simulated/floor{dir = 5; icon_state = "bluefull"},/area)
"cI" = (/obj/machinery/iv_drip,/turf/simulated/floor{dir = 5; icon_state = "bluefull"},/area)
"cJ" = (/obj/item/device/flashlight/pen,/turf/simulated/floor/plating,/area)
"cK" = (/obj/machinery/light,/turf/simulated/floor{dir = 5; icon_state = "bluefull"},/area)
"cL" = (/obj/structure/rack,/obj/item/clothing/suit/straight_jacket,/obj/item/clothing/mask/muzzle,/turf/simulated/floor{icon_state = "whitebluecorner"; dir = 1},/area)
"cM" = (/obj/item/weapon/tank/jetpack/oxygen,/turf/simulated/floor/plating,/area)
"cN" = (/obj/structure/sign/chinese/access_restricted{pixel_x = 0; pixel_y = 32},/turf/simulated/floor/plating,/area)
"cO" = (/obj/structure/sign/nosmoking_1{pixel_y = 32},/turf/simulated/floor{icon_state = "dark"},/area)
"cP" = (/obj/machinery/atmospherics/unary/tank/oxygen,/turf/simulated/floor{icon_state = "dark"},/area)
"cQ" = (/obj/structure/rack,/obj/abstract/map/spawner/assistant/materials,/obj/abstract/map/spawner/assistant/tools,/obj/item/weapon/spear/wooden,/turf/simulated/floor/plating,/area)
"cR" = (/obj/structure/rack,/obj/abstract/map/spawner/assistant/materials,/obj/abstract/map/spawner/assistant/tools,/turf/simulated/floor/plating,/area)
"cS" = (/obj/machinery/light/small{dir = 8},/turf/simulated/floor/plating,/area)
"cT" = (/obj/structure/table,/obj/abstract/map/spawner/maint,/turf/simulated/floor/plating,/area)
"cU" = (/obj/abstract/map/spawner/assistant/tools,/obj/machinery/light/small{dir = 4},/turf/simulated/floor/plating,/area)
"cV" = (/obj/item/weapon/shard,/turf/simulated/floor{dir = 5; icon_state = "bluefull"},/area)
"cW" = (/obj/structure/window/reinforced,/obj/structure/window/reinforced{dir = 4},/obj/structure/window/reinforced{dir = 1},/obj/structure/grille,/obj/structure/window/full/reinforced,/obj/structure/window/barricade/full/block,/obj/item/weapon/shard,/turf/simulated/floor/plating,/area)
"cX" = (/obj/machinery/portable_atmospherics/canister/oxygen,/obj/item/weapon/tank/oxygen,/turf/simulated/floor/plating,/area)
"cY" = (/obj/structure/ladder/mutant_den/bottom,/turf/simulated/floor{icon_state = "dark"},/area)
"cZ" = (/obj/machinery/atmospherics/unary/tank/nitrogen,/turf/simulated/floor/plating,/area)
"da" = (/obj/abstract/map/spawner/assistant/tools,/obj/machinery/light/small{dir = 8; flickering = 1},/obj/abstract/map/spawner/maint,/turf/simulated/floor/plating,/area)
"db" = (/obj/structure/rack,/obj/abstract/map/spawner/maint,/turf/simulated/floor/plating,/area)
"dc" = (/obj/structure/bed,/obj/structure/curtain/medical,/obj/item/weapon/bedsheet/medical,/turf/simulated/floor{dir = 5; icon_state = "bluefull"},/area)
"dd" = (/obj/structure/rack,/obj/machinery/light,/obj/item/device/flashlight/pen,/turf/simulated/floor{dir = 5; icon_state = "bluefull"},/area)
"de" = (/obj/structure/rack,/obj/item/weapon/storage/firstaid/toxin,/turf/simulated/floor{dir = 5; icon_state = "bluefull"},/area)
"df" = (/obj/machinery/smartfridge/bloodbank,/turf/simulated/floor{dir = 5; icon_state = "bluefull"},/area)
"dg" = (/obj/machinery/bodyscanner,/turf/simulated/floor{dir = 5; icon_state = "bluefull"},/area)
"dh" = (/obj/machinery/iv_drip,/obj/machinery/light,/turf/simulated/floor{dir = 5; icon_state = "bluefull"},/area)
"di" = (/obj/machinery/bodyscanner{dir = 1},/turf/simulated/floor{dir = 5; icon_state = "bluefull"},/area)
"dj" = (/obj/machinery/smartfridge/chemistry,/turf/simulated/floor{dir = 5; icon_state = "bluefull"},/area)
"dk" = (/obj/machinery/suit_storage_unit/standard_unit,/turf/simulated/floor{icon_state = "dark"},/area)
"dl" = (/obj/machinery/suit_storage_unit/standard_unit,/turf/simulated/floor/plating,/area)
"dm" = (/obj/machinery/atmospherics/unary/tank/nitrogen,/turf/simulated/floor{icon_state = "dark"},/area)
"dn" = (/turf/simulated/wall/invulnerable/r_wall,/area/maintenance/aft)

(1,1,1) = {"
aaaaaaaaaaaaaaaaaaaaaaaaaaaaaaaaaaaaaaaaaaaaaaaaaaaaaaaaaaaaaaaaaaaaaaaaaaaaaaaaaaaaaaaaaaaaaaaaaaaa
aaaaaaaaaaaaaaaaaaaaaaaaaaaaaaaaaaaaaaaaaaaaaaaaaaaaaaaaaaaaaaaaaaaaaaaaaaaaaaaaaaaaaaaaaaaaaaaaaaaa
aaaaaaaaaaaaaaaaaaaaaaaaaaaaaaaaaaaaaaaaaaaaaaaaaaaaaaaaaaaaaaaaaaaaaaaaaaaaaaaaaaaaaaaaaaaaaaaaaaaa
aaaaaaaaaaaaaaaaaaaaaaaaaaaaaaaaaaaaaaaaaaaaaaaaaaaaaaaaaaaaaaaaaaaaaaaaaaaaaaaaaaaaaaaaaaaaaaaaaaaa
aaaaaaaaaaaaaaaaaaaaaaaaaaaaaaaaaaaaaaaaaaaaaaaaaaaaaaaaaaaaaaaaaaaaaaaaaaaaaaaaaaaaaaaaaaaaaaaaaaaa
aaaaaaaaaaaaaaaaaaaaaaaaaaaaaaaaaaaaaaaaaaaaaaaaaaaaaaaaaaaaaaaaaaaaaaaaaaaaaaaaaaaaaaaaaaaaaaaaaaaa
abababababababaaaaaaaaaaaaaaaaaaaaaaaaaaaaaaaaaaaaaaaaaaaaaaaaaaaaaaaaaaaaaaaaaaaaaaaaaaaaaaaaaaaaaa
abacadaeafagabaaaaaaaaaaaaaaaaaaaaaaaaaaaaaaaaaaaaaaaaaaaaaaaaaaaaaaaaaaaaaaaaaaaaaaaaaaaaaaaaaaaaaa
abahaiafajafababababababababaaaaaaaaaaaaaaaaaaaaaaaaaaaaaaaaaaaaaaaaaaaaaaaaaaaaaaaaaaaaaaaaaaaaaaaa
ababakafafafalalamanaoapalabababababababababaaaaaaaaaaaaaaaaaaaaaaaaaaaaaaaaaaaaaaaaaaaaaaaaaaaaaaaa
aaabafafafafaqalaraoasatalauavawaxayazaoaAabaaaaaaaaaaaaaaaaaaaaaaaaaaaaaaaaaaaaaaaaaaaaaaaaaaaaaaaa
aaabafaBalalalalaraCaoaDalaEaFaFaFayasasaoabaaaaaaaaaaaaaaaaaaaaaaaaaaaaaaaaaaaaaaaaaaaaaaaaaaaaaaaa
aaabafakalafaGalarasaoatalaHaIaFaJayaoaKaoabaaaaaaaaaaaaaaaaaaaaaaaaaaaaaaaaaaaaaaaaaaaaaaaaaaaaaaaa
aaabafaLalafaMalaraoaNapalaOaIaFaPayazaQasababababababababababababababababababababababababababababab
ababaRalalaRalalalaSalalalayayayayayasazaAalaTaUaValasaTaWasasaXalaYalasaTaTalasasaZbaalbbbcasalalab
abazasazazazazasasasazasasazazazazasasasbdalbebfasalasasasbeaTbaalasbgaTasasbhasasasasbiasasasalalab
abaRalalaRalalazalalalalalalalalalalaWazbjalalaAalalalbgalbkblblalaTalalasbmalasasbgasalasasasalalab
abbnboalafbpalasalbqbralbsbtalbubtalazazbvbwasasasasalasalalalalalasalbxbgasaWbgalbaasalalasalalalab
abbybzalbAbBalbCalafbDalafafalafafalaoalbEalalalalasalbFbGbHbgasasbhalalbIalalasalasasalalasalalalab
abalalalalalalasalaRalalaRalalaRalalalalazalaXbJalbfaWasalalalalalasalalalalalasalasasalasasasalalab
abalalbKbLalalazbMbNbNbObNbPbQbNbgbRalazazalbSasasbgalasalaXbkaTalasalbTbUbValasbhasbgalasasasalalab
abbWalbgbgbgalbNbNbgbgbgbNbgbXbNbNbgalazasalbebYalasalasasasaXbZalbgalaVaVasalaYalasasalasasasalalab
abazcacbbNbNbNccbgbgbgbgbgcdbNcebNazazcfaAalaWalalasalasalblbeaValasalbeasbealasalcgcgcgcgascgcgcgab
abalalchalalalalcialalalalalcjalalalckcfbPalaTaTasaTasbgalalalalalbhalasasasbhbgalcgclclclclclclclab
abcmascncocpalcqcocralcsctasasascualcvcfcwalbSaTalalasasalasasasasasalaWalalalasalcgcxclclclclclcyab
abczcAcoasalalcBascCalalascococDalalalcjalalalalalalalbhalascEbVasalalcFalalasasalcgcyclclcGclclcyab
abcHasbMasalcIascJasascococKascLalcMcNascOcPalcQcRcRasasalcScTcTbgalbkaTcUalbgalalcgcyclclclclclcxab
abcocoascVcWbGascAcocoababababababcXascYazcZaldaasasasasaWasbVcEasaldbbebebhasalalcgcyclclclclclcyab
abdcasdddealdfdgdhdidjabaaaaaaaaabazdkazdldmalaVaXaTaXalalasbaasasbgasasblalasalalcgclclcxclcyclclab
ababababababababababababaaaaaaaaababdnababababababababababababababababababababababababababababababab
"}
