"aa" = (/turf/space,/area)
"ab" = (/turf/simulated/wall/invulnerable/r_wall,/area)
"ac" = (/turf/simulated/floor{icon_state = "whitegreen"},/area)
"ad" = (/turf/simulated/wall,/area)
"ae" = (/turf/simulated/floor{icon_state = "cafeteria"; dir = 5},/area)
"af" = (/obj/structure/table/reinforced,/turf/simulated/floor{icon_state = "cafeteria"; dir = 5},/area)
"ag" = (/turf/simulated/floor/wood,/area)
"ah" = (/obj/machinery/computer/fluff/medical,/turf/simulated/floor/carpet,/area)
"ai" = (/obj/structure/table/woodentable,/obj/item/weapon/folder/white,/turf/simulated/floor/carpet,/area)
"aj" = (/obj/structure/table/woodentable,/obj/item/weapon/paper_bin{pixel_x = 1; pixel_y = 9},/obj/item/weapon/pen,/turf/simulated/floor/carpet,/area)
"ak" = (/turf/simulated/floor/carpet,/area)
"al" = (/obj/structure/bed,/obj/item/weapon/bedsheet/black,/obj/structure/curtain/open/bed,/turf/simulated/floor/carpet,/area)
"am" = (/obj/machinery/computer/fluff/communications,/turf/simulated/floor/carpet,/area)
"an" = (/obj/structure/bed/chair/office/light{dir = 8},/turf/simulated/floor/carpet,/area)
"ao" = (/obj/effect/gibspawner/blood,/turf/simulated/floor/carpet,/area)
"ap" = (/obj/structure/table/woodentable,/turf/simulated/floor/carpet,/area)
"aq" = (/obj/structure/bed,/obj/structure/curtain/open/left,/turf/simulated/floor/plating,/area)
"ar" = (/obj/structure/sign/chinese/notice{pixel_y = 32},/turf/simulated/floor,/area)
"as" = (/turf/simulated/floor,/area)
"at" = (/obj/structure/bed,/obj/structure/curtain/open/right,/turf/simulated/floor/plating,/area)
"au" = (/obj/structure/closet/secure_closet/personal/cabinet,/obj/item/clothing/under/rank/research_director,/turf/simulated/floor/carpet,/area)
"av" = (/obj/structure/bed,/obj/structure/curtain/open/left,/turf/simulated/floor,/area)
"aw" = (/turf/simulated/floor/plating,/area)
"ax" = (/obj/structure/bed,/obj/structure/curtain/open/right,/turf/simulated/floor,/area)
"ay" = (/obj/structure/flora/pottedplant/random,/turf/simulated/floor/wood,/area)
"az" = (/obj/structure/table/woodentable,/obj/machinery/microwave,/turf/simulated/floor/wood,/area)
"aA" = (/obj/structure/table/woodentable,/obj/item/weapon/storage/box/donkpockets,/obj/item/weapon/storage/box/donkpockets{pixel_x = 2; pixel_y = 3},/turf/simulated/floor/wood,/area)
"aB" = (/obj/machinery/light/small{dir = 1},/obj/machinery/vending/coffee,/turf/simulated/floor/wood,/area)
"aC" = (/turf/simulated/floor{icon_state = "dark"},/area)
"aD" = (/obj/machinery/light/small{dir = 4; on = 1},/turf/simulated/floor/plating,/area)
"aE" = (/obj/structure/table/woodentable,/obj/item/clothing/mask/scarf,/turf/simulated/floor/carpet,/area)
"aF" = (/mob/living/simple_animal/hostile/giant_spider/hunter,/turf/simulated/floor,/area)
"aG" = (/obj/structure/bed,/obj/structure/curtain/closed,/turf/simulated/floor,/area)
"aH" = (/obj/structure/table/woodentable,/obj/item/device/flashlight/lamp/green{on = 0; pixel_x = -3; pixel_y = 8},/turf/simulated/floor/wood,/area)
"aI" = (/turf/simulated/floor/glass,/area)
"aJ" = (/obj/structure/bed,/obj/item/weapon/bedsheet/brown,/obj/structure/curtain/open/bed,/turf/simulated/floor/carpet,/area)
"aK" = (/obj/structure/table/woodentable,/obj/machinery/computer/security/telescreen/entertainment{pixel_x = -32},/obj/item/weapon/reagent_containers/food/drinks/coffee,/turf/simulated/floor/wood,/area)
"aL" = (/obj/structure/bed/chair/comfy/black{dir = 4},/turf/simulated/floor/glass,/area)
"aM" = (/obj/structure/bed/chair/comfy/couch/right/black{dir = 8},/turf/simulated/floor/glass,/area)
"aN" = (/obj/effect/landmark/corpse/scientist,/turf/simulated/floor{icon_state = "dark"},/area)
"aO" = (/obj/structure/coatrack,/turf/simulated/floor/carpet,/area)
"aP" = (/obj/structure/closet/secure_closet/personal/cabinet,/obj/item/clothing/under/rank/scientist,/turf/simulated/floor/carpet,/area)
"aQ" = (/obj/structure/sign/chinese/notice{pixel_x = 0; pixel_y = -32},/turf/simulated/floor,/area)
"aR" = (/obj/structure/table/woodentable,/obj/machinery/light/small{dir = 8; flickering = 1},/turf/simulated/floor/wood,/area)
"aS" = (/obj/structure/bed/chair/comfy/couch/left/black{dir = 8},/turf/simulated/floor/glass,/area)
"aT" = (/obj/effect/decal/cleanable/blood,/turf/simulated/floor{icon_state = "dark"},/area)
"aU" = (/obj/machinery/door/poddoor{desc = "A pair of heavy reinforced plasteel doors."; id_tag = "maintblastdoor"; name = "Blast Door"},/turf/simulated/floor/plating,/area)
"aV" = (/obj/machinery/door/mineral/wood{name = "Wooden Door"},/turf/simulated/floor/carpet,/area)
"aW" = (/obj/machinery/door/airlock/security{name = "Subject Residence"},/turf/simulated/floor/plating,/area)
"aX" = (/obj/machinery/door_control{desc = "A remote control switch for the AI chamber door."; id_tag = "AI Door"; name = "AI Chamber Door Control"; pixel_x = 27; pixel_y = 27; req_access_txt = "16"},/turf/simulated/floor/plating,/area)
"aY" = (/obj/effect/decal/cleanable/blood,/turf/simulated/floor/plating,/area)
"aZ" = (/obj/structure/girder,/turf/simulated/floor/plating,/area)
"ba" = (/obj/item/weapon/paper{info = "This was a mistake.  I'm so sorry for what I've taken part in."; name = "suicide note"},/turf/simulated/floor/carpet,/area)
"bb" = (/obj/item/weapon/pen,/obj/item/ammo_casing/a357,/turf/simulated/floor/carpet,/area)
"bc" = (/obj/item/clothing/under/maid,/turf/simulated/floor/carpet,/area)
"bd" = (/obj/structure/closet/secure_closet/personal/cabinet,/obj/item/clothing/suit/wintercoat/cmo,/turf/simulated/floor/carpet,/area)
"be" = (/obj/structure/bed,/obj/item/weapon/bedsheet/red,/obj/structure/curtain/open/bed,/obj/item/weapon/paper{info = "Remember: feed the assistants on time so they don't go feral.  Last time there was nearly a breach."; name = "note"},/turf/simulated/floor/carpet,/area)
"bf" = (/obj/structure/closet/secure_closet/personal/cabinet,/obj/item/clothing/under/bluepants,/turf/simulated/floor/carpet,/area)
"bg" = (/obj/structure/bed,/obj/item/weapon/bedsheet/red,/obj/structure/curtain/open/bed,/turf/simulated/floor/carpet,/area)
"bh" = (/obj/structure/closet/secure_closet/personal/cabinet,/obj/item/clothing/under/custom/N3X15/robotics,/turf/simulated/floor/carpet,/area)
"bi" = (/obj/machinery/door_control{desc = "escape button"; id_tag = "escapebutton"; name = "Escape button"; pixel_x = 27; pixel_y = 27; req_access_txt = "0"},/turf/simulated/floor/plating,/area)
"bj" = (/obj/machinery/door/poddoor{desc = "A pair of heavy reinforced plasteel doors."; id_tag = "maintblastdoor"; name = "Blast Door"},/obj/structure/cable{d1 = 1; d2 = 2; icon_state = "1-2"},/turf/simulated/floor{icon_state = "dark"},/area)
"bk" = (/obj/structure/closet/secure_closet/personal/cabinet,/obj/item/clothing/under/rank/scientist,/obj/item/clothing/under/rank/scientist,/turf/simulated/floor/carpet,/area)
"bl" = (/obj/structure/bed,/obj/item/weapon/bedsheet/green,/obj/structure/curtain/open/bed,/obj/effect/landmark/corpse/scientist,/obj/item/weapon/gun/projectile/detective,/turf/simulated/floor/carpet,/area)
"bm" = (/obj/item/weapon/bedsheet/green,/turf/simulated/floor/carpet,/area)
"bn" = (/obj/structure/bed,/obj/structure/curtain/open/bed,/turf/simulated/floor/carpet,/area)
"bo" = (/obj/machinery/light/small{dir = 8},/turf/simulated/floor{icon_state = "dark"},/area)
"bp" = (/obj/item/weapon/pen,/turf/simulated/floor/carpet,/area)
"bq" = (/obj/structure/table,/obj/machinery/computer/med_data/laptop,/turf/simulated/floor/plating,/area)
"br" = (/obj/machinery/light/small{dir = 1},/turf/simulated/floor{icon_state = "dark"},/area)
"bs" = (/obj/effect/landmark/corpse/scientist,/obj/effect/gibspawner/blood,/turf/simulated/floor/plating,/area)
"bt" = (/obj/abstract/map/spawner/misc/trash,/turf/simulated/floor{icon_state = "dark"},/area)
"bu" = (/obj/machinery/light/small{dir = 1},/obj/abstract/map/spawner/misc/trash,/turf/simulated/floor{icon_state = "dark"},/area)
"bv" = (/obj/structure/table/flipped,/turf/simulated/floor/plating,/area)
"bw" = (/obj/machinery/light/small{dir = 1},/obj/abstract/map/spawner/misc/trash,/turf/simulated/floor/plating,/area)
"bx" = (/obj/abstract/map/spawner/misc/trash,/turf/simulated/floor/plating,/area)
"by" = (/obj/machinery/light/small{dir = 1},/obj/structure/table,/turf/simulated/floor/plating,/area)
"bz" = (/obj/structure/table,/obj/item/weapon/paper_bin{pixel_x = 1; pixel_y = 9},/obj/item/weapon/pen,/turf/simulated/floor{icon_state = "dark"},/area)
"bA" = (/obj/item/weapon/extinguisher,/obj/abstract/map/spawner/misc/trash,/turf/simulated/floor/plating,/area)
"bB" = (/obj/abstract/map/spawner/misc/trash,/turf/simulated/floor{icon_state = "whitehall"},/area)
"bC" = (/obj/structure/window/barricade,/obj/abstract/map/spawner/misc/trash,/turf/simulated/floor/plating,/area)
"bD" = (/obj/structure/table/flipped,/turf/simulated/floor{icon_state = "dark"},/area)
"bE" = (/obj/structure/sign/redcross{pixel_y = -32},/obj/abstract/map/spawner/misc/trash,/turf/simulated/floor/plating,/area)
"bF" = (/obj/structure/sign/redcross{pixel_y = -32},/obj/abstract/map/spawner/misc/trash,/turf/simulated/floor{icon_state = "dark"},/area)
"bG" = (/obj/effect/plantsegment,/turf/simulated/floor{icon_state = "dark"},/area)
"bH" = (/turf/simulated/wall/mineral/uranium,/area)
"bI" = (/obj/structure/window/reinforced,/obj/structure/window/reinforced{dir = 4},/obj/structure/window/reinforced{dir = 8},/obj/structure/window/reinforced{dir = 1},/obj/structure/grille,/obj/structure/window/full/reinforced,/obj/structure/window/barricade/full/block,/turf/simulated/floor/plating,/area)
"bJ" = (/obj/structure/window/reinforced,/obj/structure/window/reinforced{dir = 4},/obj/structure/window/reinforced{dir = 8},/obj/structure/window/reinforced{dir = 1},/obj/structure/grille,/obj/structure/window/full/reinforced,/turf/simulated/floor/plating,/area)
"bK" = (/obj/machinery/door/airlock/glass_medical{id_tag = ""; name = "Medical Research"; req_access_txt = "5"},/turf/simulated/floor/plating,/area)
"bL" = (/obj/structure/sign/chinese/medbay{pixel_x = -32; pixel_y = 0},/obj/effect/plantsegment,/turf/simulated/floor{icon_state = "dark"},/area)
"bM" = (/turf/simulated/floor/mineral/uranium,/area)
"bN" = (/obj/structure/bed,/obj/item/weapon/bedsheet/medical,/obj/structure/curtain/open/left,/turf/simulated/floor{dir = 5; icon_state = "bluefull"},/area)
"bO" = (/obj/structure/bed,/obj/item/weapon/bedsheet/medical,/obj/structure/curtain/open/right,/turf/simulated/floor{dir = 5; icon_state = "bluefull"},/area)
"bP" = (/turf/simulated/floor{dir = 5; icon_state = "bluefull"},/area)
"bQ" = (/obj/item/weapon/storage/firstaid/internalbleed,/turf/simulated/floor{dir = 5; icon_state = "bluefull"},/area)
"bR" = (/obj/machinery/sleeper{dir = 1; icon_state = "sleeper_0"},/turf/simulated/floor{dir = 5; icon_state = "bluefull"},/area)
"bS" = (/obj/machinery/sleeper,/turf/simulated/floor{dir = 5; icon_state = "bluefull"},/area)
"bT" = (/obj/structure/table,/obj/item/weapon/storage/firstaid/toxin{pixel_x = 2; pixel_y = 6},/obj/item/weapon/storage/firstaid/radiation,/turf/simulated/floor{dir = 5; icon_state = "bluefull"},/area)
"bU" = (/obj/item/weapon/storage/firstaid/toxin{pixel_x = -2; pixel_y = 4},/turf/simulated/floor{dir = 5; icon_state = "bluefull"},/area)
"bV" = (/obj/structure/rack,/obj/item/clothing/suit/straight_jacket,/obj/item/clothing/mask/muzzle,/turf/simulated/floor{dir = 5; icon_state = "bluefull"},/area)
"bW" = (/obj/effect/plantsegment,/obj/machinery/light/small{dir = 8},/turf/simulated/floor/plating,/area)
"bX" = (/obj/structure/flora/pottedplant/random,/turf/simulated/floor/plating,/area)
"bY" = (/obj/machinery/light{dir = 8},/turf/simulated/floor{dir = 5; icon_state = "bluefull"},/area)
"bZ" = (/obj/item/weapon/storage/firstaid/radiation,/turf/simulated/floor/plating,/area)
"ca" = (/obj/item/weapon/storage/firstaid/toxin,/turf/simulated/floor{dir = 5; icon_state = "bluefull"},/area)
"cb" = (/obj/effect/landmark/corpse/scientist,/turf/simulated/floor{dir = 5; icon_state = "bluefull"},/area)
"cc" = (/obj/structure/rack,/obj/item/clothing/suit/straight_jacket,/obj/item/clothing/mask/muzzle,/turf/simulated/floor/plating,/area)
"cd" = (/obj/structure/altar,/turf/simulated/floor/mineral/uranium,/area)
"ce" = (/obj/structure/bed,/obj/structure/curtain/medical,/obj/item/weapon/bedsheet/medical,/mob/living/simple_animal/hostile/giant_spider/hunter,/turf/simulated/floor{dir = 5; icon_state = "bluefull"},/area)
"cf" = (/obj/machinery/iv_drip,/turf/simulated/floor{dir = 5; icon_state = "bluefull"},/area)
"cg" = (/obj/item/device/flashlight/pen,/turf/simulated/floor/plating,/area)
"ch" = (/obj/machinery/light,/turf/simulated/floor{dir = 5; icon_state = "bluefull"},/area)
"ci" = (/obj/structure/rack,/obj/item/clothing/suit/straight_jacket,/obj/item/clothing/mask/muzzle,/turf/simulated/floor{icon_state = "whitebluecorner"; dir = 1},/area)
"cj" = (/turf/unsimulated/floor/airless,/area)
"ck" = (/obj/structure/sign/chinese/access_restricted{pixel_x = 0; pixel_y = 32},/turf/unsimulated/floor/airless,/area)
"cl" = (/obj/structure/sign/nosmoking_1{pixel_y = 32},/turf/unsimulated/floor/airless,/area)
"cm" = (/obj/item/weapon/shard,/turf/simulated/floor{dir = 5; icon_state = "bluefull"},/area)
"cn" = (/obj/structure/window/reinforced,/obj/structure/window/reinforced{dir = 4},/obj/structure/window/reinforced{dir = 1},/obj/structure/grille,/obj/structure/window/full/reinforced,/obj/structure/window/barricade/full/block,/obj/item/weapon/shard,/turf/simulated/floor/plating,/area)
"co" = (/obj/structure/window/barricade{dir = 8},/turf/simulated/floor/plating,/area)
"cp" = (/obj/structure/ladder/mutant_den/bottom,/turf/unsimulated/floor/airless,/area)
"cq" = (/obj/structure/rack,/obj/machinery/light,/obj/item/device/flashlight/pen,/turf/simulated/floor{dir = 5; icon_state = "bluefull"},/area)
"cr" = (/obj/structure/rack,/obj/item/weapon/storage/firstaid/toxin,/turf/simulated/floor{dir = 5; icon_state = "bluefull"},/area)
"cs" = (/obj/machinery/smartfridge/bloodbank,/turf/simulated/floor{dir = 5; icon_state = "bluefull"},/area)
"ct" = (/obj/machinery/bodyscanner,/turf/simulated/floor{dir = 5; icon_state = "bluefull"},/area)
"cu" = (/obj/machinery/iv_drip,/obj/machinery/light,/turf/simulated/floor{dir = 5; icon_state = "bluefull"},/area)
"cv" = (/obj/machinery/bodyscanner{dir = 1},/turf/simulated/floor{dir = 5; icon_state = "bluefull"},/area)
"cw" = (/obj/machinery/smartfridge/chemistry,/turf/simulated/floor{dir = 5; icon_state = "bluefull"},/area)
"cx" = (/turf/simulated/wall/invulnerable/r_wall,/area/maintenance/aft)

(1,1,1) = {"
aaaaaaaaaaaaaaaaaaaaaaaaaaaaaaaaaaaaaaaaaaababababababababababababababababababababababababababababab
aaaaaaaaaaaaaaaaaaaaaaaaaaaaaaaaaaaaaaaaaaabacacacacacacacacacadaeaeaeaeaeafagagagagagagagagagagagab
aaaaaaaaaaaaaaaaaaaaaaaaaaaaaaaaaaaaaaaaaaabacacacacacacacacacaeaeaeaeaeaeafagagagagagagagagagagagab
aaaaaaaaaaaaaaaaaaaaaaaaaaaaaaaaaaaaaaaaaaabacacacacacacacacacadaeaeaeaeaeafagagagagagagagagagagagab
aaaaaaaaaaaaaaaaaaaaaaaaaaaaaaaaaaaaaaaaaaabacacacacacacacacacadaeaeaeaeaeafagagagagagagagagagagagab
aaaaaaaaaaaaaaaaaaaaaaaaaaaaaaaaaaaaaaaaaaabacacacacacacacacacadaeaeaeaeaeafagagagagagagagagagagagab
abababababababaaaaaaaaaaaaaaaaaaaaaaaaaaaaabacacacacacacacacacaeaeaeaeaeaeaeagagagagagagagagagagagab
abahaiajakalabaaaaaaaaaaaaaaaaaaaaaaaaaaaaabacacacacacacacacacadaeaeaeaeaeafagagagagagagagagagagagab
abamanakaoakababababababababaaaaaaaaaaaaaaabacacacacacacacacacadaeaeaeaeaeafagagagagagagagagagagagab
ababapakakakadadaqarasatadabababababababababadadadadadadadadadadadadadadadadadadadadadadadadadadadab
aaabakakakakauadavasawaxadayazaAaBagaCasaDadasasasasasasasasasasasasasasasasasasasasasasasasasasasab
aaabakaEadadadadavaFasaGadaHaIaIaIagawawasadasasasasasasasasasasasasasasasasasasasasasasasasasasasab
aaabakapadakaJadavawasaxadaKaLaIaMagasaNasadasasasasasasasasasasasasasasasasasasasasasasasasasasasab
aaabakaOadakaPadavasaQatadaRaLaIaSagaCaTawadadadadadadadadadadadadadadadadadadadadadadadadaUadadadab
ababaVadadaVadadadaWadadadagagagagagawaCaDadawawawadadawadawawawadawadawawawadawawawawadawaXawadadab
abaCawaCaCaCaCawawawaCawawaCaCaCaCawawawaYadawawawadadawawawawawadawawawawawawawawawawadawawawadadab
abaVadadaVadadaCadadadadadadadadadadaZaCawadadawadadadawadawawawadawadadawawadawawawawadawawawadadab
abbabbadakbcadawadbdbeadbfbgadbhbgadaCaCbibjawawawawadawadadadadadawadawawadadawadawawadadawadadadab
abbkbladbmbnadboadakbpadakakadakakadasadaDadadadadawadawawawawawawawadadawadadawadawawadadawadadadab
abadadadadadadawadaVadadaVadadaVadadadadaCadawawadawadawadadadadadawadadadadadawadawawadawawawadadab
abadadbqbradadaCbsbtbtbubtbvbwbtbxbyadaCaCadawawawawadawadawawawadawadawawawadawawawawadawawawadadab
abbzadbxbxbxadbtbtbxbxbxbtbxbAbtbtbxadaCawadawawadawadawawawawawadawadawawawadawadawawadawawawadadab
abaCbBbCbtbtbtbDbxbxbxbxbxbEbtbFbtaCaCbGaDadadadadawadawadawawawadawadawawawadawadbHbHbHbHawbHbHbHab
abadadbIadadadadbJadadadadadbKadadadbLbGbvadawawawawawawadadadadadawadawawawawawadbHbMbMbMbMbMbMbMab
abbNawbObPbQadbRbPbSadbTbUawawawbVadbWbGbXadawawadadawawadawawawawawadadadadadawadbHbMbMbMbMbMbMbMab
abbYbZbPawadadcaawcbadadawbPbPccadadadbKadadadadadadadawadawawawawadadawadadawawadbHbMbMbMcdbMbMbMab
abceawbsawadcfawcgawawbPbPchawciadcjckcjclcjadawawawawawadawawawawadawawawadawadadbHbMbMbMbMbMbMbMab
abbPbPawcmcncoawbZbPbPababababababcjcjcpcjcjadawawawawawadawawawawadawawawawawadadbHbMbMbMbMbMbMbMab
abceawcqcradcsctcucvcwabaaaaaaaaabcjcjcjcjcjadawawawawadadawawawawawawawawadawadadbHbMbMbMbMbMbMbMab
ababababababababababababaaaaaaaaababcxababababababababababababababababababababababababababababababab
"}
