"aa" = (/turf/space,/area)
"ab" = (/turf/simulated/wall/invulnerable/r_wall,/area)
"ac" = (/obj/machinery/computer/fluff/medical,/turf/simulated/floor/carpet,/area)
"ad" = (/obj/structure/table/woodentable,/obj/item/weapon/folder/white,/turf/simulated/floor/carpet,/area)
"ae" = (/obj/structure/table/woodentable,/obj/item/weapon/paper_bin{pixel_x = 1; pixel_y = 9},/obj/item/weapon/pen,/turf/simulated/floor/carpet,/area)
"af" = (/turf/simulated/floor/carpet,/area)
"ag" = (/obj/structure/bed,/obj/item/weapon/bedsheet/black,/obj/structure/curtain/open/bed,/turf/simulated/floor/carpet,/area)
"ah" = (/obj/machinery/computer/fluff/communications,/turf/simulated/floor/carpet,/area)
"ai" = (/obj/structure/bed/chair/office/light{dir = 8},/turf/simulated/floor/carpet,/area)
"aj" = (/obj/effect/gibspawner/blood,/turf/simulated/floor/carpet,/area)
"ak" = (/obj/structure/table/woodentable,/turf/simulated/floor/carpet,/area)
"al" = (/turf/simulated/wall,/area)
"am" = (/obj/structure/bed,/obj/structure/curtain/open/left,/turf/simulated/floor/plating,/area)
"an" = (/obj/structure/sign/chinese/notice{pixel_y = 32},/turf/simulated/floor,/area)
"ao" = (/turf/simulated/floor,/area)
"ap" = (/obj/structure/bed,/obj/structure/curtain/open/right,/turf/simulated/floor/plating,/area)
"aq" = (/obj/structure/closet/secure_closet/personal/cabinet,/obj/item/clothing/under/rank/research_director,/turf/simulated/floor/carpet,/area)
"ar" = (/obj/structure/bed,/obj/structure/curtain/open/left,/turf/simulated/floor,/area)
"as" = (/turf/simulated/floor/plating,/area)
"at" = (/obj/structure/bed,/obj/structure/curtain/open/right,/turf/simulated/floor,/area)
"au" = (/obj/structure/flora/pottedplant/random,/turf/simulated/floor/wood,/area)
"av" = (/obj/structure/table/woodentable,/obj/machinery/microwave,/turf/simulated/floor/wood,/area)
"aw" = (/obj/structure/table/woodentable,/obj/item/weapon/storage/box/donkpockets,/obj/item/weapon/storage/box/donkpockets{pixel_x = 2; pixel_y = 3},/turf/simulated/floor/wood,/area)
"ax" = (/obj/machinery/light/small{dir = 1},/obj/machinery/vending/coffee,/turf/simulated/floor/wood,/area)
"ay" = (/turf/simulated/floor/wood,/area)
"az" = (/turf/simulated/floor{icon_state = "dark"},/area)
"aA" = (/obj/machinery/light/small{dir = 4; on = 1},/turf/simulated/floor/plating,/area)
"aB" = (/obj/structure/table/woodentable,/obj/item/clothing/mask/scarf,/turf/simulated/floor/carpet,/area)
"aC" = (/mob/living/simple_animal/hostile/giant_spider/hunter,/turf/simulated/floor,/area)
"aD" = (/obj/structure/bed,/obj/structure/curtain/closed,/turf/simulated/floor,/area)
"aE" = (/obj/structure/table/woodentable,/obj/item/device/flashlight/lamp/green{on = 0; pixel_x = -3; pixel_y = 8},/turf/simulated/floor/wood,/area)
"aF" = (/turf/simulated/floor/glass,/area)
"aG" = (/obj/structure/bed,/obj/item/weapon/bedsheet/brown,/obj/structure/curtain/open/bed,/turf/simulated/floor/carpet,/area)
"aH" = (/obj/structure/table/woodentable,/obj/machinery/computer/security/telescreen/entertainment{pixel_x = -32},/obj/item/weapon/reagent_containers/food/drinks/coffee,/turf/simulated/floor/wood,/area)
"aI" = (/obj/structure/bed/chair/comfy/black{dir = 4},/turf/simulated/floor/glass,/area)
"aJ" = (/obj/structure/bed/chair/comfy/couch/right/black{dir = 8},/turf/simulated/floor/glass,/area)
"aK" = (/obj/effect/landmark/corpse/scientist,/turf/simulated/floor{icon_state = "dark"},/area)
"aL" = (/obj/structure/coatrack,/turf/simulated/floor/carpet,/area)
"aM" = (/obj/structure/closet/secure_closet/personal/cabinet,/obj/item/clothing/under/rank/scientist,/turf/simulated/floor/carpet,/area)
"aN" = (/obj/structure/sign/chinese/notice{pixel_x = 0; pixel_y = -32},/turf/simulated/floor,/area)
"aO" = (/obj/structure/table/woodentable,/obj/machinery/light/small{dir = 8; flickering = 1},/turf/simulated/floor/wood,/area)
"aP" = (/obj/structure/bed/chair/comfy/couch/left/black{dir = 8},/turf/simulated/floor/glass,/area)
"aQ" = (/obj/effect/decal/cleanable/blood,/turf/simulated/floor{icon_state = "dark"},/area)
"aR" = (/obj/machinery/door/mineral/wood{name = "Wooden Door"},/turf/simulated/floor/carpet,/area)
"aS" = (/obj/machinery/door/airlock/security{name = "Subject Residence"},/turf/simulated/floor/plating,/area)
"aT" = (/obj/abstract/map/spawner/maint,/turf/simulated/floor/plating,/area)
"aU" = (/obj/structure/rack,/obj/abstract/map/spawner/assistant/tools,/turf/simulated/floor/plating,/area)
"aV" = (/obj/abstract/map/spawner/assistant/materials,/turf/simulated/floor/plating,/area)
"aW" = (/obj/abstract/map/spawner/assistant/tools,/turf/simulated/floor/plating,/area)
"aX" = (/obj/machinery/light/small{dir = 4},/turf/simulated/floor/plating,/area)
"aY" = (/obj/machinery/light{dir = 1},/turf/simulated/floor/plating,/area)
"aZ" = (/mob/living/simple_animal/hostile/giant_spider/hunter,/turf/simulated/floor/plating,/area)
"ba" = (/obj/effect/decal/cleanable/blood,/turf/simulated/floor/plating,/area)
"bb" = (/obj/structure/window/barricade,/mob/living/simple_animal/hostile/giant_spider/hunter,/turf/simulated/floor/plating,/area)
"bc" = (/obj/structure/window/barricade/full,/turf/simulated/floor/plating,/area)
"bd" = (/obj/machinery/door/poddoor{desc = "A pair of heavy reinforced plasteel doors."; id_tag = "maintblastdoor"; name = "Blast Door"},/turf/simulated/floor/plating,/area)
"be" = (/obj/structure/girder,/turf/simulated/floor/plating,/area)
"bf" = (/obj/structure/rack,/obj/abstract/map/spawner/assistant/materials,/turf/simulated/floor/plating,/area)
"bg" = (/obj/item/weapon/paper{info = "This was a mistake.  I'm so sorry for what I've taken part in."; name = "suicide note"},/turf/simulated/floor/carpet,/area)
"bh" = (/obj/item/weapon/pen,/obj/item/ammo_casing/a357,/turf/simulated/floor/carpet,/area)
"bi" = (/obj/item/clothing/under/maid,/turf/simulated/floor/carpet,/area)
"bj" = (/obj/structure/closet/secure_closet/personal/cabinet,/obj/item/clothing/suit/wintercoat/cmo,/turf/simulated/floor/carpet,/area)
"bk" = (/obj/structure/bed,/obj/item/weapon/bedsheet/red,/obj/structure/curtain/open/bed,/obj/item/weapon/paper{info = "Remember: feed the assistants on time so they don't go feral.  Last time there was nearly a breach."; name = "note"},/turf/simulated/floor/carpet,/area)
"bl" = (/obj/structure/closet/secure_closet/personal/cabinet,/obj/item/clothing/under/bluepants,/turf/simulated/floor/carpet,/area)
"bm" = (/obj/structure/bed,/obj/item/weapon/bedsheet/red,/obj/structure/curtain/open/bed,/turf/simulated/floor/carpet,/area)
"bn" = (/obj/structure/closet/secure_closet/personal/cabinet,/obj/item/clothing/under/custom/N3X15/robotics,/turf/simulated/floor/carpet,/area)
"bo" = (/obj/machinery/door_control{desc = "escape button"; id_tag = "escapebutton"; name = "Escape button"; pixel_x = 27; pixel_y = 27; req_access_txt = "0"},/turf/simulated/floor/plating,/area)
"bp" = (/obj/machinery/door/poddoor{desc = "A pair of heavy reinforced plasteel doors."; id_tag = "maintblastdoor"; name = "Blast Door"},/turf/simulated/floor{icon_state = "dark"},/area)
"bq" = (/obj/structure/closet/secure_closet/personal/cabinet,/obj/item/clothing/under/rank/scientist,/obj/item/clothing/under/rank/scientist,/turf/simulated/floor/carpet,/area)
"br" = (/obj/structure/bed,/obj/item/weapon/bedsheet/green,/obj/structure/curtain/open/bed,/obj/effect/landmark/corpse/scientist,/obj/item/weapon/gun/projectile/detective,/turf/simulated/floor/carpet,/area)
"bs" = (/obj/item/weapon/bedsheet/green,/turf/simulated/floor/carpet,/area)
"bt" = (/obj/structure/bed,/obj/structure/curtain/open/bed,/turf/simulated/floor/carpet,/area)
"bu" = (/obj/machinery/light/small{dir = 8},/turf/simulated/floor{icon_state = "dark"},/area)
"bv" = (/obj/item/weapon/pen,/turf/simulated/floor/carpet,/area)
"bw" = (/obj/structure/window/barricade{dir = 8},/turf/simulated/floor/plating,/area)
"bx" = (/obj/machinery/light/small,/turf/simulated/floor/plating,/area)
"by" = (/obj/machinery/light/small{dir = 1},/turf/simulated/floor/plating,/area)
"bz" = (/obj/structure/window/barricade,/turf/simulated/floor/plating,/area)
"bA" = (/obj/structure/table,/obj/machinery/computer/med_data/laptop,/turf/simulated/floor/plating,/area)
"bB" = (/obj/machinery/light/small{dir = 1},/turf/simulated/floor{icon_state = "dark"},/area)
"bC" = (/obj/effect/landmark/corpse/scientist,/obj/effect/gibspawner/blood,/turf/simulated/floor/plating,/area)
"bD" = (/obj/abstract/map/spawner/misc/trash,/turf/simulated/floor{icon_state = "dark"},/area)
"bE" = (/obj/machinery/light/small{dir = 1},/obj/abstract/map/spawner/misc/trash,/turf/simulated/floor{icon_state = "dark"},/area)
"bF" = (/obj/structure/table/flipped,/turf/simulated/floor/plating,/area)
"bG" = (/obj/machinery/light/small{dir = 1},/obj/abstract/map/spawner/misc/trash,/turf/simulated/floor/plating,/area)
"bH" = (/obj/abstract/map/spawner/misc/trash,/turf/simulated/floor/plating,/area)
"bI" = (/obj/machinery/light/small{dir = 1},/obj/structure/table,/turf/simulated/floor/plating,/area)
"bJ" = (/obj/structure/table,/obj/abstract/map/spawner/highrisk,/turf/simulated/floor/plating,/area)
"bK" = (/obj/machinery/door_control{desc = "Danger within."; id_tag = "maintblastdoor"; name = "Containment Control"; pixel_x = 27; pixel_y = 27; req_access_txt = "0"},/obj/abstract/map/spawner/assistant/materials,/obj/structure/table,/turf/simulated/floor/plating,/area)
"bL" = (/obj/structure/table,/turf/simulated/floor/plating,/area)
"bM" = (/obj/structure/table,/obj/item/weapon/paper_bin{pixel_x = 1; pixel_y = 9},/obj/item/weapon/pen,/turf/simulated/floor{icon_state = "dark"},/area)
"bN" = (/obj/item/weapon/extinguisher,/obj/abstract/map/spawner/misc/trash,/turf/simulated/floor/plating,/area)
"bO" = (/obj/abstract/map/spawner/assistant/materials,/obj/abstract/map/spawner/assistant/materials,/turf/simulated/floor/plating,/area)
"bP" = (/obj/abstract/map/spawner/assistant/tools,/mob/living/simple_animal/hostile/giant_spider/hunter,/turf/simulated/floor/plating,/area)
"bQ" = (/obj/abstract/map/spawner/assistant/materials,/mob/living/simple_animal/hostile/giant_spider/hunter,/turf/simulated/floor/plating,/area)
"bR" = (/obj/abstract/map/spawner/misc/trash,/turf/simulated/floor{icon_state = "whitehall"},/area)
"bS" = (/obj/structure/window/barricade,/obj/abstract/map/spawner/misc/trash,/turf/simulated/floor/plating,/area)
"bT" = (/obj/structure/table/flipped,/turf/simulated/floor{icon_state = "dark"},/area)
"bU" = (/obj/structure/sign/redcross{pixel_y = -32},/obj/abstract/map/spawner/misc/trash,/turf/simulated/floor/plating,/area)
"bV" = (/obj/structure/sign/redcross{pixel_y = -32},/obj/abstract/map/spawner/misc/trash,/turf/simulated/floor{icon_state = "dark"},/area)
"bW" = (/obj/effect/plantsegment,/turf/simulated/floor{icon_state = "dark"},/area)
"bX" = (/turf/simulated/wall/mineral/uranium,/area)
"bY" = (/obj/structure/window/reinforced,/obj/structure/window/reinforced{dir = 4},/obj/structure/window/reinforced{dir = 8},/obj/structure/window/reinforced{dir = 1},/obj/structure/grille,/obj/structure/window/full/reinforced,/obj/structure/window/barricade/full/block,/turf/simulated/floor/plating,/area)
"bZ" = (/obj/structure/window/reinforced,/obj/structure/window/reinforced{dir = 4},/obj/structure/window/reinforced{dir = 8},/obj/structure/window/reinforced{dir = 1},/obj/structure/grille,/obj/structure/window/full/reinforced,/turf/simulated/floor/plating,/area)
"ca" = (/obj/machinery/door/airlock/glass_medical{id_tag = ""; name = "Medical Research"; req_access_txt = "5"},/turf/simulated/floor/plating,/area)
"cb" = (/obj/structure/sign/chinese/medbay{pixel_x = -32; pixel_y = 0},/obj/effect/plantsegment,/turf/simulated/floor{icon_state = "dark"},/area)
"cc" = (/turf/simulated/floor/mineral/uranium,/area)
"cd" = (/obj/structure/bed,/obj/item/weapon/bedsheet/medical,/obj/structure/curtain/open/left,/turf/simulated/floor{dir = 5; icon_state = "bluefull"},/area)
"ce" = (/obj/structure/bed,/obj/item/weapon/bedsheet/medical,/obj/structure/curtain/open/right,/turf/simulated/floor{dir = 5; icon_state = "bluefull"},/area)
"cf" = (/turf/simulated/floor{dir = 5; icon_state = "bluefull"},/area)
"cg" = (/obj/item/weapon/storage/firstaid/internalbleed,/turf/simulated/floor{dir = 5; icon_state = "bluefull"},/area)
"ch" = (/obj/machinery/sleeper{dir = 1; icon_state = "sleeper_0"},/turf/simulated/floor{dir = 5; icon_state = "bluefull"},/area)
"ci" = (/obj/machinery/sleeper,/turf/simulated/floor{dir = 5; icon_state = "bluefull"},/area)
"cj" = (/obj/structure/table,/obj/item/weapon/storage/firstaid/toxin{pixel_x = 2; pixel_y = 6},/obj/item/weapon/storage/firstaid/radiation,/turf/simulated/floor{dir = 5; icon_state = "bluefull"},/area)
"ck" = (/obj/item/weapon/storage/firstaid/toxin{pixel_x = -2; pixel_y = 4},/turf/simulated/floor{dir = 5; icon_state = "bluefull"},/area)
"cl" = (/obj/structure/rack,/obj/item/clothing/suit/straight_jacket,/obj/item/clothing/mask/muzzle,/turf/simulated/floor{dir = 5; icon_state = "bluefull"},/area)
"cm" = (/obj/effect/plantsegment,/obj/machinery/light/small{dir = 8},/turf/simulated/floor/plating,/area)
"cn" = (/obj/structure/flora/pottedplant/random,/turf/simulated/floor/plating,/area)
"co" = (/obj/abstract/map/spawner/maint,/mob/living/simple_animal/hostile/giant_spider/hunter,/turf/simulated/floor/plating,/area)
"cp" = (/obj/machinery/light{dir = 8},/turf/simulated/floor{dir = 5; icon_state = "bluefull"},/area)
"cq" = (/obj/item/weapon/storage/firstaid/radiation,/turf/simulated/floor/plating,/area)
"cr" = (/obj/item/weapon/storage/firstaid/toxin,/turf/simulated/floor{dir = 5; icon_state = "bluefull"},/area)
"cs" = (/obj/effect/landmark/corpse/scientist,/turf/simulated/floor{dir = 5; icon_state = "bluefull"},/area)
"ct" = (/obj/structure/rack,/obj/item/clothing/suit/straight_jacket,/obj/item/clothing/mask/muzzle,/turf/simulated/floor/plating,/area)
"cu" = (/obj/structure/table,/obj/abstract/map/spawner/theater/costumes,/turf/simulated/floor/plating,/area)
"cv" = (/obj/structure/altar,/turf/simulated/floor/mineral/uranium,/area)
"cw" = (/obj/structure/bed,/obj/structure/curtain/medical,/obj/item/weapon/bedsheet/medical,/mob/living/simple_animal/hostile/giant_spider/hunter,/turf/simulated/floor{dir = 5; icon_state = "bluefull"},/area)
"cx" = (/obj/machinery/iv_drip,/turf/simulated/floor{dir = 5; icon_state = "bluefull"},/area)
"cy" = (/obj/item/device/flashlight/pen,/turf/simulated/floor/plating,/area)
"cz" = (/obj/machinery/light,/turf/simulated/floor{dir = 5; icon_state = "bluefull"},/area)
"cA" = (/obj/structure/rack,/obj/item/clothing/suit/straight_jacket,/obj/item/clothing/mask/muzzle,/turf/simulated/floor{icon_state = "whitebluecorner"; dir = 1},/area)
"cB" = (/obj/item/weapon/tank/jetpack/oxygen,/turf/simulated/floor/plating,/area)
"cC" = (/obj/structure/sign/chinese/access_restricted{pixel_x = 0; pixel_y = 32},/turf/simulated/floor/plating,/area)
"cD" = (/obj/structure/sign/nosmoking_1{pixel_y = 32},/turf/simulated/floor{icon_state = "dark"},/area)
"cE" = (/obj/machinery/atmospherics/unary/tank/oxygen,/turf/simulated/floor{icon_state = "dark"},/area)
"cF" = (/obj/structure/rack,/obj/abstract/map/spawner/assistant/materials,/obj/abstract/map/spawner/assistant/tools,/turf/simulated/floor/plating,/area)
"cG" = (/obj/machinery/light/small{dir = 8},/turf/simulated/floor/plating,/area)
"cH" = (/obj/structure/table,/obj/abstract/map/spawner/maint,/turf/simulated/floor/plating,/area)
"cI" = (/obj/abstract/map/spawner/assistant/tools,/obj/machinery/light/small{dir = 4},/turf/simulated/floor/plating,/area)
"cJ" = (/obj/item/weapon/shard,/turf/simulated/floor{dir = 5; icon_state = "bluefull"},/area)
"cK" = (/obj/structure/window/reinforced,/obj/structure/window/reinforced{dir = 4},/obj/structure/window/reinforced{dir = 1},/obj/structure/grille,/obj/structure/window/full/reinforced,/obj/structure/window/barricade/full/block,/obj/item/weapon/shard,/turf/simulated/floor/plating,/area)
"cL" = (/obj/machinery/portable_atmospherics/canister/oxygen,/obj/item/weapon/tank/oxygen,/turf/simulated/floor/plating,/area)
"cM" = (/obj/structure/ladder/mutant_den/bottom,/turf/simulated/floor{icon_state = "dark"},/area)
"cN" = (/obj/machinery/atmospherics/unary/tank/nitrogen,/turf/simulated/floor/plating,/area)
"cO" = (/obj/abstract/map/spawner/assistant/tools,/obj/machinery/light/small{dir = 8; flickering = 1},/obj/abstract/map/spawner/maint,/turf/simulated/floor/plating,/area)
"cP" = (/obj/structure/rack,/obj/abstract/map/spawner/maint,/turf/simulated/floor/plating,/area)
"cQ" = (/obj/structure/rack,/obj/machinery/light,/obj/item/device/flashlight/pen,/turf/simulated/floor{dir = 5; icon_state = "bluefull"},/area)
"cR" = (/obj/structure/rack,/obj/item/weapon/storage/firstaid/toxin,/turf/simulated/floor{dir = 5; icon_state = "bluefull"},/area)
"cS" = (/obj/machinery/smartfridge/bloodbank,/turf/simulated/floor{dir = 5; icon_state = "bluefull"},/area)
"cT" = (/obj/machinery/bodyscanner,/turf/simulated/floor{dir = 5; icon_state = "bluefull"},/area)
"cU" = (/obj/machinery/iv_drip,/obj/machinery/light,/turf/simulated/floor{dir = 5; icon_state = "bluefull"},/area)
"cV" = (/obj/machinery/bodyscanner{dir = 1},/turf/simulated/floor{dir = 5; icon_state = "bluefull"},/area)
"cW" = (/obj/machinery/smartfridge/chemistry,/turf/simulated/floor{dir = 5; icon_state = "bluefull"},/area)
"cX" = (/obj/machinery/suit_storage_unit/standard_unit,/turf/simulated/floor{icon_state = "dark"},/area)
"cY" = (/obj/machinery/suit_storage_unit/standard_unit,/turf/simulated/floor/plating,/area)
"cZ" = (/obj/machinery/atmospherics/unary/tank/nitrogen,/turf/simulated/floor{icon_state = "dark"},/area)
"da" = (/turf/simulated/wall/invulnerable/r_wall,/area/maintenance/aft)

(1,1,1) = {"
aaaaaaaaaaaaaaaaaaaaaaaaaaaaaaaaaaaaaaaaaaaaaaaaaaaaaaaaaaaaaaaaaaaaaaaaaaaaaaaaaaaaaaaaaaaaaaaaaaaa
aaaaaaaaaaaaaaaaaaaaaaaaaaaaaaaaaaaaaaaaaaaaaaaaaaaaaaaaaaaaaaaaaaaaaaaaaaaaaaaaaaaaaaaaaaaaaaaaaaaa
aaaaaaaaaaaaaaaaaaaaaaaaaaaaaaaaaaaaaaaaaaaaaaaaaaaaaaaaaaaaaaaaaaaaaaaaaaaaaaaaaaaaaaaaaaaaaaaaaaaa
aaaaaaaaaaaaaaaaaaaaaaaaaaaaaaaaaaaaaaaaaaaaaaaaaaaaaaaaaaaaaaaaaaaaaaaaaaaaaaaaaaaaaaaaaaaaaaaaaaaa
aaaaaaaaaaaaaaaaaaaaaaaaaaaaaaaaaaaaaaaaaaaaaaaaaaaaaaaaaaaaaaaaaaaaaaaaaaaaaaaaaaaaaaaaaaaaaaaaaaaa
aaaaaaaaaaaaaaaaaaaaaaaaaaaaaaaaaaaaaaaaaaaaaaaaaaaaaaaaaaaaaaaaaaaaaaaaaaaaaaaaaaaaaaaaaaaaaaaaaaaa
abababababababaaaaaaaaaaaaaaaaaaaaaaaaaaaaaaaaaaaaaaaaaaaaaaaaaaaaaaaaaaaaaaaaaaaaaaaaaaaaaaaaaaaaaa
abacadaeafagabaaaaaaaaaaaaaaaaaaaaaaaaaaaaaaaaaaaaaaaaaaaaaaaaaaaaaaaaaaaaaaaaaaaaaaaaaaaaaaaaaaaaaa
abahaiafajafababababababababaaaaaaaaaaaaaaaaaaaaaaaaaaaaaaaaaaaaaaaaaaaaaaaaaaaaaaaaaaaaaaaaaaaaaaaa
ababakafafafalalamanaoapalabababababababababaaaaaaaaaaaaaaaaaaaaaaaaaaaaaaaaaaaaaaaaaaaaaaaaaaaaaaaa
aaabafafafafaqalaraoasatalauavawaxayazaoaAabaaaaaaaaaaaaaaaaaaaaaaaaaaaaaaaaaaaaaaaaaaaaaaaaaaaaaaaa
aaabafaBalalalalaraCaoaDalaEaFaFaFayasasaoabaaaaaaaaaaaaaaaaaaaaaaaaaaaaaaaaaaaaaaaaaaaaaaaaaaaaaaaa
aaabafakalafaGalarasaoatalaHaIaFaJayaoaKaoabaaaaaaaaaaaaaaaaaaaaaaaaaaaaaaaaaaaaaaaaaaaaaaaaaaaaaaaa
aaabafaLalafaMalaraoaNapalaOaIaFaPayazaQasababababababababababababababababababababababababababababab
ababaRalalaRalalalaSalalalayayayayayasazaAalaTaUaValasaTalasasaWalaXalasaTaTalasasaYaZalasasasalalab
abazasazazazazasasasazasasazazazazasasasbaalaVbbasalasasasaVaTaZalasasaTasasbcasasasasbdasasasalalab
abaRalalaRalalazalalalalalalalalalalbeazasalalaAalalalasalaUbfbfalaTalalasasalasasasasalasasasalalab
abbgbhalafbialasalbjbkalblbmalbnbmalazazbobpasasasasalasalalalalalasalasasasalasalaZasalalasalalalab
abbqbralbsbtalbualafbvalafafalafafalaoalaAalalalalasalasbwbxasasasbcalalasalalasalasasalalasalalalab
abalalalalalalasalaRalalaRalalaRalalalalazalaWbyalbzalasalalalalalasalalalalalasalasasalasasasalalab
abalalbAbBalalazbCbDbDbEbDbFbGbDbHbIalazazalaTaZasasalasalaWaUaTalasalbJbKbLalasbcasasalasasasalalab
abbMalbHbHbHalbDbDbHbHbHbDbHbNbDbDbHalazasalaVbOalasalasasasbPbfalasalbQbQasalaXalasasalasasasalalab
abazbRbSbDbDbDbTbHbHbHbHbHbUbDbVbDazazbWaAalalalalasalasalbfaVaValasalaVasaValasalbXbXbXbXasbXbXbXab
abalalbYalalalalbZalalalalalcaalalalcbbWbFalaTaTasaTasasalalalalalbcalasasasbcasalbXccccccccccccccab
abcdascecfcgalchcfcialcjckasasasclalcmbWcnalcoaTalalasasalasasasasasalalalalalasalbXccccccccccccccab
abcpcqcfasalalcrascsalalascfcfctalalalcaalalalalalalalbcalascubLasalalbPalalasasalbXcccccccvccccccab
abcwasbCasalcxascyasascfcfczascAalcBcCascDcEalcFcFcFasasalcGcHcHasalaUaTcIalasalalbXccccccccccccccab
abcfcfascJcKbwascqcfcfababababababcLascMazcNalcOaZasasasalasbLcuasalcPaVaVbcasalalbXccccccccccccccab
abcwascQcRalcScTcUcVcWabaaaaaaaaabazcXazcYcZalaVaWaTaWalalasaZasasasasasbfalasalalbXccccccccccccccab
ababababababababababababaaaaaaaaababdaababababababababababababababababababababababababababababababab
"}
