"aa" = (/turf/simulated/wall/invulnerable/r_wall,/area)
"ab" = (/turf/simulated/floor/carpet,/area)
"ac" = (/obj/structure/bed,/turf/simulated/floor/carpet,/area)
"ad" = (/turf/simulated/wall,/area)
"ae" = (/turf/simulated/floor,/area)
"af" = (/turf/simulated/floor{icon_state = "whitegreen"},/area)
"ag" = (/turf/simulated/floor{icon_state = "cafeteria"; dir = 5},/area)
"ah" = (/obj/structure/table/reinforced,/turf/simulated/floor{icon_state = "cafeteria"; dir = 5},/area)
"ai" = (/turf/simulated/floor/wood,/area)
"aj" = (/turf/simulated/floor/plating,/area)
"ak" = (/turf/simulated/floor{icon_state = "dark"},/area)
"al" = (/obj/structure/bed,/obj/item/weapon/bedsheet/red,/turf/simulated/floor/carpet,/area)
"am" = (/obj/structure/bed,/obj/item/weapon/bedsheet/green,/turf/simulated/floor/carpet,/area)
"an" = (/obj/item/weapon/bedsheet/green,/turf/simulated/floor/carpet,/area)
"ao" = (/obj/machinery/light/small{dir = 8},/turf/simulated/floor{icon_state = "dark"},/area)
"ap" = (/obj/machinery/door/mineral/wood,/turf/simulated/floor/carpet,/area)
"aq" = (/obj/structure/table,/turf/simulated/floor/plating,/area)
"ar" = (/obj/machinery/light/small{dir = 1},/turf/simulated/floor{icon_state = "dark"},/area)
"as" = (/obj/machinery/light/small{dir = 1},/turf/simulated/floor/plating,/area)
"at" = (/obj/structure/table,/turf/simulated/floor{icon_state = "dark"},/area)
"au" = (/turf/simulated/floor{icon_state = "whitehall"},/area)
"av" = (/obj/structure/window/barricade,/turf/simulated/floor/plating,/area)
"aw" = (/turf/simulated/wall/mineral/uranium,/area)
"ax" = (/obj/structure/window/reinforced,/obj/structure/window/reinforced{dir = 4},/obj/structure/window/reinforced{dir = 8},/obj/structure/window/reinforced{dir = 1},/obj/structure/grille,/obj/structure/window/full/reinforced,/obj/structure/window/barricade/full/block,/turf/simulated/floor/plating,/area)
"ay" = (/obj/structure/window/reinforced,/obj/structure/window/reinforced{dir = 4},/obj/structure/window/reinforced{dir = 8},/obj/structure/window/reinforced{dir = 1},/obj/structure/grille,/obj/structure/window/full/reinforced,/turf/simulated/floor/plating,/area)
"az" = (/obj/machinery/door/airlock/glass_medical{id_tag = ""; name = "Medical Research"; req_access_txt = "5"},/turf/simulated/floor/plating,/area)
"aA" = (/turf/simulated/floor/mineral/uranium,/area)
"aB" = (/obj/structure/bed,/obj/item/weapon/bedsheet/medical,/obj/structure/curtain/open/left,/turf/simulated/floor{dir = 5; icon_state = "bluefull"},/area)
"aC" = (/obj/structure/bed,/obj/item/weapon/bedsheet/medical,/obj/structure/curtain/open/right,/turf/simulated/floor{dir = 5; icon_state = "bluefull"},/area)
"aD" = (/turf/simulated/floor{dir = 5; icon_state = "bluefull"},/area)
"aE" = (/obj/item/weapon/storage/firstaid/internalbleed,/turf/simulated/floor{dir = 5; icon_state = "bluefull"},/area)
"aF" = (/obj/machinery/sleeper{dir = 1; icon_state = "sleeper_0"},/turf/simulated/floor{dir = 5; icon_state = "bluefull"},/area)
"aG" = (/obj/machinery/sleeper,/turf/simulated/floor{dir = 5; icon_state = "bluefull"},/area)
"aH" = (/obj/structure/table,/obj/item/weapon/storage/firstaid/toxin{pixel_x = 2; pixel_y = 6},/obj/item/weapon/storage/firstaid/radiation,/turf/simulated/floor{dir = 5; icon_state = "bluefull"},/area)
"aI" = (/obj/item/weapon/storage/firstaid/toxin{pixel_x = -2; pixel_y = 4},/turf/simulated/floor{dir = 5; icon_state = "bluefull"},/area)
"aJ" = (/obj/structure/rack,/obj/item/clothing/suit/straight_jacket,/obj/item/clothing/mask/muzzle,/turf/simulated/floor{dir = 5; icon_state = "bluefull"},/area)
"aK" = (/obj/machinery/light{dir = 8},/turf/simulated/floor{dir = 5; icon_state = "bluefull"},/area)
"aL" = (/obj/item/weapon/storage/firstaid/radiation,/turf/simulated/floor/plating,/area)
"aM" = (/obj/item/weapon/storage/firstaid/toxin,/turf/simulated/floor{dir = 5; icon_state = "bluefull"},/area)
"aN" = (/obj/structure/rack,/obj/item/clothing/suit/straight_jacket,/obj/item/clothing/mask/muzzle,/turf/simulated/floor/plating,/area)
"aO" = (/obj/structure/altar,/turf/simulated/floor/mineral/uranium,/area)
"aP" = (/obj/structure/bed,/obj/structure/curtain/medical,/obj/item/weapon/bedsheet/medical,/mob/living/simple_animal/hostile/giant_spider/hunter,/turf/simulated/floor{dir = 5; icon_state = "bluefull"},/area)
"aQ" = (/obj/machinery/iv_drip,/turf/simulated/floor{dir = 5; icon_state = "bluefull"},/area)
"aR" = (/obj/machinery/light,/turf/simulated/floor{dir = 5; icon_state = "bluefull"},/area)
"aS" = (/obj/structure/rack,/obj/item/clothing/suit/straight_jacket,/obj/item/clothing/mask/muzzle,/turf/simulated/floor{icon_state = "whitebluecorner"; dir = 1},/area)
"aT" = (/turf/unsimulated/floor/airless,/area)
"aU" = (/obj/item/weapon/shard,/turf/simulated/floor{dir = 5; icon_state = "bluefull"},/area)
"aV" = (/obj/structure/window/reinforced,/obj/structure/window/reinforced{dir = 4},/obj/structure/window/reinforced{dir = 1},/obj/structure/grille,/obj/structure/window/full/reinforced,/obj/structure/window/barricade/full/block,/obj/item/weapon/shard,/turf/simulated/floor/plating,/area)
"aW" = (/obj/structure/window/barricade{dir = 8},/turf/simulated/floor/plating,/area)
"aX" = (/obj/structure/ladder/mutant_den/bottom,/turf/unsimulated/floor/airless,/area)
"aY" = (/obj/structure/rack,/obj/machinery/light,/turf/simulated/floor{dir = 5; icon_state = "bluefull"},/area)
"aZ" = (/obj/item/weapon/storage/firstaid/toxin,/obj/structure/rack,/turf/simulated/floor{dir = 5; icon_state = "bluefull"},/area)
"ba" = (/obj/machinery/smartfridge/bloodbank,/turf/simulated/floor{dir = 5; icon_state = "bluefull"},/area)
"bb" = (/obj/machinery/bodyscanner,/turf/simulated/floor{dir = 5; icon_state = "bluefull"},/area)
"bc" = (/obj/machinery/iv_drip,/obj/machinery/light,/turf/simulated/floor{dir = 5; icon_state = "bluefull"},/area)
"bd" = (/obj/machinery/bodyscanner{dir = 1},/turf/simulated/floor{dir = 5; icon_state = "bluefull"},/area)
"be" = (/obj/machinery/smartfridge/chemistry,/turf/simulated/floor{dir = 5; icon_state = "bluefull"},/area)
"bf" = (/turf/space,/area)
"bg" = (/obj/machinery/atmospherics/pipe/simple/supply/hidden{dir = 4},/obj/structure/cable/white{d1 = 4; d2 = 8; icon_state = "4-8"},/obj/machinery/light,/turf/simulated/floor{icon_state = "white"},/area)
"bh" = (/turf/simulated/wall/invulnerable/r_wall,/area/maintenance/aft)

(1,1,1) = {"
aaaaaaaaaaaaaaaaaaaaaaaaaaaaaaaaaaaaaaaaaaaaaaaaaaaaaaaaaaaaaaaaaaaaaaaaaaaaaaaaaaaaaaaaaaaaaaaaaaaa
aaabacadabacadabacadaeaeaeadabababadaeaeaeadafafafafafafafafafadagagagagagahaiaiaiaiaiaiaiaiaiaiaiaa
aaababadababadababadaeaeaeabababacadaeaeaeadafafafafafafafafafagagagagagagahaiaiaiaiaiaiaiaiaiaiaiaa
aaabadadabadadabadadaeaeaeadabababadaeaeaeadafafafafafafafafafadagagagagagahaiaiaiaiaiaiaiaiaiaiaiaa
aaaeaeaeaeaeaeaeaeaeaeaeaeadadadadadaeaeaeadafafafafafafafafafadagagagagagahaiaiaiaiaiaiaiaiaiaiaiaa
aaaeaeaeaeaeaeaeaeaeaeaeaeadacabacadaeaeaeadafafafafafafafafafadagagagagagahaiaiaiaiaiaiaiaiaiaiaiaa
aaabadadabadadabadadaeaeaeadacabacadaeaeaeadafafafafafafafafafagagagagagagagaiaiaiaiaiaiaiaiaiaiaiaa
aaababadababadababadaeaeaeadacabacadaeaeaeadafafafafafafafafafadagagagagagahaiaiaiaiaiaiaiaiaiaiaiaa
aaabacadabacadabacadaeaeaeadabababadaeaeaeadafafafafafafafafafadagagagagagahaiaiaiaiaiaiaiaiaiaiaiaa
aaadadadadadadadadadaeaeaeabababababaeaeaeadadadadadadadadadadadadadadadadadadadadadadadadadadadadaa
aaabacadabacadabacadaeaeaeadabababadaeaeaeaeaeaeaeaeaeaeaeaeaeaeaeaeaeaeaeaeaeaeaeaeaeaeaeaeaeaeaeaa
aaababadababadababadaeaeaeadacabacadaeaeaeaeaeaeaeaeaeaeaeaeaeaeaeaeaeaeaeaeaeaeaeaeaeaeaeaeaeaeaeaa
aaabadadabadadabadadaeaeaeadacabacadaeaeaeaeaeaeaeaeaeaeaeaeaeaeaeaeaeaeaeaeaeaeaeaeaeaeaeaeaeaeaeaa
aaaeaeaeaeaeaeaeaeaeaeaeaeadacabacadaeaeaeadadadadadadadadadadadadadadadadadadadadadadadadajadadadaa
aaaeaeaeaeaeaeaeaeaeaeaeaeadadadadadaeaeaeadajajajadadajadajajajadajadajajajadajajajajadajajajadadaa
aaaeaeaeaeaeaeaeaeaeaeaeaeaeaeaeaeaeaeaeaeadajajajadadajajajajajadajajajajajajajajajajadajajajadadaa
aaabadadabadadakadadadadadadadadadadaeaeaeadadajadadadajadajajajadajadadajajadajajajajadajajajadadaa
aaababadababadajadabaladabaladabaladaeaeajajajajajajadajadadadadadajadajajadadajadajajadadajadadadaa
aaabamadanacadaoadababadababadababadaeadajadadadadajadajajajajajajajadadajadadajadajajadadajadadadaa
aaadadadadadadajadapadadapadadapadadadadakadajajadajadajadadadadadajadadadadadajadajajadajajajadadaa
aaadadaqaradadakajakakarakajasakajasadakakadajajajajadajadajajajadajadajajajadajajajajadajajajadadaa
aaatadajajajadakakajajajakajajakakajadakajadajajadajadajajajajajadajadajajajadajadajajadajajajadadaa
aaakauavakakakakajajajajajajakakakakakakajadadadadajadajadajajajadajadajajajadajadawawawawajawawawaa
aaadadaxadadadadayadadadadadazadadadakakajadajajajajajajadadadadadajadajajajajajadawaAaAaAaAaAaAaAaa
aaaBajaCaDaEadaFaDaGadaHaIajajajaJadajakajadajajadadajajadajajajajajadadadadadajadawaAaAaAaAaAaAaAaa
aaaKaLaDajadadaMajaDadadajaDaDaNadadadazadadadadadadadajadajajajajadadajadadajajadawaAaAaAaOaAaAaAaa
aaaPajajajadaQajajajajaDaDaRajaSadaTaTaTaTaTadajajajajajadajajajajadajajajadajadadawaAaAaAaAaAaAaAaa
aaaDaDajaUaVaWajaLaDaDaaaaaaaaaaaaaTaTaXaTaTadajajajajajadajajajajadajajajajajadadawaAaAaAaAaAaAaAaa
aaaPajaYaZadbabbbcbdbeaabfbfbfbfaaaTaTaTaTaTadajajajajadadajajajajajajajajadajadadawaAaAaAaAaAaAaAaa
aaaaaaaaaaaaaaaaaaaaaaaabfbfbgbfaaaabhaaaaaaaaaaaaaaaaaaaaaaaaaaaaaaaaaaaaaaaaaaaaaaaaaaaaaaaaaaaaaa
"}
