//MAP CONVERTED BY dmm2tgm.py THIS HEADER COMMENT PREVENTS RECONVERSION, DO NOT REMOVE
"aa" = (
/turf/space,
/area)
"ab" = (
/obj/structure/catwalk{
	icon_state = "catwalk4"
	},
/turf/space,
/area/vault/oldarmory)
"ac" = (
/obj/structure/catwalk{
	icon_state = "catwalk12"
	},
/obj/effect/decal/cleanable/blood,
/turf/space,
/area/vault/oldarmory)
"ad" = (
/obj/structure/catwalk{
	icon_state = "catwalk8"
	},
/turf/space,
/area/vault/oldarmory)
"af" = (
/obj/machinery/door/airlock/highsecurity{
	name = "SECURE FACILITY"
	},
/turf/simulated/floor/plating,
/area/vault/oldarmory)
"ai" = (
/obj/effect/decal/cleanable/blood/drip,
/turf/simulated/floor/plating,
/area/vault/oldarmory)
"ak" = (
/obj/structure/sign/vacuum,
/obj/structure/grille/window_spawner/reinforced_plasma/full,
/turf/space,
/area/vault/oldarmory)
"am" = (
/obj/effect/decal/remains/human,
/turf/simulated/floor/plating,
/area/vault/oldarmory)
"ao" = (
/turf/simulated/floor/plating,
/area/vault/oldarmory)
"ap" = (
/obj/structure/grille/window_spawner/reinforced_plasma/full,
/turf/space,
/area/vault/oldarmory)
"aq" = (
/turf/simulated/wall/shuttle/unsmoothed{
	dir = 8;
	icon_state = "diagonalWall3"
	},
/area/vault/oldarmory)
"ar" = (
/turf/simulated/wall/invulnerable,
/area/vault/oldarmory)
"as" = (
/obj/structure/sign/securearea,
/turf/simulated/wall/invulnerable,
/area/vault/oldarmory)
"at" = (
/obj/machinery/door/airlock/highsecurity{
	locked = 1;
	name = "SECURE FACILITY"
	},
/turf/simulated/floor/plating,
/area/vault/oldarmory)
"au" = (
/turf/simulated/wall/shuttle/unsmoothed{
	dir = 1;
	icon_state = "diagonalWall3"
	},
/area/vault/oldarmory)
"av" = (
/obj/machinery/sweet,
/turf/simulated/floor/shuttle/brig,
/area/vault/oldarmory)
"aw" = (
/obj/machinery/vending/nuka,
/turf/simulated/floor/shuttle/brig,
/area/vault/oldarmory)
"ax" = (
/obj/machinery/vending/snack,
/turf/simulated/floor/shuttle/brig,
/area/vault/oldarmory)
"ay" = (
/obj/structure/reagent_dispensers/water_cooler,
/turf/simulated/floor/shuttle/brig,
/area/vault/oldarmory)
"az" = (
/obj/structure/table,
/obj/machinery/microwave,
/turf/simulated/floor/shuttle/brig,
/area/vault/oldarmory)
"aA" = (
/obj/structure/table,
/obj/item/weapon/storage/box/donkpockets,
/turf/simulated/floor/shuttle/brig,
/area/vault/oldarmory)
"aB" = (
/turf/simulated/wall,
/area/vault/oldarmory)
"aC" = (
/obj/structure/flora/pottedplant,
/turf/simulated/floor/shuttle/brig,
/area/vault/oldarmory)
"aD" = (
/turf/simulated/floor/shuttle/brig,
/area/vault/oldarmory)
"aE" = (
/obj/structure/bed,
/obj/item/weapon/bedsheet/red/redcoat,
/turf/simulated/floor/shuttle/brig,
/area/vault/oldarmory)
"aF" = (
/obj/machinery/light{
	dir = 1
	},
/turf/simulated/floor/shuttle/brig,
/area/vault/oldarmory)
"aG" = (
/obj/structure/painting/random,
/turf/simulated/wall/invulnerable,
/area/vault/oldarmory)
"aH" = (
/obj/structure/bed/chair,
/turf/simulated/floor/shuttle/brig,
/area/vault/oldarmory)
"aI" = (
/obj/structure/bed/chair,
/mob/living/simple_animal/hostile/humanoid/syndicate/ranged/laser,
/turf/simulated/floor/shuttle/brig,
/area/vault/oldarmory)
"aJ" = (
/obj/item/trash/syndi_cakes,
/turf/simulated/floor/shuttle/brig,
/area/vault/oldarmory)
"aK" = (
/obj/structure/bed/chair/wood/normal,
/turf/simulated/floor/shuttle/brig,
/area/vault/oldarmory)
"aL" = (
/obj/machinery/light{
	dir = 4
	},
/turf/simulated/floor/shuttle/brig,
/area/vault/oldarmory)
"aM" = (
/obj/machinery/light{
	dir = 8
	},
/turf/simulated/floor/shuttle/brig,
/area/vault/oldarmory)
"aN" = (
/obj/item/weapon/beach_ball,
/turf/simulated/floor/shuttle/brig,
/area/vault/oldarmory)
"aO" = (
/obj/structure/bookcase{
	name = "bookcase (Tactics)"
	},
/obj/item/weapon/book/manual/nuclear,
/turf/simulated/floor/shuttle/brig,
/area/vault/oldarmory)
"aP" = (
/obj/machinery/vending/coffee,
/turf/simulated/floor/shuttle/brig,
/area/vault/oldarmory)
"aQ" = (
/obj/structure/bed/chair{
	dir = 4
	},
/turf/simulated/floor/shuttle/brig,
/area/vault/oldarmory)
"aR" = (
/obj/structure/table,
/obj/item/trash/plate,
/turf/simulated/floor/shuttle/brig,
/area/vault/oldarmory)
"aS" = (
/obj/structure/table,
/obj/item/weapon/reagent_containers/food/drinks/soda_cans/quantum,
/turf/simulated/floor/shuttle/brig,
/area/vault/oldarmory)
"aT" = (
/obj/structure/bed/chair{
	dir = 8
	},
/turf/simulated/floor/shuttle/brig,
/area/vault/oldarmory)
"aU" = (
/obj/structure/table/woodentable/poker,
/obj/item/toy/cards/wizard/full,
/obj/item/toy/cards/wizard/full,
/turf/simulated/floor/shuttle/brig,
/area/vault/oldarmory)
"aV" = (
/obj/machinery/door/airlock{
	name = "Canteen"
	},
/turf/simulated/floor/shuttle/brig,
/area/vault/oldarmory)
"aW" = (
/obj/machinery/vending/cola,
/turf/simulated/floor/shuttle/brig,
/area/vault/oldarmory)
"aX" = (
/obj/structure/bed/chair{
	dir = 1
	},
/turf/simulated/floor/shuttle/brig,
/area/vault/oldarmory)
"aY" = (
/obj/structure/bed/chair/wood/normal{
	dir = 1
	},
/turf/simulated/floor/shuttle/brig,
/area/vault/oldarmory)
"aZ" = (
/obj/structure/dispenser/oxygen,
/turf/simulated/floor/shuttle/brig,
/area/vault/oldarmory)
"ba" = (
/obj/structure/table/woodentable,
/obj/item/device/flashlight/lamp,
/turf/simulated/floor/shuttle/brig,
/area/vault/oldarmory)
"bb" = (
/obj/effect/decal/cleanable/blood/gibs,
/turf/simulated/floor/shuttle/brig,
/area/vault/oldarmory)
"bd" = (
/obj/structure/noticeboard,
/turf/simulated/wall,
/area/vault/oldarmory)
"be" = (
/obj/machinery/computer/security/telescreen/entertainment,
/turf/simulated/wall,
/area/vault/oldarmory)
"bf" = (
/obj/structure/sign/poster{
	icon_state = "poster5";
	tag = "icon-poster5"
	},
/turf/simulated/wall,
/area/vault/oldarmory)
"bg" = (
/obj/machinery/computer/arcade,
/turf/simulated/floor/shuttle/brig,
/area/vault/oldarmory)
"bh" = (
/obj/structure/closet/crate/bin,
/turf/simulated/floor/shuttle/brig,
/area/vault/oldarmory)
"bi" = (
/obj/machinery/light{
	dir = 1
	},
/obj/item/trash/chips,
/turf/simulated/floor/shuttle/brig,
/area/vault/oldarmory)
"bj" = (
/mob/living/simple_animal/hostile/humanoid/syndicate/ranged{
	anchored = 1;
	name = "Syndicate Sentry"
	},
/turf/simulated/floor/shuttle/brig,
/area/vault/oldarmory)
"bk" = (
/obj/structure/grille/window_spawner/reinforced/full,
/turf/simulated/floor/shuttle/brig,
/area/vault/oldarmory)
"bl" = (
/obj/machinery/door/airlock{
	name = "Dormitory"
	},
/turf/simulated/floor/shuttle/brig,
/area/vault/oldarmory)
"bm" = (
/obj/machinery/vending/cigarette,
/turf/simulated/floor/shuttle/brig,
/area/vault/oldarmory)
"bn" = (
/mob/living/simple_animal/hostile/humanoid/syndicate/ranged/laser,
/turf/simulated/floor/shuttle/brig,
/area/vault/oldarmory)
"bo" = (
/obj/structure/mirror,
/turf/simulated/wall,
/area/vault/oldarmory)
"bp" = (
/obj/structure/sink{
	dir = 8;
	pixel_x = -11
	},
/turf/simulated/floor{
	icon_state = "freezerfloor"
	},
/area/vault/oldarmory)
"bq" = (
/obj/machinery/light{
	dir = 1
	},
/turf/simulated/floor{
	icon_state = "freezerfloor"
	},
/area/vault/oldarmory)
"br" = (
/obj/machinery/door/airlock{
	locked = 1;
	name = "Toilet"
	},
/turf/simulated/floor{
	icon_state = "freezerfloor"
	},
/area/vault/oldarmory)
"bs" = (
/obj/structure/toilet{
	dir = 8
	},
/obj/machinery/light/small{
	dir = 1
	},
/mob/living/simple_animal/hostile/humanoid/syndicate/melee,
/turf/simulated/floor{
	icon_state = "freezerfloor"
	},
/area/vault/oldarmory)
"bt" = (
/mob/living/simple_animal/hostile/humanoid/syndicate/melee,
/turf/simulated/floor/shuttle/brig,
/area/vault/oldarmory)
"bu" = (
/obj/machinery/door{
	name = "Bathroom"
	},
/turf/simulated/floor{
	icon_state = "freezerfloor"
	},
/area/vault/oldarmory)
"bv" = (
/turf/simulated/floor{
	icon_state = "freezerfloor"
	},
/area/vault/oldarmory)
"bw" = (
/obj/item/weapon/soap/syndie,
/turf/simulated/floor{
	icon_state = "freezerfloor"
	},
/area/vault/oldarmory)
"bx" = (
/turf/simulated/wall/r_wall,
/area/vault/oldarmory)
"bz" = (
/obj/structure/grille/window_spawner/reinforced_plasma/full,
/turf/simulated/floor/shuttle/brig,
/area/vault/oldarmory)
"bB" = (
/obj/machinery/door/airlock/glass_security{
	name = "Armory";
	req_access_txt = "3"
	},
/turf/simulated/floor/shuttle/brig,
/area/vault/oldarmory)
"bC" = (
/obj/structure/sign/goldenplaque,
/turf/simulated/wall/r_wall,
/area/vault/oldarmory)
"bD" = (
/obj/machinery/door/airlock/command{
	name = "Situation Room"
	},
/turf/simulated/floor/shuttle/brig,
/area/vault/oldarmory)
"bE" = (
/obj/machinery/door/airlock{
	name = "Toilet"
	},
/turf/simulated/floor{
	icon_state = "freezerfloor"
	},
/area/vault/oldarmory)
"bF" = (
/obj/structure/toilet{
	dir = 8
	},
/obj/machinery/light/small,
/turf/simulated/floor{
	icon_state = "freezerfloor"
	},
/area/vault/oldarmory)
"bG" = (
/obj/structure/closet/crate,
/obj/item/target,
/obj/item/target,
/obj/item/target,
/turf/simulated/floor/shuttle/brig,
/area/vault/oldarmory)
"bH" = (
/obj/machinery/light,
/turf/simulated/floor{
	icon_state = "freezerfloor"
	},
/area/vault/oldarmory)
"bI" = (
/obj/machinery/light{
	dir = 8
	},
/obj/structure/closet/syndicate{
	desc = "It's a basic storage unit. In red.";
	name = "Spare Space Suit"
	},
/obj/item/clothing/head/helmet/space/syndicate,
/obj/item/clothing/suit/space/syndicate,
/obj/item/weapon/tank/jetpack/oxygen,
/obj/item/clothing/mask/gas/syndicate,
/obj/item/clothing/shoes/magboots,
/turf/simulated/floor/shuttle/brig,
/area/vault/oldarmory)
"bJ" = (
/mob/living/simple_animal/hostile/humanoid/syndicate/ranged/space,
/turf/simulated/floor/shuttle/brig,
/area/vault/oldarmory)
"bK" = (
/obj/structure/bed/chair,
/mob/living/simple_animal/hostile/humanoid/syndicate/melee/space,
/turf/simulated/floor/shuttle/brig,
/area/vault/oldarmory)
"bL" = (
/obj/structure/closet/syndicate{
	desc = "There's a note on it. It says: 'Do our guns even use all of this?'";
	name = "Ammo Storage"
	},
/obj/item/ammo_storage/speedloader/a357,
/obj/item/ammo_storage/box/c45,
/obj/item/ammo_storage/box/BMG50,
/obj/item/ammo_storage/magazine/a762,
/turf/simulated/floor/shuttle/brig,
/area/vault/oldarmory)
"bM" = (
/obj/structure/target_stake{
	anchored = 1
	},
/turf/simulated/floor/shuttle/brig,
/area/vault/oldarmory)
"bN" = (
/obj/structure/table/reinforced{
	icon_state = "table"
	},
/obj/item/weapon/phone,
/turf/simulated/floor/shuttle/brig,
/area/vault/oldarmory)
"bO" = (
/obj/structure/table/reinforced{
	icon_state = "table"
	},
/obj/item/weapon/paper_bin,
/turf/simulated/floor/shuttle/brig,
/area/vault/oldarmory)
"bP" = (
/obj/structure/extinguisher_cabinet,
/turf/simulated/wall,
/area/vault/oldarmory)
"bQ" = (
/obj/machinery/vending/autodrobe,
/turf/simulated/floor/shuttle/brig,
/area/vault/oldarmory)
"bR" = (
/obj/structure/closet,
/obj/item/clothing/head/helmet/dredd,
/obj/item/clothing/suit/armor/dredd,
/turf/simulated/floor/shuttle/brig,
/area/vault/oldarmory)
"bS" = (
/obj/structure/rack,
/obj/abstract/map/spawner/space/weapons2,
/obj/abstract/map/spawner/space/weapons2,
/turf/simulated/floor/shuttle/brig,
/area/vault/oldarmory)
"bT" = (
/obj/structure/rack,
/obj/abstract/map/spawner/security/armor,
/obj/abstract/map/spawner/security/armor,
/turf/simulated/floor/shuttle/brig,
/area/vault/oldarmory)
"bU" = (
/obj/structure/rack,
/obj/abstract/map/spawner/security/weapons,
/obj/abstract/map/spawner/security/weapons,
/turf/simulated/floor/shuttle/brig,
/area/vault/oldarmory)
"bV" = (
/obj/structure/rack,
/obj/item/device/batterer,
/obj/item/weapon/gun/grenadelauncher,
/obj/item/weapon/storage/box/emps,
/turf/simulated/floor/shuttle/brig,
/area/vault/oldarmory)
"bW" = (
/obj/structure/bed/chair{
	dir = 4
	},
/mob/living/simple_animal/hostile/humanoid/syndicate/ranged/space,
/turf/simulated/floor/shuttle/brig,
/area/vault/oldarmory)
"bX" = (
/obj/structure/table/reinforced{
	icon_state = "table"
	},
/obj/item/trash/syndi_cakes,
/turf/simulated/floor/shuttle/brig,
/area/vault/oldarmory)
"bY" = (
/obj/structure/table/reinforced{
	icon_state = "table"
	},
/obj/item/weapon/pen/sleepypen,
/turf/simulated/floor/shuttle/brig,
/area/vault/oldarmory)
"bZ" = (
/obj/structure/bed/chair{
	dir = 8
	},
/mob/living/simple_animal/hostile/humanoid/syndicate/ranged/space,
/turf/simulated/floor/shuttle/brig,
/area/vault/oldarmory)
"ca" = (
/obj/machinery/door/airlock{
	name = "Disguises"
	},
/turf/simulated/floor/shuttle/brig,
/area/vault/oldarmory)
"cb" = (
/obj/structure/closet/gimmick/tacticool,
/turf/simulated/floor/shuttle/brig,
/area/vault/oldarmory)
"cc" = (
/obj/structure/closet,
/obj/item/clothing/head/helmet/volnutthelmet,
/obj/item/clothing/suit/armor/volnutt,
/obj/item/weapon/gun/energy/mmlbuster,
/turf/simulated/floor/shuttle/brig,
/area/vault/oldarmory)
"cd" = (
/obj/machinery/turret/portable{
	dir = 4;
	emagged = 1
	},
/turf/simulated/floor/shuttle/brig,
/area/vault/oldarmory)
"ce" = (
/obj/structure/sign/securearea,
/turf/simulated/wall/r_wall,
/area/vault/oldarmory)
"cf" = (
/obj/structure/painting/random,
/turf/simulated/wall/r_wall,
/area/vault/oldarmory)
"cg" = (
/obj/machinery/door/airlock/command{
	name = "Computer Chamber"
	},
/turf/simulated/floor/shuttle/brig,
/area/vault/oldarmory)
"ch" = (
/obj/machinery/vending/wallmed1,
/turf/simulated/wall/r_wall,
/area/vault/oldarmory)
"ci" = (
/obj/machinery/vending/suitdispenser,
/turf/simulated/floor/shuttle/brig,
/area/vault/oldarmory)
"cj" = (
/obj/structure/safe,
/obj/item/toy/gasha/newcop,
/obj/item/toy/syndicateballoon,
/turf/simulated/floor/shuttle/brig,
/area/vault/oldarmory)
"ck" = (
/obj/machinery/door/airlock/vault{
	locked = 1;
	name = "Communications Relay"
	},
/turf/simulated/floor/shuttle/brig,
/area/vault/oldarmory)
"cl" = (
/obj/machinery/vending/shoedispenser,
/turf/simulated/floor/shuttle/brig,
/area/vault/oldarmory)
"cm" = (
/obj/machinery/syndicate_beacon{
	desc = "This seems to be what the Syndicate agents here are using to communicate with their leaders. Maybe they'd be willing to hire you?";
	name = "Syndicate Communications Relay"
	},
/turf/simulated/floor/shuttle/brig,
/area/vault/oldarmory)
"cn" = (
/obj/structure/bed/chair,
/mob/living/simple_animal/hostile/humanoid/syndicate/ranged/space,
/turf/simulated/floor/shuttle/brig,
/area/vault/oldarmory)
"co" = (
/obj/machinery/vending/hatdispenser,
/turf/simulated/floor/shuttle/brig,
/area/vault/oldarmory)
"cp" = (
/turf/simulated/wall/shuttle/unsmoothed{
	icon_state = "diagonalWall3"
	},
/area/vault/oldarmory)
"cq" = (
/obj/machinery/light,
/turf/simulated/floor/shuttle/brig,
/area/vault/oldarmory)
"cr" = (
/obj/structure/table/reinforced,
/obj/machinery/recharger,
/turf/simulated/floor/shuttle/brig,
/area/vault/oldarmory)
"cs" = (
/obj/machinery/computer/security/engineering,
/turf/simulated/floor/shuttle/brig,
/area/vault/oldarmory)
"ct" = (
/obj/machinery/computer/security/mining,
/turf/simulated/floor/shuttle/brig,
/area/vault/oldarmory)
"cu" = (
/obj/machinery/computer/station_alert,
/turf/simulated/floor/shuttle/brig,
/area/vault/oldarmory)
"cv" = (
/obj/machinery/computer/atmos_alert,
/turf/simulated/floor/shuttle/brig,
/area/vault/oldarmory)
"cw" = (
/obj/machinery/computer/crew,
/turf/simulated/floor/shuttle/brig,
/area/vault/oldarmory)
"cx" = (
/obj/machinery/computer/secure_data,
/turf/simulated/floor/shuttle/brig,
/area/vault/oldarmory)
"cy" = (
/obj/machinery/computer/security,
/turf/simulated/floor/shuttle/brig,
/area/vault/oldarmory)
"cz" = (
/obj/structure/rack,
/obj/item/clothing/mask/fakemoustache,
/obj/item/clothing/mask/fakemoustache,
/obj/item/clothing/mask/fakemoustache,
/obj/item/clothing/mask/fakemoustache,
/obj/item/clothing/mask/fakemoustache,
/turf/simulated/floor/shuttle/brig,
/area/vault/oldarmory)
"cA" = (
/obj/structure/rack,
/obj/item/clothing/head/helmet/doomguy,
/obj/item/clothing/shoes/doomguy,
/obj/item/clothing/suit/armor/doomguy,
/obj/item/clothing/under/doomguy,
/obj/item/weapon/storage/belt/security/doomguy,
/obj/item/clothing/gloves/doomguy,
/turf/simulated/floor/shuttle/brig,
/area/vault/oldarmory)
"cB" = (
/turf/simulated/wall/shuttle/unsmoothed{
	dir = 4;
	icon_state = "diagonalWall3"
	},
/area/vault/oldarmory)

(1,1,1) = {"
aa
aa
aa
aa
aa
aa
aa
aa
aa
aa
aa
aa
aa
aa
aa
aa
aa
aa
aa
aa
aa
aa
aa
aa
aa
aa
aa
aa
aa
aa
"}
(2,1,1) = {"
aa
aa
aa
aa
aa
aa
aa
aa
aa
aa
aa
aa
aa
aa
aa
aq
ar
ar
ar
ar
ar
ar
ar
ar
ar
ar
ar
ar
cp
aa
"}
(3,1,1) = {"
aa
aa
aa
aa
aa
aa
aa
aa
aa
aa
aa
aa
aa
aa
aq
ar
ar
bm
aM
bx
bG
bI
bL
aD
bx
aD
aD
ar
ar
cp
"}
(4,1,1) = {"
aa
aa
aa
aa
aa
aa
aa
aa
aa
aa
aa
aa
aa
aq
ar
ar
bh
aD
aD
bx
aD
aD
bM
aD
bx
aD
cj
aD
ar
ar
"}
(5,1,1) = {"
aa
aa
aa
aa
aa
aa
aa
aa
aa
aa
aa
aa
aq
ar
ar
aB
bi
aD
aD
bz
aD
bJ
aD
aD
bx
aD
aD
aD
aD
ar
"}
(6,1,1) = {"
aa
aa
aa
aa
aa
aa
aa
aa
aa
aa
aa
aq
ar
aP
aW
aB
aD
aD
aD
bz
aD
aD
bM
aD
bx
aD
aD
cm
aD
ar
"}
(7,1,1) = {"
aa
aa
aa
aa
aa
aa
aa
aa
aa
aa
aq
ar
aD
aQ
aD
bk
aD
bn
aD
bz
aD
aD
aD
aD
bx
cd
aD
aD
cd
ar
"}
(8,1,1) = {"
aa
aa
aa
aa
aa
aa
aa
aa
aa
aa
ar
av
aH
aR
aX
aB
aD
aD
aD
bx
aD
aD
bJ
aD
bx
aD
aD
aD
aD
ar
"}
(9,1,1) = {"
aa
aa
aa
aa
aa
aa
aa
aa
aa
aa
ar
aw
aI
aS
aX
aB
aF
aD
aD
bB
aD
aD
aD
aD
bx
aF
aD
aD
cq
ar
"}
(10,1,1) = {"
aa
aa
aa
aa
aa
aa
aa
aa
aa
aa
ar
ax
aJ
aT
aD
aV
aD
aD
aD
bx
aD
aD
aD
bS
bx
aD
aD
aD
aD
ar
"}
(11,1,1) = {"
aa
aa
aa
aa
aa
aa
aa
aa
aa
aa
ar
ay
aD
aD
aD
bd
aD
aD
aD
bz
aD
aD
aD
bT
bx
aD
aD
aD
aD
ar
"}
(12,1,1) = {"
aa
aa
aa
aa
aa
aa
aa
aa
aa
aa
ar
az
aK
aU
aY
bk
aD
aD
bt
bz
aD
bn
aD
bU
bx
cd
aD
aD
cd
ar
"}
(13,1,1) = {"
aa
aa
aa
aa
aa
aa
aa
aa
aa
aa
ar
aA
aL
aD
aD
be
aD
aD
aD
bz
aD
aL
aD
bV
bx
aD
aD
aD
aD
ar
"}
(14,1,1) = {"
aa
aa
aa
aa
aa
aa
aa
aa
aa
aa
ar
aB
aB
aV
aB
bf
aD
aD
aD
bx
bx
bx
bx
bx
bx
ce
ck
ce
bx
ar
"}
(15,1,1) = {"
aa
aa
aa
ab
ap
ap
ak
ap
ap
ap
as
aC
aM
aD
aD
aD
bj
aD
aD
bx
aD
aD
aD
aD
aD
bx
aD
aM
cr
ar
"}
(16,1,1) = {"
aa
aa
aa
ac
af
ai
ai
ai
am
ao
at
aD
aD
aD
aD
aD
aD
aD
aD
bx
aF
aD
aD
aD
aD
bx
aD
aH
cs
ar
"}
(17,1,1) = {"
aa
aa
aa
ad
ap
ap
ak
ap
ap
ap
as
aC
aL
aD
aZ
aD
bj
aD
aD
bC
aD
aD
aQ
bW
aD
cf
aD
aH
ct
ar
"}
(18,1,1) = {"
aa
aa
aa
aa
aa
aa
aa
aa
aa
aa
ar
aB
aB
aB
aB
bf
aB
aD
aD
bx
aC
bK
bN
bX
aD
bx
aD
bK
cu
ar
"}
(19,1,1) = {"
aa
aa
aa
aa
aa
aa
aa
aa
aa
aa
ar
aD
aN
aD
aD
aD
aB
aF
aD
bD
aD
bK
bO
bY
aD
cg
aD
cn
cv
ar
"}
(20,1,1) = {"
aa
aa
aa
aa
aa
aa
aa
aa
aa
aa
ar
aE
aE
aE
aE
aD
bk
aD
bt
bx
aC
aD
aT
bZ
aD
bx
aD
aH
cw
ar
"}
(21,1,1) = {"
aa
aa
aa
aa
aa
aa
aa
aa
aa
aa
ar
aF
aD
aD
aD
aD
bl
aD
aD
bx
aD
aD
aD
aD
aD
bx
aD
aH
cx
ar
"}
(22,1,1) = {"
aa
aa
aa
aa
aa
aa
aa
aa
aa
aa
ar
aE
aE
aE
aE
aD
bk
aD
aD
bx
aF
aD
aD
aD
aD
ch
aD
aH
cy
ar
"}
(23,1,1) = {"
aa
aa
aa
aa
aa
aa
aa
aa
aa
aa
ar
aG
aD
aD
aD
aD
aB
aD
aD
bx
aD
aD
aD
aD
aD
bx
aD
aL
aD
ar
"}
(24,1,1) = {"
aa
aa
aa
aa
aa
aa
aa
aa
aa
aa
au
ar
aO
aD
ba
bb
aB
bo
bu
aB
bo
aB
bP
ca
aB
aB
aB
aB
aB
ar
"}
(25,1,1) = {"
aa
aa
aa
aa
aa
aa
aa
aa
aa
aa
aa
au
ar
aD
bb
bb
aB
bp
bv
bv
bp
aB
aD
aD
aD
aM
aD
aD
cz
ar
"}
(26,1,1) = {"
aa
aa
aa
aa
aa
aa
aa
aa
aa
aa
aa
aa
au
ar
ar
bg
aB
bq
bw
bv
bH
aB
bQ
aD
aD
aD
aD
aD
cA
ar
"}
(27,1,1) = {"
aa
aa
aa
aa
aa
aa
aa
aa
aa
aa
aa
aa
aa
au
ar
ar
aB
br
aB
bE
aB
aB
aD
aD
bn
aD
aD
co
ar
ar
"}
(28,1,1) = {"
aa
aa
aa
aa
aa
aa
aa
aa
aa
aa
aa
aa
aa
aa
au
ar
ar
bs
aB
bF
aB
aD
bR
cb
cc
ci
cl
ar
ar
cB
"}
(29,1,1) = {"
aa
aa
aa
aa
aa
aa
aa
aa
aa
aa
aa
aa
aa
aa
aa
au
ar
ar
ar
ar
ar
ar
ar
ar
ar
ar
ar
ar
cB
aa
"}
(30,1,1) = {"
aa
aa
aa
aa
aa
aa
aa
aa
aa
aa
aa
aa
aa
aa
aa
aa
aa
aa
aa
aa
aa
aa
aa
aa
aa
aa
aa
aa
aa
aa
"}
