"a" = (/turf/space,/area)
"b" = (/obj/structure/sign/securearea,/turf/simulated/wall/r_wall,/area/vault/oldarmory)
"c" = (/obj/machinery/door/airlock/vault,/turf/simulated/floor/plating,/area/vault/oldarmory)
"d" = (/turf/simulated/wall/r_wall,/area/vault/oldarmory)
"e" = (/turf/simulated/floor/plating,/area/vault/oldarmory)
"f" = (/obj/machinery/light/built,/turf/simulated/wall/r_wall,/area/vault/oldarmory)
"g" = (/obj/structure/window/reinforced,/turf/simulated/floor/plating,/area/vault/oldarmory)
"h" = (/obj/structure/rack,/obj/item/clothing/head/helmet/space/ancient,/obj/item/clothing/suit/space/ancient,/turf/simulated/floor/plating,/area/vault/oldarmory)
"i" = (/obj/machinery/door/window,/turf/simulated/floor/plating,/area/vault/oldarmory)
"j" = (/obj/structure/rack,/obj/item/weapon/storage/belt/skull,/obj/item/weapon/sord,/turf/simulated/floor/plating,/area/vault/oldarmory)
"k" = (/obj/structure/window/reinforced{dir = 1},/obj/structure/rack,/obj/item/clothing/suit/armor/xcomsquaddie/dredd,/obj/item/clothing/head/helmet/swat/dredd,/obj/item/clothing/gloves/combat,/turf/simulated/floor/plating,/area/vault/oldarmory)
"l" = (/obj/structure/window/reinforced{dir = 1},/turf/simulated/floor/plating,/area/vault/oldarmory)
"m" = (/obj/structure/window/reinforced{dir = 1},/obj/machinery/door/window,/turf/simulated/floor/plating,/area/vault/oldarmory)
"n" = (/mob/living/simple_animal/hostile/humanoid/syndicate/melee/space,/turf/simulated/floor/plating,/area/vault/oldarmory)
"o" = (/obj/structure/rack,/obj/structure/window/reinforced{dir = 1},/obj/item/clothing/suit/space/syndicate/black,/obj/item/clothing/head/helmet/space/syndicate/black,/turf/simulated/floor/plating,/area/vault/oldarmory)
"p" = (/obj/structure/window/reinforced,/obj/machinery/door/window,/turf/simulated/floor/plating,/area/vault/oldarmory)
"q" = (/obj/structure/rack,/obj/item/clothing/head/helmet/space/rig/t51b,/obj/item/clothing/suit/space/rig/t51b,/turf/simulated/floor/plating,/area/vault/oldarmory)
"r" = (/obj/structure/rack,/obj/item/clothing/head/helmet/volnutthelmet,/obj/item/clothing/suit/armor/volnutt,/obj/item/weapon/gun/energy/mmlbuster,/turf/simulated/floor/plating,/area/vault/oldarmory)
"s" = (/mob/living/simple_animal/hostile/humanoid/syndicate/ranged/space,/turf/simulated/floor/plating,/area/vault/oldarmory)
"t" = (/obj/structure/rack,/obj/item/weapon/gun/projectile/pistol,/obj/item/weapon/gun/projectile/silenced,/obj/item/weapon/gun/projectile/automatic/mini_uzi,/turf/simulated/floor/plating,/area/vault/oldarmory)
"u" = (/obj/structure/rack,/obj/item/weapon/gun/energy/mindflayer,/obj/item/weapon/gun/energy/radgun,/turf/simulated/floor/plating,/area/vault/oldarmory)
"v" = (/obj/structure/rack,/obj/item/weapon/gun/grenadelauncher,/obj/item/weapon/gun/projectile/deagle/camo,/obj/item/weapon/gun/hookshot,/turf/simulated/floor/plating,/area/vault/oldarmory)
"w" = (/obj/structure/rack,/obj/item/weapon/grenade/spawnergrenade/spesscarp,/obj/item/weapon/grenade/chem_grenade/incendiary,/obj/item/weapon/grenade/flashbang/clusterbang,/obj/item/weapon/grenade/spawnergrenade/beenade,/turf/simulated/floor/plating,/area/vault/oldarmory)
"x" = (/obj/structure/rack,/obj/item/weapon/gun/energy/xray,/obj/item/weapon/gun/projectile/shotgun/pump/combat,/turf/simulated/floor/plating,/area/vault/oldarmory)
"y" = (/obj/machinery/light{step_y = 0},/turf/simulated/floor/plating,/area/vault/oldarmory)
"z" = (/obj/structure/rack,/obj/item/device/batterer,/obj/item/weapon/gun/projectile/nagant,/obj/item/clothing/gloves/knuckles/spiked,/turf/simulated/floor/plating,/area/vault/oldarmory)
"A" = (/obj/structure/closet/gimmick/tacticool,/turf/simulated/floor/plating,/area/vault/oldarmory)
"B" = (/obj/structure/rack,/obj/item/ammo_storage/magazine/a50,/obj/item/ammo_storage/magazine/a50,/obj/item/ammo_storage/box/c45,/obj/item/ammo_storage/box/c45,/obj/item/ammo_storage/box/c12mm,/obj/item/ammo_storage/box/c12mm,/turf/simulated/floor/plating,/area/vault/oldarmory)
"C" = (/obj/machinery/light{step_y = 1},/turf/simulated/floor/plating,/area/vault/oldarmory)
"D" = (/obj/structure/rack,/obj/item/ammo_storage/box/b762x55,/obj/item/ammo_storage/speedloader/a762x55,/obj/item/ammo_storage/box/c9mm,/obj/item/ammo_storage/box/c9mm,/obj/item/ammo_storage/box/b762x55,/obj/item/ammo_storage/magazine/uzi45,/obj/item/ammo_storage/box/c45,/turf/simulated/floor/plating,/area/vault/oldarmory)

(1,1,1) = {"
aaaaaaaaaaaaaaaaaaaa
aaaaaaaaaaaaaaaaaaaa
aaaaaaaaaaaaaaaaaaaa
aaaaaaabcbaaaaaaaaaa
aaaaaaadedaaaaaaaaaa
aaaaaadbcbdaaaaaaaaa
addddfdeeedfddddaaaa
adgggeeeeeeegggdaaaa
adheieeeeeeijeedaaaa
adeeieeeeeeieeedaaaa
adklmeeneneiolldaaaa
adggpeeeeeeigggdaaaa
adqeieeeeeeireedaaaa
adeeieseeesieeedaaaa
adllleeeeeeellldaaaa
adteeeueeeveeewdaaaa
adxeyezeAeBeCeDdaaaa
adddddddddddddddaaaa
aaaaaaaaaaaaaaaaaaaa
aaaaaaaaaaaaaaaaaaaa
"}
