"an" = (/obj/structure/bed/chair/shuttle/red{dir = 8},/obj/effect/decal/cleanable/blood/drip,/obj/effect/decal/cleanable/dirt,/turf/simulated/floor/shuttle/airless,/area/vault/dockruins)
"ar" = (/obj/item/stack/tile/metal,/turf/simulated/floor/shuttle/plating/airless,/area/vault/dockruins)
"aA" = (/obj/structure/shuttle/engine/propulsion/left,/obj/effect/decal/cleanable/soot,/turf/simulated/floor/plating,/area/vault/dockruins)
"bh" = (/obj/structure/shuttle/diag_wall/smooth{dir = 4},/turf/space,/area/vault/dockruins)
"ci" = (/obj/machinery/optable,/obj/effect/decal/cleanable/blood/oil,/obj/effect/decal/cleanable/dirt,/obj/effect/landmark/corpse/mutilated,/obj/effect/gibspawner/blood,/turf/simulated/floor/airless{broken = 1; icon_state = "damaged4"},/area/vault/dockruins)
"cs" = (/obj/item/stack/rods,/obj/item/weapon/shard{icon_state = "small"; pixel_x = 5; pixel_y = -5},/turf/space,/area)
"cz" = (/obj/structure/window/reinforced{dir = 8},/obj/structure/grille/broken,/obj/structure/lattice,/obj/item/weapon/shard{icon_state = "medium"},/turf/space,/area/vault/dockruins)
"cJ" = (/turf/simulated/floor/shuttle/airless{icon_state = "floor3"},/area/vault/dockruins)
"cP" = (/obj/item/broken_device,/turf/simulated/floor/shuttle/airless{icon_state = "floor3"},/area/vault/dockruins)
"dz" = (/obj/item/weapon/bikehorn,/turf/simulated/floor/shuttle/plating/airless,/area/vault/dockruins)
"fH" = (/obj/structure/bed/roller/surgery,/turf/simulated/floor/airless{broken = 1; icon_state = "damaged2"},/area/vault/dockruins)
"fO" = (/obj/machinery/vending/circus{emagged = 1},/turf/simulated/floor/shuttle/plating/airless,/area/vault/dockruins)
"gh" = (/obj/structure/bed/chair/shuttle/red{dir = 8},/obj/effect/decal/cleanable/scattered_sand,/obj/machinery/light/small/broken{dir = 1},/obj/effect/decal/cleanable/blood/gibs/limb,/turf/simulated/floor/shuttle/airless,/area/vault/dockruins)
"gv" = (/obj/item/stack/rods,/turf/space,/area)
"gB" = (/obj/structure/shuttle/diag_wall/smooth,/turf/simulated/floor/shuttle/airless,/area/vault/dockruins)
"gR" = (/obj/item/stack/sheet/metal,/obj/effect/decal/cleanable/dirt,/turf/simulated/floor/shuttle/airless{icon_state = "floor3"},/area/vault/dockruins)
"gS" = (/obj/structure/shuttle/engine/propulsion/left{dir = 4},/obj/structure/shuttle/diag_wall/smooth{dir = 1},/turf/space,/area/vault/dockruins)
"hl" = (/obj/structure/lattice,/obj/item/weapon/shard,/obj/item/stack/rods,/turf/space,/area/vault/dockruins)
"hC" = (/obj/item/weapon/stool/bar,/obj/structure/lattice,/turf/space,/area/vault/dockruins)
"hL" = (/obj/effect/decal/cleanable/dirt,/turf/simulated/floor/shuttle/airless{icon_state = "floor3"},/area/vault/dockruins)
"hS" = (/obj/machinery/door/unpowered/shuttle,/obj/structure/lattice,/turf/space,/area/vault/dockruins)
"iL" = (/turf/simulated/wall/shuttle,/area/vault/dockruins)
"iN" = (/obj/machinery/vending/wallmed1{name = "Emergency NanoMed"; pixel_x = 30; stat = 1},/obj/item/stack/rods,/turf/simulated/floor/shuttle/airless,/area/vault/dockruins)
"iS" = (/obj/effect/decal/cleanable/scattered_sand,/turf/simulated/floor/shuttle/airless,/area/vault/dockruins)
"jp" = (/obj/structure/table/reinforced{flipped = 3},/obj/item/stack/rods,/turf/simulated/floor/shuttle/airless{icon_state = "floor3"},/area/vault/dockruins)
"js" = (/obj/structure/table,/obj/item/weapon/storage/firstaid/o2{pixel_x = 5; pixel_y = 5},/turf/simulated/floor/shuttle/airless,/area/vault/dockruins)
"jF" = (/obj/item/device/radio/intercom{name = "Station Intercom (General)"; pixel_y = 20},/obj/structure/bed/chair/shuttle/red{dir = 4},/obj/effect/decal/cleanable/dirt,/turf/simulated/floor/shuttle/airless,/area/vault/dockruins)
"jI" = (/obj/structure/shuttle/diag_wall/smooth,/obj/structure/lattice,/turf/space,/area/vault/dockruins)
"jP" = (/obj/structure/bed/chair/shuttle/red{dir = 4},/obj/machinery/light/small/broken,/obj/effect/decal/cleanable/blood/drip,/obj/effect/decal/cleanable/cockroach_remains,/obj/effect/decal/cleanable/cockroach_remains{pixel_x = -3; pixel_y = -3},/obj/item/device/radio/intercom{name = "Station Intercom (General)"; pixel_y = 20},/turf/simulated/floor/shuttle,/area/vault/dockruins)
"jR" = (/obj/structure/piano{broken = 1; dir = 4},/turf/simulated/floor/shuttle/airless,/area/vault/dockruins)
"jY" = (/obj/machinery/bodyscanner/upgraded,/turf/simulated/floor/airless{broken = 1; icon_state = "damaged2"},/area/vault/dockruins)
"ki" = (/obj/structure/window/reinforced{dir = 8},/obj/structure/window/reinforced{dir = 1},/obj/item/weapon/shard{icon_state = "small"; pixel_x = 5; pixel_y = -5},/turf/simulated/floor/shuttle/plating/airless,/area/vault/dockruins)
"kA" = (/obj/structure/shuttle/diag_wall/smooth,/turf/space,/area/vault/dockruins)
"kI" = (/obj/structure/shuttle/diag_wall/smooth{dir = 1},/turf/space,/area/vault/dockruins)
"ld" = (/obj/structure/table/reinforced,/obj/item/weapon/reagent_containers/food/drinks/drinkingglass,/turf/simulated/floor/shuttle/airless,/area/vault/dockruins)
"ll" = (/obj/item/weapon/beach_ball/holoball,/turf/simulated/floor/shuttle/plating/airless,/area/vault/dockruins)
"lL" = (/obj/structure/shuttle/engine/propulsion/right,/obj/effect/decal/cleanable/soot,/turf/simulated/floor/shuttle/plating/airless,/area/vault/dockruins)
"lQ" = (/obj/item/weapon/storage/firstaid/internalbleed{pixel_x = -5; pixel_y = 5},/turf/simulated/floor/shuttle/airless{icon_state = "floor2"},/area/vault/dockruins)
"mu" = (/obj/structure/shuttle/diag_wall/smooth{dir = 8},/turf/simulated/floor/shuttle/airless,/area/vault/dockruins)
"mv" = (/obj/item/device/instrument/guitar,/obj/effect/decal/cleanable/blood/oil,/turf/simulated/floor/shuttle/plating/airless,/area/vault/dockruins)
"mz" = (/obj/structure/shuttle/diag_wall/smooth{dir = 1},/turf/simulated/floor/shuttle/plating/airless,/area/vault/dockruins)
"ni" = (/obj/structure/table,/obj/item/weapon/storage/firstaid/regular/empty,/turf/simulated/floor/shuttle/airless,/area/vault/dockruins)
"nN" = (/obj/item/stack/tile/metal,/turf/space,/area)
"on" = (/obj/effect/decal/cleanable/blood/oil,/obj/effect/gibspawner/blood,/turf/simulated/floor/shuttle/airless,/area/vault/dockruins)
"os" = (/obj/effect/decal/cleanable/ash,/obj/effect/decal/cleanable/dirt,/obj/effect/decal/cleanable/soot,/turf/simulated/floor/shuttle,/area/vault/dockruins)
"oO" = (/obj/structure/shuttle/engine/heater{dir = 8},/turf/space,/area)
"oS" = (/obj/structure/shuttle/engine/propulsion/right,/obj/effect/decal/cleanable/soot,/turf/simulated/floor/plating,/area/vault/dockruins)
"oZ" = (/obj/structure/shuttle/engine/propulsion/left{dir = 1},/turf/space,/area)
"pf" = (/obj/structure/shuttle/diag_wall/smooth{dir = 1},/obj/effect/decal/cleanable/soot,/turf/simulated/floor/shuttle/airless{icon_state = "floor2"},/area/vault/dockruins)
"pE" = (/obj/structure/bed/chair/shuttle/red{dir = 4},/obj/effect/decal/cleanable/spiderling_remains,/obj/effect/decal/cleanable/blood/gibs/body,/obj/abstract/map/spawner/assistant/tools,/obj/item/weapon/storage/toolbox/mechanical,/obj/effect/decal/remains/human,/turf/simulated/floor/shuttle/airless,/area/vault/dockruins)
"qe" = (/obj/effect/decal/cleanable/blood,/turf/simulated/floor/shuttle/airless,/area/vault/dockruins)
"qo" = (/obj/structure/window/reinforced{dir = 4},/obj/structure/grille/broken,/obj/effect/decal/cleanable/soot,/turf/simulated/floor/shuttle/plating/airless,/area/vault/dockruins)
"rM" = (/obj/structure/lattice,/obj/item/weapon/shard{icon_state = "small"; pixel_x = 5; pixel_y = -5},/turf/space,/area/vault/dockruins)
"sn" = (/obj/structure/window/reinforced{dir = 8},/obj/structure/window/reinforced,/obj/structure/grille/broken,/obj/structure/lattice,/obj/structure/shuttle/diag_wall/smooth,/turf/space,/area/vault/dockruins)
"sP" = (/obj/structure/grille,/obj/structure/window/reinforced{dir = 8},/obj/structure/window/reinforced{dir = 4},/obj/structure/window/reinforced,/obj/item/weapon/shard{icon_state = "small"; pixel_x = 5; pixel_y = -5},/turf/simulated/floor/shuttle/plating,/area/vault/dockruins)
"sQ" = (/obj/item/weapon/gun/energy/pulse_rifle/destroyer{projectile_type = "/obj/item/projectile/beam/lasertag/blue"},/turf/simulated/floor/shuttle/plating/airless,/area/vault/dockruins)
"sV" = (/obj/structure/lattice,/obj/structure/shuttle/engine/propulsion/right{dir = 1},/obj/structure/shuttle/diag_wall/smooth{dir = 8},/turf/space,/area/vault/dockruins)
"tf" = (/obj/machinery/computer/security/telescreen/entertainment{pixel_x = -32; stat = 1},/turf/simulated/floor/shuttle/airless{icon_state = "floor2"},/area/vault/dockruins)
"tr" = (/obj/structure/grille/window_spawner/reinforced,/turf/simulated/floor/shuttle/plating,/area/vault/dockruins)
"tI" = (/obj/structure/shuttle/engine/propulsion/left{dir = 8},/obj/structure/shuttle/diag_wall/smooth{dir = 8},/turf/simulated/floor/shuttle/plating/airless,/area/vault/dockruins)
"tU" = (/obj/machinery/door/airlock/external{name = "Salvage Shuttle Dock"},/obj/docking_port/destination/pod2/centcom,/turf/simulated/floor/shuttle/airless{icon_state = "floor2"},/area/vault/dockruins)
"uf" = (/obj/structure/lattice,/turf/space,/area/vault/dockruins)
"uK" = (/obj/item/device/radio/intercom{dir = 4; name = "Station Intercom (General)"; pixel_x = 27},/obj/effect/decal/cleanable/dirt,/obj/effect/decal/cleanable/dirt,/obj/effect/decal/cleanable/blood/viralsputum,/turf/simulated/floor/shuttle/airless,/area/vault/dockruins)
"wv" = (/obj/item/stack/rods,/turf/space,/area/vault/dockruins)
"wA" = (/obj/effect/decal/cleanable/dirt,/obj/effect/decal/cleanable/blood/gibs/xeno,/turf/simulated/floor/shuttle/airless{icon_state = "floor3"},/area/vault/dockruins)
"xp" = (/obj/effect/decal/cleanable/ash,/obj/effect/decal/cleanable/dirt,/obj/structure/table/woodentable/poker,/turf/simulated/floor/shuttle/airless,/area/vault/dockruins)
"xC" = (/obj/structure/closet/emcloset/legacy{opened = 1},/turf/simulated/floor/shuttle/airless,/area/vault/dockruins)
"xI" = (/obj/structure/bed/chair/shuttle{dir = 1},/obj/effect/decal/cleanable/dirt,/obj/effect/decal/cleanable/blood/gibs/body,/turf/simulated/floor/shuttle,/area/vault/dockruins)
"xN" = (/obj/item/stack/sheet/metal,/turf/simulated/floor/shuttle/airless{icon_state = "floor2"},/area/vault/dockruins)
"yg" = (/obj/machinery/door/airlock/external{name = "Salvage Shuttle Dock"},/obj/docking_port/destination/pod1/centcom,/turf/simulated/floor/shuttle/airless{icon_state = "floor2"},/area/vault/dockruins)
"yi" = (/obj/structure/shuttle/engine/propulsion/left{dir = 8},/obj/structure/shuttle/diag_wall/smooth{dir = 8},/turf/simulated/floor/plating,/area/vault/dockruins)
"ys" = (/obj/structure/bed/chair/shuttle/red{dir = 4},/obj/effect/decal/cleanable/cockroach_remains,/obj/effect/decal/cleanable/cockroach_remains,/obj/effect/decal/cleanable/cockroach_remains{pixel_x = 3; pixel_y = 3},/turf/simulated/floor/shuttle,/area/vault/dockruins)
"yt" = (/obj/item/weapon/stool/bar,/obj/item/weapon/shard{icon_state = "small"},/turf/simulated/floor/shuttle/airless,/area/vault/dockruins)
"yx" = (/obj/machinery/newscaster{pixel_y = -32},/obj/item/stack/sheet/metal,/obj/effect/decal/cleanable/ash,/turf/simulated/floor/shuttle/airless,/area/vault/dockruins)
"yT" = (/obj/effect/decal/cleanable/dirt,/obj/effect/decal/cleanable/blood/gibs/robot,/turf/simulated/floor/shuttle/airless,/area/vault/dockruins)
"yZ" = (/obj/effect/decal/cleanable/soot,/turf/simulated/floor/shuttle/airless,/area/vault/dockruins)
"ze" = (/obj/effect/decal/cleanable/scattered_sand,/obj/effect/decal/cleanable/blood/gibs/limb,/turf/simulated/floor/shuttle/airless,/area/vault/dockruins)
"zy" = (/obj/structure/shuttle/diag_wall/smooth{dir = 8},/obj/structure/lattice,/turf/space,/area/vault/dockruins)
"zz" = (/obj/structure/bed/chair/wood/wings,/turf/simulated/floor/shuttle/airless,/area/vault/dockruins)
"Aw" = (/obj/item/weapon/stool/piano{dir = 8; pixel_x = -5},/turf/simulated/floor/shuttle/airless,/area/vault/dockruins)
"Ay" = (/obj/item/weapon/beach_ball,/turf/simulated/floor/shuttle/plating/airless,/area/vault/dockruins)
"BR" = (/obj/structure/shuttle/diag_wall/smooth{dir = 8},/turf/space,/area/vault/dockruins)
"BY" = (/obj/item/device/radio/intercom{dir = 4; name = "Station Intercom (General)"; pixel_x = 27},/obj/structure/bed/chair/shuttle{dir = 1},/obj/machinery/light/small/broken{dir = 8},/turf/simulated/floor/shuttle,/area/vault/dockruins)
"Cq" = (/turf/simulated/wall/shuttle/unsmoothed,/area/vault/dockruins)
"Cz" = (/obj/machinery/sleeper/upgraded{dir = 1},/obj/item/stack/sheet/metal,/turf/simulated/floor/airless{broken = 1; icon_state = "damaged2"},/area/vault/dockruins)
"De" = (/obj/item/stack/sheet/metal,/turf/simulated/floor/shuttle/airless{icon_state = "floor3"},/area/vault/dockruins)
"DK" = (/obj/effect/decal/cleanable/ash,/obj/item/trash/slag,/obj/effect/decal/cleanable/dirt,/obj/effect/decal/cleanable/soot,/turf/simulated/floor/shuttle/airless,/area/vault/dockruins)
"DP" = (/obj/item/weapon/boomerang/toy,/obj/effect/decal/cleanable/blood/oil,/turf/simulated/floor/shuttle/plating/airless,/area/vault/dockruins)
"Fa" = (/obj/structure/bed/chair/shuttle/blue{dir = 4},/obj/effect/decal/cleanable/dirt,/obj/effect/decal/cleanable/vomit,/obj/effect/decal/cleanable/soot,/turf/simulated/floor/shuttle/airless,/area/vault/dockruins)
"FT" = (/obj/machinery/door/unpowered/shuttle,/turf/simulated/floor/shuttle,/area/vault/dockruins)
"FZ" = (/obj/item/weapon/gun/energy/fireworkslauncher,/turf/simulated/floor/shuttle/plating/airless,/area/vault/dockruins)
"GM" = (/obj/structure/shuttle/engine/propulsion/right{dir = 1},/obj/structure/shuttle/diag_wall/smooth{dir = 1},/turf/space,/area/vault/dockruins)
"Im" = (/obj/structure/bed/chair/comfy/black,/turf/simulated/floor/shuttle/airless,/area/vault/dockruins)
"IM" = (/obj/item/weapon/shard{icon_state = "small"; pixel_x = 5; pixel_y = -5},/turf/space,/area/vault/dockruins)
"IX" = (/obj/machinery/door/airlock/external{name = "Salvage Shuttle Dock"; welded = true},/obj/docking_port/destination/pod5/centcom{dir = 4},/turf/simulated/floor/shuttle/plating,/area/vault/dockruins)
"Jj" = (/obj/effect/decal/cleanable/blood/drip,/turf/simulated/floor/shuttle/airless,/area/vault/dockruins)
"Jq" = (/obj/item/stack/rods,/turf/simulated/floor/shuttle/airless,/area/vault/dockruins)
"JB" = (/obj/structure/bed/chair/shuttle/red{dir = 4},/obj/effect/decal/cleanable/spiderling_remains,/obj/machinery/light/small/broken,/obj/abstract/map/spawner/assistant/tools,/turf/simulated/floor/shuttle/airless,/area/vault/dockruins)
"JL" = (/obj/effect/decal/cleanable/ash,/obj/effect/decal/cleanable/dirt,/obj/effect/decal/cleanable/soot,/obj/machinery/computer/security/telescreen/entertainment{pixel_y = 32; stat = 1},/turf/simulated/floor/shuttle,/area/vault/dockruins)
"JT" = (/obj/machinery/computer/arcade{stat = 1},/turf/simulated/floor/shuttle/airless,/area/vault/dockruins)
"JV" = (/obj/structure/shuttle/engine/heater{dir = 1},/turf/space,/area)
"JX" = (/obj/item/weapon/melee/defibrillator,/turf/simulated/floor/shuttle/airless,/area/vault/dockruins)
"Kc" = (/obj/structure/window/reinforced{dir = 1},/obj/structure/window/reinforced{dir = 4},/obj/item/weapon/reagent_containers/blood/AMinus{pixel_x = -4},/obj/item/stack/rods,/turf/simulated/floor/shuttle/plating,/area/vault/dockruins)
"Kg" = (/obj/item/stack/tile/metal,/turf/space,/area/vault/dockruins)
"Kl" = (/obj/structure/shuttle/engine/propulsion/right{dir = 8},/obj/structure/shuttle/diag_wall/smooth,/turf/simulated/floor/plating,/area/vault/dockruins)
"Kn" = (/obj/structure/table/reinforced,/obj/item/weapon/reagent_containers/food/drinks/drinkingglass,/obj/item/weapon/storage/firstaid/toxin{pixel_x = 5; pixel_y = 5},/turf/simulated/floor/shuttle/airless,/area/vault/dockruins)
"KC" = (/obj/structure/grille/broken,/obj/structure/window/reinforced{dir = 8},/obj/item/weapon/shard{icon_state = "small"},/turf/simulated/floor/shuttle/plating,/area/vault/dockruins)
"KP" = (/obj/structure/shuttle/diag_wall/smooth{dir = 8},/turf/simulated/floor/shuttle/plating/airless,/area/vault/dockruins)
"Lq" = (/obj/item/device/radio/intercom{dir = 4; name = "Station Intercom (General)"; pixel_x = 27},/obj/effect/decal/cleanable/dirt,/obj/structure/bed/chair/shuttle{dir = 1},/obj/machinery/light/small/broken{dir = 8},/turf/simulated/floor/shuttle,/area/vault/dockruins)
"Lw" = (/obj/effect/decal/cleanable/blood/drip,/turf/simulated/floor/shuttle/airless{icon_state = "floor2"},/area/vault/dockruins)
"LA" = (/obj/item/weapon/kitchen/utensil/fork{pixel_x = -10; pixel_y = 2},/obj/effect/decal/cleanable/broken_plate,/obj/item/weapon/paper/crumpled{info = "The pods just kept coming and kept coming and kept coming and-"},/obj/structure/table/woodentable{flipped = 8},/turf/simulated/floor/shuttle/airless,/area/vault/dockruins)
"LR" = (/obj/machinery/door/unpowered/shuttle,/turf/simulated/floor/shuttle/airless{icon_state = "floor3"},/area/vault/dockruins)
"LS" = (/obj/structure/window/reinforced,/obj/structure/grille/broken,/obj/item/weapon/shard{icon_state = "small"; pixel_x = 5; pixel_y = -5},/turf/space,/area/vault/dockruins)
"Mb" = (/obj/structure/bed/chair/comfy/black{dir = 8},/turf/simulated/floor/shuttle/airless,/area/vault/dockruins)
"Mu" = (/obj/structure/bed/chair/shuttle{dir = 1},/obj/effect/decal/remains/human,/obj/item/clothing/head/dunce_cap{pixel_y = 8},/obj/effect/decal/cleanable/dirt,/obj/effect/decal/cleanable/blood/gibs/body,/turf/simulated/floor/shuttle/airless,/area/vault/dockruins)
"MV" = (/obj/structure/shuttle/engine/heater{dir = 4},/turf/space,/area)
"NB" = (/obj/structure/table/reinforced,/obj/effect/decal/cleanable/pie_smudge,/obj/abstract/map/spawner/space/drinks,/turf/simulated/floor/shuttle/airless,/area/vault/dockruins)
"NR" = (/obj/machinery/vending/cigarette{stat = 1},/turf/simulated/floor/shuttle/airless,/area/vault/dockruins)
"Oc" = (/obj/machinery/door/airlock/hatch{name = "Cockpit"; req_access_txt = "109"},/turf/simulated/floor/shuttle/airless{icon_state = "floor2"},/area/vault/dockruins)
"OI" = (/obj/structure/table,/obj/structure/sign/nosmoking_1{pixel_y = 28},/obj/item/stack/medical/advanced/bruise_pack{pixel_x = -6; pixel_y = 6},/obj/abstract/map/spawner/medical/pills,/turf/simulated/floor/airless{broken = 1; icon_state = "damaged3"},/area/vault/dockruins)
"OJ" = (/obj/structure/shuttle/engine/propulsion/left{dir = 8},/turf/space,/area)
"OX" = (/obj/item/stack/sheet/metal,/turf/space,/area)
"Pv" = (/turf/simulated/floor/shuttle/airless{icon_state = "floor2"},/area/vault/dockruins)
"QL" = (/obj/effect/decal/cleanable/dirt,/obj/effect/decal/cleanable/ash,/obj/effect/decal/cleanable/soot,/turf/simulated/floor/shuttle/airless,/area/vault/dockruins)
"Ri" = (/obj/structure/grille/broken,/obj/effect/decal/cleanable/soot,/turf/simulated/floor/shuttle/plating/airless,/area/vault/dockruins)
"Rq" = (/obj/structure/lattice,/obj/item/stack/sheet/metal,/turf/space,/area)
"RJ" = (/obj/structure/table{flipped = 4},/obj/item/weapon/paper_bin,/obj/item/stack/sheet/metal,/obj/effect/decal/cleanable/dirt,/obj/effect/decal/cleanable/soot,/turf/simulated/floor/shuttle/airless,/area/vault/dockruins)
"Se" = (/turf/simulated/floor/shuttle/airless,/area/vault/dockruins)
"SH" = (/obj/structure/shuttle/engine/propulsion/right{dir = 8},/obj/structure/shuttle/diag_wall/smooth,/turf/simulated/floor/shuttle/plating/airless,/area/vault/dockruins)
"SW" = (/obj/item/weapon/stool,/turf/simulated/floor/shuttle/airless,/area/vault/dockruins)
"Tp" = (/obj/item/stack/tile/metal,/turf/simulated/floor/shuttle/airless{icon_state = "floor2"},/area/vault/dockruins)
"Ua" = (/obj/machinery/door/window{base_state = "right"; name = "Bar Door"},/turf/simulated/floor/shuttle{icon_state = "floor3"},/area/vault/dockruins)
"Uo" = (/obj/effect/decal/cleanable/ash,/obj/effect/decal/cleanable/dirt,/obj/effect/decal/cleanable/soot,/turf/simulated/floor/shuttle/airless,/area/vault/dockruins)
"UN" = (/obj/item/broken_device,/turf/simulated/floor/shuttle/airless,/area/vault/dockruins)
"UQ" = (/obj/structure/door_assembly/door_assembly_mhatch,/turf/simulated/floor/shuttle/plating/airless,/area/vault/dockruins)
"Vf" = (/obj/machinery/door/unpowered/shuttle,/turf/simulated/floor/shuttle/airless,/area/vault/dockruins)
"Vw" = (/obj/structure/shuttle/engine/propulsion/left{dir = 4},/turf/space,/area/vault/dockruins)
"VH" = (/obj/structure/closet/emcloset,/turf/simulated/floor/shuttle/airless,/area/vault/dockruins)
"Wo" = (/obj/structure/window/reinforced{dir = 1},/obj/structure/window/reinforced{dir = 8},/obj/structure/grille/broken,/obj/item/weapon/shard{icon_state = "medium"},/turf/simulated/floor/shuttle/plating/airless,/area/vault/dockruins)
"Xi" = (/obj/machinery/chem_dispenser/booze_dispenser/mapping,/obj/structure/table/reinforced,/turf/simulated/floor/shuttle/airless{icon_state = "floor3"},/area/vault/dockruins)
"Xo" = (/obj/structure/lattice,/obj/item/stack/tile/metal,/turf/space,/area/vault/dockruins)
"XV" = (/obj/item/weapon/toy/xmas_cracker,/turf/simulated/floor/shuttle/plating/airless,/area/vault/dockruins)
"Yd" = (/obj/machinery/recharger/defibcharger/wallcharger{pixel_y = 30},/obj/item/stack/rods,/obj/effect/decal/cleanable/dirt,/obj/effect/decal/cleanable/blood/gibs/up,/turf/simulated/floor/airless{broken = 1; icon_state = "damaged2"},/area/vault/dockruins)
"Ye" = (/turf/space,/area)
"Yi" = (/obj/machinery/door/airlock/maintenance_hatch,/turf/simulated/floor/shuttle/plating/airless,/area/vault/dockruins)
"Yo" = (/obj/structure/shuttle/engine/propulsion/left{dir = 4},/obj/structure/shuttle/diag_wall/smooth{dir = 4},/turf/space,/area/vault/dockruins)
"YB" = (/obj/structure/shuttle/engine/propulsion/left{dir = 4},/turf/space,/area)
"Za" = (/obj/structure/closet/emcloset{opened = 1},/turf/simulated/floor/shuttle,/area/vault/dockruins)
"Zb" = (/turf/space,/area/vault/dockruins)
"Zy" = (/obj/structure/lattice,/obj/item/stack/sheet/metal,/turf/space,/area/vault/dockruins)

(1,1,1) = {"
YeYeYeYeYeYeoZYeYeYeYeYeYeYeYeYeYeYeYeYeYeYeYeYeYe
YeYeYeOXYeYeJVYeYeBRtrkIYeBRtrkIYeYeYeYeYeYeYeYeYe
YeYeYeYeYeYeYegvYeiLxIiLnNiLxIiLYeYegvYeYeYeYeYeYe
YeYeYeYetIiLiLkIYeiLBYiLYeiLLqiLYeBRiLiLVwYeYeYeYe
YeYegvYeFTJBpEkigvaAFToSYeaAFToScsiSzeghVfYeYeYeYe
YeYeYeYeSHiLiLZyYeCqygCqCqCqtUiLCqjIZyiLVwYeYeYeYe
YeYeYeYeiLdzAyKPYeZaPvosJLosLwxCgBmzXVsQiLYeYeYeYe
YeYeYeYeiLllDPUQnNJqZbPvPvlQPvUNhCYimvariLYeYeYeYe
YeYeYeYekAmzFZsVLRGMmuiLytPvJjAwjRiLfOKPbhYeYegvYe
YeYeYeOJoOkACqiLwAiLXildSeKgzzqeniiLiLbhYeYeYeYeYe
YeYeYeYeYeYeYeiLhLrMcPKnSePvLAonjsCqYeYeYeYeYeYeYe
YeYeYeYeYeYeYeczgRcJDeNBSeLwUozyiLiLgSYeYeYeYeYeYe
YeYeOXYeYeYeYesnjpiLkIUaZbPvLwhlanyThSYegvYeYeYeYe
YeYeYeYeYeYeYeCqCqCqCqiLtfSeImjIiLiLYoYeYeYeYeOXYe
YeYeYeYeYeYeYeWoOIciYdKcZbQLxpMbxNsPYeYeYeYeYeYeYe
YeYeYegvYeYeYenNRqyiiLiLPvSeQLJXTpCqyiiLiLkIYeYeYe
YeYeYeYeYeYeYeYeYeVfjFZbPvufPvIMPvIXFTjPystrYeYeYe
YeYeYeYeYeYeYeYegvKliLiLPvSWUNwviNiLKliLiLbhYeYeYe
YeYeYeYeYeYeYeLSCzfHjYKCPvJTyxNRVHiLYeYeYeYeYeYeYe
YeYeYeYeYeYeYekACqCqCqufOciLiLiLiLbhYeYeYeYeYeYeYe
YeYeYeYeYeOXYeYekACqzyXopfFaDKiLbhYeYeYeYeYegvYeYe
YeYeYeYeYeYeYeYenNZyiLMuiLyZDKiLOXYeYeYeYeYeYeYeYe
YeYeYeYeYeYeYeYeYeCqiLuKiLUoRJiLYeYeMVYBYeYeYeYeYe
YeYeYeYeYegvYeYeYekAaAFTlLRiqobhYeYeYeYeYeYeYeYeYe
YeYeYeYeYeYeYeYeYeYeYeYeYeYeYeYeYeYeYeYeYeYeYeYeYe
"}
