//MAP CONVERTED BY dmm2tgm.py THIS HEADER COMMENT PREVENTS RECONVERSION, DO NOT REMOVE
"a" = (
/turf/space,
/area)
"b" = (
/turf/simulated/wall/invulnerable,
/area/vault/rattlemebones)
"c" = (
/obj/abstract/mover/redirector/east,
/turf/simulated/floor/wood,
/area/vault/rattlemebones)
"d" = (
/turf/simulated/floor/wood,
/area/vault/rattlemebones)
"e" = (
/obj/abstract/mover/redirector/south,
/turf/simulated/floor/wood,
/area/vault/rattlemebones)
"f" = (
/mob/living/simple_animal/hostile/rattlemebones,
/turf/simulated/floor/wood,
/area/vault/rattlemebones)
"g" = (
/obj/abstract/mover/redirector/west,
/turf/simulated/floor/wood,
/area/vault/rattlemebones)
"h" = (
/obj/abstract/mover/transporter{
	dir = 1
	},
/mob/living/simple_animal/hostile/rattlemebones,
/turf/simulated/floor/wood,
/area/vault/rattlemebones)
"i" = (
/obj/abstract/mover/transporter,
/mob/living/simple_animal/hostile/rattlemebones,
/turf/simulated/floor/wood,
/area/vault/rattlemebones)
"j" = (
/obj/abstract/mover/redirector/north,
/turf/simulated/floor/wood,
/area/vault/rattlemebones)
"k" = (
/obj/abstract/mover/transporter{
	dir = 8
	},
/mob/living/simple_animal/hostile/rattlemebones,
/turf/simulated/floor/wood,
/area/vault/rattlemebones)
"l" = (
/mob/living/simple_animal/hostile/humanoid/skellington{
	wander = 0
	},
/turf/simulated/floor/wood,
/area/vault/rattlemebones)
"m" = (
/obj/machinery/door/mineral/wood,
/turf/simulated/floor/wood,
/area/vault/rattlemebones)
"n" = (
/obj/abstract/mover/redirector/southwest,
/turf/simulated/floor/wood,
/area/vault/rattlemebones)
"o" = (
/obj/abstract/mover/redirector/northwest,
/turf/simulated/floor/wood,
/area/vault/rattlemebones)
"p" = (
/obj/abstract/mover/redirector/southeast,
/turf/simulated/floor/wood,
/area/vault/rattlemebones)
"q" = (
/obj/abstract/mover/redirector/northeast,
/turf/simulated/floor/wood,
/area/vault/rattlemebones)
"r" = (
/obj/item/weapon/dnainjector/nofail/melt,
/turf/simulated/floor/wood,
/area/vault/rattlemebones)
"s" = (
/obj/item/weapon/coin/gold,
/turf/simulated/floor/wood,
/area/vault/rattlemebones)
"t" = (
/obj/item/weapon/melee/energy/sword/pirate,
/turf/simulated/floor/wood,
/area/vault/rattlemebones)
"u" = (
/obj/structure/disposalpipe/trunk/no_deconstruct{
	dir = 4
	},
/obj/structure/disposaloutlet/no_deconstruct{
	dir = 8
	},
/turf/simulated/floor/wood,
/area/vault/rattlemebones)
"v" = (
/obj/structure/disposalpipe/segment/no_deconstruct{
	dir = 4
	},
/turf/simulated/wall/invulnerable,
/area/vault/rattlemebones)
"w" = (
/obj/structure/disposalpipe/trunk/no_deconstruct{
	dir = 8
	},
/obj/machinery/disposal/deliveryChute/no_deconstruct{
	dir = 4
	},
/turf/simulated/floor/wood,
/area/vault/rattlemebones)
"x" = (
/obj/item/weapon/storage/bag/money/treasure,
/turf/simulated/floor/wood,
/area/vault/rattlemebones)
"y" = (
/obj/effect/decal/remains/human,
/obj/item/clothing/under/pirate,
/obj/item/clothing/accessory/medal/gold,
/obj/item/clothing/suit/armor/vest/piratelord,
/obj/item/clothing/glasses/thermal/eyepatch,
/obj/item/clothing/head/helmet/piratelord,
/turf/simulated/floor/wood,
/area/vault/rattlemebones)

(1,1,1) = {"
a
a
a
a
a
a
a
a
a
a
a
a
a
a
a
a
a
a
a
a
a
a
a
a
a
a
a
a
a
a
a
a
a
a
a
a
a
a
a
a
"}
(2,1,1) = {"
a
a
a
a
a
a
a
a
a
a
a
a
a
a
a
a
a
a
a
a
a
a
a
a
a
a
a
a
a
a
a
a
a
a
a
a
a
a
a
a
"}
(3,1,1) = {"
a
a
b
b
b
b
b
b
b
b
b
b
b
b
b
b
b
b
b
b
b
b
b
b
b
b
b
b
b
b
b
b
b
b
b
b
a
a
a
a
"}
(4,1,1) = {"
a
a
b
c
d
h
d
j
d
c
d
d
d
j
b
l
d
d
d
d
d
d
d
b
f
f
f
f
f
f
f
f
f
f
f
b
a
a
a
a
"}
(5,1,1) = {"
a
a
b
d
d
d
d
d
d
d
d
d
d
d
m
d
d
d
d
d
d
d
d
b
f
f
d
d
d
f
f
d
d
d
d
b
a
a
a
a
"}
(6,1,1) = {"
a
a
b
d
d
c
d
d
d
d
d
j
d
k
m
d
d
d
d
d
d
d
d
b
f
f
d
f
d
f
d
d
f
f
d
b
a
a
a
a
"}
(7,1,1) = {"
a
a
b
d
d
d
d
d
d
d
d
d
d
d
b
l
d
d
d
d
d
d
d
b
d
d
d
f
d
f
d
f
f
f
d
b
a
a
a
a
"}
(8,1,1) = {"
a
a
b
e
d
d
d
g
d
e
d
d
d
g
b
b
b
b
b
b
b
b
m
b
d
f
f
f
d
d
d
f
d
d
d
b
a
a
a
a
"}
(9,1,1) = {"
a
a
b
d
d
d
d
d
d
d
d
d
d
d
b
b
b
d
d
d
d
d
d
b
d
d
d
f
f
f
f
f
d
f
f
b
a
a
a
a
"}
(10,1,1) = {"
a
a
b
d
d
d
d
d
d
d
d
d
d
d
b
b
b
m
b
b
b
b
b
b
b
b
m
b
b
b
b
b
m
b
b
b
a
a
a
a
"}
(11,1,1) = {"
a
a
b
c
d
d
d
j
d
c
d
h
d
j
b
c
d
d
d
d
d
d
d
d
d
d
h
d
j
b
d
d
d
d
d
b
a
a
a
a
"}
(12,1,1) = {"
a
a
b
d
d
d
d
d
d
d
d
d
d
d
b
e
d
d
d
d
d
d
d
d
d
d
d
d
g
b
d
d
d
d
d
b
b
b
a
a
"}
(13,1,1) = {"
a
a
b
d
d
e
d
k
i
d
d
g
d
d
b
e
d
d
d
d
h
j
e
i
d
d
d
d
j
b
f
d
d
d
d
m
d
m
a
a
"}
(14,1,1) = {"
a
a
b
d
d
d
d
d
d
d
d
d
d
d
b
c
d
d
d
d
d
d
d
d
d
d
d
d
j
b
d
d
d
d
d
b
b
b
a
a
"}
(15,1,1) = {"
a
a
b
e
d
d
d
g
d
e
d
d
d
g
b
e
d
i
d
d
d
d
d
d
d
d
d
d
g
b
d
d
d
d
d
b
a
a
a
a
"}
(16,1,1) = {"
a
a
b
b
b
b
b
b
m
b
b
b
b
b
b
b
b
b
b
b
b
b
b
b
b
b
b
b
b
b
b
b
m
b
b
b
a
a
a
a
"}
(17,1,1) = {"
a
a
b
c
d
d
d
d
d
d
d
d
d
j
d
f
f
f
f
f
d
d
p
h
d
h
d
h
j
b
d
d
d
d
d
b
a
a
a
a
"}
(18,1,1) = {"
a
a
b
d
d
c
d
d
h
d
d
j
d
d
d
f
f
f
f
d
d
d
d
d
d
d
d
f
k
b
d
d
d
d
d
b
a
a
a
a
"}
(19,1,1) = {"
a
a
b
e
d
d
d
d
i
d
d
d
d
g
d
f
f
f
d
d
d
d
d
d
d
d
d
f
d
b
b
b
u
b
b
b
a
a
a
a
"}
(20,1,1) = {"
a
a
b
d
d
d
d
d
d
d
d
d
d
d
d
f
f
d
d
d
d
l
d
d
d
d
d
f
k
b
b
b
v
b
b
b
a
a
a
a
"}
(21,1,1) = {"
a
a
b
d
d
e
d
d
d
d
d
g
d
d
f
f
d
d
d
d
d
d
d
d
d
d
q
f
d
b
b
b
w
b
b
b
a
a
a
a
"}
(22,1,1) = {"
a
a
b
d
d
d
d
d
d
d
d
d
d
f
f
d
d
d
d
d
f
f
d
d
d
d
d
f
k
b
d
d
d
d
d
b
a
a
a
a
"}
(23,1,1) = {"
a
a
b
f
d
d
d
d
d
d
d
d
f
f
e
d
d
d
d
d
p
f
d
d
d
d
d
f
d
b
d
d
d
d
d
b
a
a
a
a
"}
(24,1,1) = {"
a
a
b
f
e
d
d
d
d
d
c
f
f
d
d
d
d
d
d
d
d
d
d
d
d
d
d
f
k
m
d
d
r
d
d
b
a
a
a
a
"}
(25,1,1) = {"
a
a
b
f
d
d
d
d
d
d
d
f
d
d
d
d
d
d
d
d
d
d
d
d
l
d
d
f
f
b
d
d
d
s
d
b
a
a
a
a
"}
(26,1,1) = {"
a
a
b
f
d
d
d
d
d
d
d
f
d
d
d
d
d
d
d
d
d
d
d
d
d
d
d
f
f
b
d
r
t
r
d
b
a
a
a
a
"}
(27,1,1) = {"
a
a
b
f
g
d
d
d
d
j
d
f
n
d
d
d
d
d
d
d
d
d
d
d
d
d
d
f
f
b
d
s
x
d
d
b
a
a
a
a
"}
(28,1,1) = {"
a
a
b
f
d
d
d
d
d
d
d
f
f
d
d
d
d
d
d
o
d
d
d
d
d
d
d
f
f
b
d
t
y
d
r
b
a
a
a
a
"}
(29,1,1) = {"
a
a
b
f
d
d
d
d
d
d
d
d
d
d
o
j
d
d
f
f
f
f
d
d
d
d
q
f
f
b
d
r
d
d
d
b
a
a
a
a
"}
(30,1,1) = {"
a
a
b
f
e
d
i
d
d
g
d
d
d
d
d
d
o
j
d
d
d
q
d
d
d
d
d
f
f
b
d
d
d
d
s
b
a
a
a
a
"}
(31,1,1) = {"
a
a
b
f
d
d
d
l
d
d
d
d
d
d
d
d
d
d
d
d
d
d
d
d
d
d
d
f
f
b
d
d
d
d
d
b
a
a
a
a
"}
(32,1,1) = {"
a
a
b
f
g
d
d
d
d
d
j
d
d
d
d
d
d
d
d
o
d
d
d
o
d
d
d
f
f
b
d
d
d
d
d
b
a
a
a
a
"}
(33,1,1) = {"
a
a
b
b
b
b
b
b
b
b
b
b
b
b
b
b
b
b
b
b
b
b
b
b
b
b
b
b
b
b
b
b
b
b
b
b
a
a
a
a
"}
(34,1,1) = {"
a
a
a
a
a
a
a
a
a
a
a
a
a
a
a
a
a
a
a
a
a
a
a
a
a
a
a
a
a
a
a
a
a
a
a
a
a
a
a
a
"}
(35,1,1) = {"
a
a
a
a
a
a
a
a
a
a
a
a
a
a
a
a
a
a
a
a
a
a
a
a
a
a
a
a
a
a
a
a
a
a
a
a
a
a
a
a
"}
