"aa" = (/turf/space,/area)
"ab" = (/turf/simulated/wall/r_wall,/area/vault/research)
"ac" = (/obj/machinery/power/terminal{dir = 4},/obj/structure/cable{icon_state = "0-2"; d2 = 2},/turf/simulated/floor/plating,/area/vault/research)
"ad" = (/obj/machinery/power/battery/smes{charge = 0},/obj/structure/cable{icon_state = "0-4"; d2 = 4},/turf/simulated/floor/plating,/area/vault/research)
"ae" = (/obj/item/stack/cable_coil,/obj/structure/table,/obj/item/stack/sheet/mineral/uranium{amount = 25},/obj/structure/cable{d1 = 2; d2 = 8; icon_state = "2-8"; tag = ""},/turf/simulated/floor/plating,/area/vault/research)
"af" = (/obj/structure/table,/turf/simulated/floor/plating,/area/vault/research)
"ag" = (/obj/structure/table,/obj/item/weapon/storage/toolbox/emergency,/turf/simulated/floor/plating,/area/vault/research)
"ah" = (/obj/structure/table,/obj/item/weapon/storage/toolbox/mechanical,/obj/item/weapon/storage/box/monkeycubes/farwacubes,/obj/machinery/light{dir = 1},/turf/simulated/floor/plating,/area/vault/research)
"ai" = (/obj/structure/table,/obj/item/weapon/storage/toolbox/electrical,/turf/simulated/floor/plating,/area/vault/research)
"aj" = (/obj/item/weapon/am_containment,/obj/item/weapon/am_containment,/obj/item/weapon/am_containment,/obj/item/weapon/am_containment,/obj/item/weapon/am_containment,/obj/item/weapon/am_containment,/obj/structure/table,/turf/simulated/floor{icon_state = "dark vault full"},/area/vault/research)
"ak" = (/turf/simulated/floor{icon_state = "dark vault full"},/area/vault/research)
"al" = (/obj/item/device/am_shielding_container,/obj/item/device/am_shielding_container,/obj/item/device/am_shielding_container,/obj/item/device/am_shielding_container,/obj/item/device/am_shielding_container,/obj/item/device/am_shielding_container,/obj/item/device/am_shielding_container,/obj/item/device/am_shielding_container,/obj/structure/table,/turf/simulated/floor{icon_state = "dark vault full"},/area/vault/research)
"am" = (/obj/machinery/power/am_control_unit,/turf/simulated/floor{icon_state = "dark vault full"},/area/vault/research)
"an" = (/obj/structure/cable{d1 = 1; d2 = 2; icon_state = "1-2"; pixel_y = 0},/turf/simulated/floor/plating,/area/vault/research)
"ao" = (/turf/simulated/floor/plating,/area/vault/research)
"ap" = (/obj/machinery/vending/engivend,/turf/simulated/floor/plating,/area/vault/research)
"aq" = (/obj/abstract/map/spawner/mobs/medivault,/turf/simulated/floor/plating,/area/vault/research)
"ar" = (/obj/abstract/map/spawner/misc/medivault,/obj/structure/cable{d1 = 2; d2 = 4; icon_state = "2-4"},/turf/simulated/floor/plating,/area/vault/research)
"as" = (/obj/abstract/map/spawner/mobs/medivault,/obj/structure/cable{d2 = 8; icon_state = "0-8"},/turf/simulated/floor/plating,/area/vault/research)
"at" = (/obj/item/toy/gasha/clown,/turf/simulated/floor/plating,/area/vault/research)
"au" = (/obj/machinery/power/apc/frame/research_vault,/turf/simulated/wall/r_wall,/area/vault/research)
"av" = (/obj/structure/cable{d1 = 2; d2 = 4; icon_state = "2-4"},/turf/simulated/floor/plating,/area/vault/research)
"aw" = (/obj/structure/cable{d1 = 4; d2 = 8; icon_state = "4-8"; pixel_y = 0},/turf/simulated/floor/plating,/area/vault/research)
"ax" = (/obj/abstract/map/spawner/mobs/medivault,/obj/structure/cable{d1 = 4; d2 = 8; icon_state = "4-8"; pixel_y = 0},/turf/simulated/floor/plating,/area/vault/research)
"ay" = (/obj/structure/cable{d1 = 2; d2 = 8; icon_state = "2-8"; tag = ""},/turf/simulated/floor/plating,/area/vault/research)
"az" = (/obj/abstract/map/spawner/mobs/medivault,/turf/simulated/floor{icon_state = "dark vault full"},/area/vault/research)
"aA" = (/obj/item/toy/syndicateballoon,/turf/simulated/floor{icon_state = "dark vault full"},/area/vault/research)
"aB" = (/obj/machinery/power/port_gen/pacman/super,/obj/structure/cable,/turf/simulated/floor/plating,/area/vault/research)
"aC" = (/obj/structure/cable{d1 = 1; d2 = 8; icon_state = "1-8"},/turf/simulated/floor/plating,/area/vault/research)
"aD" = (/obj/machinery/vending/tool,/turf/simulated/floor/plating,/area/vault/research)
"aE" = (/obj/machinery/portable_atmospherics/canister/oxygen,/turf/simulated/floor/plating,/area/vault/research)
"aF" = (/obj/machinery/vending/wallmed1{pixel_y = 0},/turf/simulated/wall/r_wall,/area/vault/research)
"aG" = (/obj/machinery/light{dir = 8},/obj/structure/cable{d1 = 2; d2 = 4; icon_state = "2-4"},/turf/simulated/floor{icon_state = "dark vault full"},/area/vault/research)
"aH" = (/obj/structure/cable{d2 = 8; icon_state = "0-8"},/turf/simulated/floor{icon_state = "dark-markings"; dir = 8},/area/vault/research)
"aI" = (/obj/machinery/light{dir = 4},/turf/simulated/floor{icon_state = "dark vault full"},/area/vault/research)
"aJ" = (/obj/machinery/door/airlock/maintenance,/obj/structure/cable{d1 = 1; d2 = 2; icon_state = "1-2"; pixel_y = 0},/turf/simulated/floor/plating,/area/vault/research)
"aK" = (/obj/structure/sign/electricshock,/turf/simulated/wall/r_wall,/area/vault/research)
"aL" = (/obj/structure/crematorium,/turf/simulated/floor{icon_state = "dark"; dir = 6},/area/vault/research)
"aM" = (/obj/abstract/map/spawner/mobs/medivault,/obj/machinery/light{dir = 1},/turf/simulated/floor{icon_state = "dark"; dir = 6},/area/vault/research)
"aN" = (/obj/machinery/vending/chapel,/turf/simulated/floor{icon_state = "dark"; dir = 6},/area/vault/research)
"aO" = (/obj/structure/table,/obj/item/weapon/storage/box/handcuffs,/obj/item/weapon/reagent_containers/glass/beaker/mednanobots,/turf/simulated/floor{icon_state = "white"},/area/vault/research)
"aP" = (/obj/structure/table,/obj/item/clothing/suit/straight_jacket,/obj/item/clothing/mask/muzzle,/obj/abstract/map/spawner/misc/medivault,/obj/machinery/light{dir = 1},/turf/simulated/floor{icon_state = "white"},/area/vault/research)
"aQ" = (/obj/structure/table,/obj/item/clothing/mask/surgical,/obj/item/weapon/reagent_containers/food/snacks/monkeycube/wrapped,/obj/item/weapon/reagent_containers/food/snacks/monkeycube/wrapped,/obj/item/weapon/reagent_containers/food/snacks/monkeycube/wrapped,/turf/simulated/floor{icon_state = "white"},/area/vault/research)
"aR" = (/obj/structure/table,/obj/item/weapon/switchtool/surgery,/obj/item/weapon/reagent_containers/spray/cleaner{desc = "Someone has crossed out the Space from Space Cleaner and written in Surgery. 'Do not remove under punishment of death!!!' is scrawled on the back."; name = "Surgery Cleaner"; pixel_x = 0; pixel_y = 0},/obj/effect/decal/cleanable/cobweb2,/obj/item/weapon/barricade_kit,/turf/simulated/floor{icon_state = "white"},/area/vault/research)
"aS" = (/obj/structure/cable{d1 = 1; d2 = 4; icon_state = "1-4"; tag = "90Curve"},/turf/simulated/floor/plating,/area/vault/research)
"aT" = (/obj/machinery/door/airlock/maintenance,/obj/structure/cable{d1 = 4; d2 = 8; icon_state = "4-8"; pixel_y = 0},/turf/simulated/floor/plating,/area/vault/research)
"aU" = (/obj/effect/landmark/corpse/doctor,/obj/structure/cable{d1 = 1; d2 = 8; icon_state = "1-8"},/turf/simulated/floor{icon_state = "dark vault full"},/area/vault/research)
"aV" = (/obj/abstract/map/spawner/misc/medivault,/turf/simulated/floor/plating,/area/vault/research)
"aW" = (/obj/structure/cable{d1 = 1; d2 = 4; icon_state = "1-4"},/turf/simulated/floor/plating,/area/vault/research)
"aX" = (/obj/structure/cable{d2 = 8; icon_state = "0-8"},/turf/simulated/floor/plating,/area/vault/research)
"aY" = (/obj/structure/cable{icon_state = "0-4"; d2 = 4},/obj/item/weapon/wirecutters,/turf/simulated/floor/plating,/area/vault/research)
"aZ" = (/obj/structure/cable{d1 = 1; d2 = 8; icon_state = "1-8"},/obj/structure/cable{d1 = 4; d2 = 8; icon_state = "4-8"; pixel_y = 0},/turf/simulated/floor/plating,/area/vault/research)
"ba" = (/obj/effect/landmark/corpse/engineer,/obj/structure/cable{d1 = 4; d2 = 8; icon_state = "4-8"; pixel_y = 0},/turf/simulated/floor/plating,/area/vault/research)
"bb" = (/obj/machinery/door/airlock/maintenance,/turf/simulated/floor/plating,/area/vault/research)
"bc" = (/obj/effect/decal/cleanable/ash,/turf/simulated/floor{icon_state = "dark-markings"; dir = 8},/area/vault/research)
"bd" = (/obj/abstract/map/spawner/misc/medivault,/turf/simulated/floor{icon_state = "dark"; dir = 6},/area/vault/research)
"be" = (/turf/simulated/floor{icon_state = "dark"; dir = 6},/area/vault/research)
"bf" = (/obj/machinery/door/airlock/vault,/obj/structure/window/barricade/full/block,/turf/simulated/floor{icon_state = "white"},/area/vault/research)
"bg" = (/obj/item/organ/internal/eyes/tajaran,/mob/living/simple_animal/hostile/humanoid/surgeon/boss,/turf/simulated/floor{icon_state = "white"},/area/vault/research)
"bh" = (/obj/item/weapon/scalpel/laser/tier2,/obj/item/weapon/storage/box/monkeycubes,/turf/simulated/floor{icon_state = "white"},/area/vault/research)
"bi" = (/turf/simulated/floor{icon_state = "white"},/area/vault/research)
"bj" = (/obj/structure/table,/obj/item/weapon/storage/firstaid/regular{pixel_x = 6; pixel_y = 2},/obj/item/weapon/storage/firstaid/internalbleed,/turf/simulated/floor{icon_state = "white"},/area/vault/research)
"bk" = (/obj/item/stack/cable_coil,/turf/simulated/floor/plating,/area/vault/research)
"bl" = (/obj/item/weapon/retractor/manager,/turf/simulated/floor{icon_state = "white"},/area/vault/research)
"bm" = (/obj/machinery/optable,/obj/effect/decal/cleanable/blood,/obj/effect/landmark/corpse/stripper,/turf/simulated/floor{icon_state = "white"},/area/vault/research)
"bn" = (/obj/item/organ/internal/lungs/filter,/turf/simulated/floor{icon_state = "white"},/area/vault/research)
"bo" = (/obj/machinery/bioprinter,/turf/simulated/floor{icon_state = "white"},/area/vault/research)
"bp" = (/obj/effect/decal/cleanable/blood,/turf/simulated/floor/plating,/area/vault/research)
"bq" = (/obj/machinery/gibber,/obj/effect/decal/cleanable/cobweb,/turf/simulated/floor{icon_state = "freezerfloor"},/area/vault/research)
"br" = (/obj/item/weapon/reagent_containers/spray/cleaner,/obj/machinery/light{dir = 1},/turf/simulated/floor{icon_state = "freezerfloor"},/area/vault/research)
"bs" = (/obj/effect/landmark/corpse/chef,/turf/simulated/floor{icon_state = "freezerfloor"},/area/vault/research)
"bt" = (/obj/structure/closet/secure_closet/freezer/meat,/turf/simulated/floor{icon_state = "freezerfloor"},/area/vault/research)
"bu" = (/obj/effect/decal/cleanable/cobweb,/turf/simulated/shuttle/floor4,/area/vault/research)
"bv" = (/obj/structure/bed,/obj/item/weapon/bedsheet/orange,/obj/machinery/light/small{dir = 1},/turf/simulated/shuttle/floor4,/area/vault/research)
"bw" = (/obj/effect/landmark/corpse/clown,/turf/simulated/shuttle/floor4,/area/vault/research)
"bx" = (/obj/structure/bed,/obj/item/weapon/bedsheet/clown,/obj/abstract/map/spawner/misc/medivault,/obj/machinery/light/small{dir = 1},/turf/simulated/shuttle/floor4,/area/vault/research)
"by" = (/obj/abstract/map/spawner/mobs/medivault,/turf/simulated/shuttle/floor4,/area/vault/research)
"bz" = (/obj/structure/sign/securearea,/turf/simulated/wall/r_wall,/area/vault/research)
"bA" = (/obj/structure/sign/greencross,/turf/simulated/wall/r_wall,/area/vault/research)
"bB" = (/obj/structure/noticeboard,/turf/simulated/wall/r_wall,/area/vault/research)
"bC" = (/obj/structure/window/barricade/full,/turf/simulated/floor/plating,/area/vault/research)
"bD" = (/obj/item/weapon/kitchen/utensil/knife/large/butch/meatcleaver,/turf/simulated/floor{icon_state = "freezerfloor"},/area/vault/research)
"bE" = (/obj/abstract/map/spawner/mobs/medivault,/turf/simulated/floor{icon_state = "freezerfloor"},/area/vault/research)
"bF" = (/turf/simulated/floor{icon_state = "freezerfloor"},/area/vault/research)
"bG" = (/obj/structure/sink{dir = 4; pixel_x = 11},/turf/simulated/floor{icon_state = "freezerfloor"},/area/vault/research)
"bH" = (/turf/simulated/shuttle/floor4,/area/vault/research)
"bI" = (/obj/item/toy/crayon/rainbow,/turf/simulated/shuttle/floor4,/area/vault/research)
"bJ" = (/obj/item/weapon/storage/backpack/clown,/turf/simulated/shuttle/floor4,/area/vault/research)
"bK" = (/obj/effect/decal/cleanable/blood,/turf/simulated/shuttle/floor4,/area/vault/research)
"bL" = (/obj/effect/decal/remains,/turf/simulated/shuttle/floor4,/area/vault/research)
"bM" = (/turf/simulated/floor{dir = 1; icon_state = "whiteblue"},/area/vault/research)
"bN" = (/obj/machinery/chem_master,/turf/simulated/floor{dir = 1; icon_state = "whiteblue"},/area/vault/research)
"bO" = (/obj/structure/table,/obj/machinery/reagentgrinder,/obj/machinery/light{dir = 1},/turf/simulated/floor{dir = 1; icon_state = "whiteblue"},/area/vault/research)
"bP" = (/obj/machinery/chem_dispenser,/turf/simulated/floor{dir = 1; icon_state = "whiteblue"},/area/vault/research)
"bQ" = (/obj/machinery/door/airlock/freezer,/turf/simulated/floor,/area/vault/research)
"bR" = (/obj/machinery/door/airlock/vault,/turf/simulated/floor,/area/vault/research)
"bS" = (/obj/structure/grille,/obj/structure/window/full/plasma,/turf/simulated/floor,/area/vault/research)
"bT" = (/obj/item/weapon/reagent_containers/glass/beaker/bluespace/large,/turf/simulated/floor{icon_state = "white"},/area/vault/research)
"bU" = (/obj/item/clothing/under/rank/chemist,/turf/simulated/floor{icon_state = "white"},/area/vault/research)
"bV" = (/obj/effect/landmark/corpse/doctor,/turf/simulated/floor{icon_state = "white"},/area/vault/research)
"bW" = (/obj/structure/sign/chemtable,/turf/simulated/wall/r_wall,/area/vault/research)
"bX" = (/obj/structure/table,/obj/item/weapon/storage/box/beakers,/obj/item/weapon/storage/box/beakers,/obj/item/stack/medical/advanced/bruise_pack{pixel_x = 0; pixel_y = 0},/turf/simulated/floor{icon_state = "white"},/area/vault/research)
"bY" = (/obj/structure/table,/obj/item/weapon/storage/box/autoinjectors,/obj/item/weapon/storage/box/pillbottles{pixel_x = 6; pixel_y = 4},/turf/simulated/floor{icon_state = "white"},/area/vault/research)
"bZ" = (/obj/structure/table/woodentable,/obj/machinery/microwave,/turf/simulated/floor/wood,/area/vault/research)
"ca" = (/obj/structure/table/woodentable,/obj/machinery/chem_dispenser/booze_dispenser,/turf/simulated/floor/wood,/area/vault/research)
"cb" = (/turf/simulated/floor/wood,/area/vault/research)
"cc" = (/obj/machinery/light{dir = 1},/turf/simulated/floor/wood,/area/vault/research)
"cd" = (/turf/simulated/floor/wood{broken = 1; icon_state = "wood-broken6"},/area/vault/research)
"ce" = (/turf/simulated/floor{blocks_air = 1; icon_state = "dark"},/area/vault/research)
"cf" = (/obj/effect/decal/cleanable/blood,/turf/simulated/floor{blocks_air = 1; icon_state = "dark"},/area/vault/research)
"cg" = (/obj/machinery/door/airlock/vault,/turf/simulated/floor{blocks_air = 1; icon_state = "dark"},/area/vault/research)
"ch" = (/obj/abstract/map/spawner/mobs/medivault,/turf/simulated/floor{icon_state = "white"},/area/vault/research)
"ci" = (/obj/abstract/map/spawner/misc/medivault,/turf/simulated/floor{icon_state = "white"},/area/vault/research)
"cj" = (/obj/machinery/vending/medical,/turf/simulated/floor{icon_state = "white"},/area/vault/research)
"ck" = (/obj/item/weapon/reagent_containers/dropper,/turf/simulated/floor{icon_state = "white"},/area/vault/research)
"cl" = (/obj/structure/table,/obj/item/weapon/storage/box/masks,/obj/item/weapon/storage/box/gloves{pixel_x = 6; pixel_y = 4},/turf/simulated/floor{icon_state = "white"},/area/vault/research)
"cm" = (/obj/machinery/light/small{dir = 1},/turf/simulated/shuttle/floor4,/area/vault/research)
"cn" = (/obj/abstract/map/spawner/misc/medivault,/turf/simulated/shuttle/floor4,/area/vault/research)
"co" = (/obj/item/weapon/storage/firstaid,/turf/simulated/floor/wood,/area/vault/research)
"cp" = (/obj/structure/table/woodentable,/obj/item/weapon/reagent_containers/glass/rag,/turf/simulated/floor/wood,/area/vault/research)
"cq" = (/obj/effect/decal/cleanable/blood,/turf/simulated/floor{icon_state = "white"},/area/vault/research)
"cr" = (/obj/machinery/bot/medbot,/turf/simulated/floor{icon_state = "white"},/area/vault/research)
"cs" = (/obj/machinery/door/airlock/glass_science,/turf/simulated/floor{icon_state = "white"},/area/vault/research)
"ct" = (/obj/structure/table,/obj/abstract/map/spawner/medical/pills,/obj/machinery/light{dir = 4},/turf/simulated/floor{icon_state = "white"},/area/vault/research)
"cu" = (/obj/item/weapon/tank/jetpack/oxygen,/turf/simulated/shuttle/floor4,/area/vault/research)
"cv" = (/obj/structure/table/woodentable,/obj/item/weapon/paper_bin,/turf/simulated/floor/wood,/area/vault/research)
"cw" = (/obj/structure/table/woodentable,/obj/item/weapon/pen,/turf/simulated/floor/wood,/area/vault/research)
"cx" = (/obj/structure/table/woodentable,/obj/item/weapon/storage/box/donkpockets,/turf/simulated/floor/wood,/area/vault/research)
"cy" = (/obj/structure/table/woodentable,/turf/simulated/floor/wood,/area/vault/research)
"cz" = (/obj/item/weapon/reagent_containers/glass/beaker/noreact,/turf/simulated/shuttle/floor4,/area/vault/research)
"cA" = (/obj/effect/decal/cleanable/cobweb2,/obj/item/weapon/reagent_containers/food/snacks/braincakeslice,/turf/simulated/shuttle/floor4,/area/vault/research)
"cB" = (/obj/item/weapon/reagent_containers/glass/beaker/large,/obj/structure/sink{dir = 8; pixel_x = -12; pixel_y = 0},/turf/simulated/floor{icon_state = "white"},/area/vault/research)
"cC" = (/obj/machinery/iv_drip,/turf/simulated/floor{icon_state = "white"},/area/vault/research)
"cD" = (/obj/structure/table,/obj/abstract/map/spawner/medical/pills,/turf/simulated/floor{icon_state = "white"},/area/vault/research)
"cE" = (/obj/item/weapon/stool,/obj/machinery/light{dir = 8},/turf/simulated/floor/wood,/area/vault/research)
"cF" = (/obj/item/weapon/stool,/turf/simulated/floor/wood,/area/vault/research)
"cG" = (/obj/structure/bed,/obj/item/weapon/bedsheet/orange,/obj/machinery/light/small,/turf/simulated/shuttle/floor4,/area/vault/research)
"cH" = (/obj/item/weapon/reagent_containers/glass/beaker/bluespace/large,/turf/simulated/shuttle/floor4,/area/vault/research)
"cI" = (/obj/structure/bed,/obj/item/weapon/bedsheet/medical,/turf/simulated/floor{icon_state = "white"},/area/vault/research)
"cJ" = (/obj/structure/bed,/obj/item/weapon/bedsheet/medical,/obj/machinery/light,/turf/simulated/floor{icon_state = "white"},/area/vault/research)
"cK" = (/obj/structure/table,/obj/structure/bedsheetbin,/turf/simulated/floor{icon_state = "white"},/area/vault/research)
"cL" = (/obj/structure/table,/obj/item/weapon/reagent_containers/blood/OPlus,/obj/item/weapon/reagent_containers/blood/OPlus,/obj/item/weapon/reagent_containers/blood/OPlus,/obj/item/stack/medical/advanced/ointment,/obj/item/weapon/reagent_containers/glass/beaker/noreact,/obj/item/weapon/switchtool/surgery,/turf/simulated/floor{icon_state = "white"},/area/vault/research)
"cM" = (/obj/structure/table,/obj/item/weapon/storage/firstaid/regular{pixel_x = 6; pixel_y = 2},/obj/item/weapon/storage/firstaid/regular{pixel_x = -2; pixel_y = 2},/obj/item/weapon/storage/firstaid/internalbleed,/turf/simulated/floor{icon_state = "white"},/area/vault/research)
"cN" = (/obj/abstract/map/spawner/mobs/medivault,/turf/simulated/floor{blocks_air = 1; icon_state = "dark"},/area/vault/research)
"cO" = (/obj/structure/closet/wardrobe/red,/turf/simulated/floor{blocks_air = 1; icon_state = "dark"},/area/vault/research)
"cP" = (/obj/effect/landmark/corpse/doctor,/turf/simulated/floor/wood,/area/vault/research)
"cQ" = (/turf/simulated/floor/wood{broken = 1; icon_state = "wood-broken"},/area/vault/research)
"cR" = (/obj/abstract/map/spawner/mobs/medivault,/turf/simulated/floor/wood,/area/vault/research)
"cS" = (/obj/machinery/door/airlock/vault,/turf/simulated/floor{icon_state = "white"},/area/vault/research)
"cT" = (/obj/structure/table,/obj/item/weapon/storage/box/sunglasses,/obj/item/weapon/storage/box/smokebombs{pixel_x = 3; pixel_y = 5},/turf/simulated/floor{blocks_air = 1; icon_state = "dark"},/area/vault/research)
"cU" = (/obj/structure/closet/secure_closet/security,/turf/simulated/floor{blocks_air = 1; icon_state = "dark"},/area/vault/research)
"cV" = (/obj/item/weapon/reagent_containers/food/drinks/coffee,/turf/simulated/floor/wood,/area/vault/research)
"cW" = (/obj/effect/decal/cleanable/blood,/turf/simulated/floor/wood,/area/vault/research)
"cX" = (/obj/machinery/light,/turf/simulated/floor/wood,/area/vault/research)
"cY" = (/obj/machinery/door/airlock/glass_science,/turf/simulated/floor,/area/vault/research)
"cZ" = (/turf/simulated/floor,/area/vault/research)
"da" = (/obj/structure/table,/obj/item/weapon/paper/pamphlet/medivault,/obj/machinery/light{dir = 1},/turf/simulated/floor,/area/vault/research)
"db" = (/obj/structure/table,/turf/simulated/floor,/area/vault/research)
"dc" = (/obj/structure/table,/obj/item/weapon/disk/shuttle_coords/vault/research,/turf/simulated/floor,/area/vault/research)
"dd" = (/obj/structure/table,/obj/machinery/light{dir = 1},/turf/simulated/floor,/area/vault/research)
"de" = (/obj/effect/decal/cleanable/blood,/turf/simulated/floor,/area/vault/research)
"df" = (/obj/machinery/light{dir = 1},/turf/simulated/floor,/area/vault/research)
"dg" = (/obj/machinery/vending/snack,/turf/simulated/floor,/area/vault/research)
"dh" = (/obj/machinery/vending/coffee,/turf/simulated/floor,/area/vault/research)
"di" = (/turf/simulated/floor{icon_state = "red"; dir = 5},/area/vault/research)
"dj" = (/obj/machinery/door/airlock/security{name = "Armory"; req_access = null; req_access_txt = "3"},/turf/simulated/floor,/area/vault/research)
"dk" = (/obj/structure/closet/secure_closet/security,/obj/machinery/light{dir = 4},/turf/simulated/floor{blocks_air = 1; icon_state = "dark"},/area/vault/research)
"dl" = (/obj/machinery/door/airlock/glass_science,/turf/simulated/floor/wood,/area/vault/research)
"dm" = (/obj/structure/mirror,/turf/simulated/wall/r_wall,/area/vault/research)
"dn" = (/obj/machinery/light/small{dir = 8},/turf/simulated/floor,/area/vault/research)
"do" = (/obj/structure/sign/biohazard,/turf/simulated/wall/r_wall,/area/vault/research)
"dp" = (/turf/simulated/floor{icon_state = "red"; dir = 4},/area/vault/research)
"dq" = (/obj/structure/table,/obj/item/weapon/storage/lockbox/loyalty,/turf/simulated/floor{blocks_air = 1; icon_state = "dark"},/area/vault/research)
"dr" = (/obj/effect/decal/cleanable/cobweb,/turf/simulated/floor/carpet,/area/vault/research)
"ds" = (/obj/effect/landmark/corpse/doctor,/turf/simulated/floor/carpet,/area/vault/research)
"dt" = (/obj/structure/closet/cabinet/medivault,/turf/simulated/floor/carpet,/area/vault/research)
"du" = (/obj/structure/rack,/obj/item/clothing/suit/bio_suit/virology,/obj/item/clothing/head/bio_hood/virology,/turf/simulated/floor,/area/vault/research)
"dv" = (/obj/structure/flora/pottedplant,/turf/simulated/floor,/area/vault/research)
"dw" = (/obj/machinery/light,/turf/simulated/floor,/area/vault/research)
"dx" = (/obj/effect/landmark/corpse/engineer,/turf/simulated/floor,/area/vault/research)
"dy" = (/obj/structure/flora/pottedplant,/turf/simulated/floor{icon_state = "red"; dir = 6},/area/vault/research)
"dz" = (/obj/abstract/map/spawner/misc/medivault,/turf/simulated/floor{blocks_air = 1; icon_state = "dark"},/area/vault/research)
"dA" = (/obj/item/weapon/storage/box/emps,/turf/simulated/floor{blocks_air = 1; icon_state = "dark"},/area/vault/research)
"dB" = (/obj/machinery/door/airlock/maintenance,/turf/simulated/floor{blocks_air = 1; icon_state = "dark"},/area/vault/research)
"dC" = (/obj/machinery/door/airlock/research,/turf/simulated/floor/carpet,/area/vault/research)
"dD" = (/obj/abstract/map/spawner/mobs/medivault,/turf/simulated/floor/carpet,/area/vault/research)
"dE" = (/obj/item/weapon/storage/pill_bottle/dice,/turf/simulated/floor/carpet,/area/vault/research)
"dF" = (/obj/structure/bed,/obj/item/weapon/bedsheet/green,/obj/machinery/light/small{dir = 4},/turf/simulated/floor/carpet,/area/vault/research)
"dG" = (/obj/machinery/door/window/plasma,/turf/simulated/floor/wood,/area/vault/research)
"dH" = (/turf/simulated/floor/carpet,/area/vault/research)
"dI" = (/obj/item/weapon/stool,/obj/effect/landmark/corpse/commander,/turf/simulated/floor/carpet,/area/vault/research)
"dJ" = (/obj/structure/table/woodentable,/turf/simulated/floor/carpet,/area/vault/research)
"dK" = (/obj/machinery/suit_storage_unit/security,/turf/simulated/floor{blocks_air = 1; icon_state = "dark"},/area/vault/research)
"dL" = (/obj/machinery/suit_storage_unit/security,/obj/machinery/light,/turf/simulated/floor{blocks_air = 1; icon_state = "dark"},/area/vault/research)
"dM" = (/obj/machinery/light{dir = 8},/turf/simulated/floor/wood,/area/vault/research)
"dN" = (/obj/structure/table/woodentable,/obj/item/weapon/phone,/turf/simulated/floor/carpet,/area/vault/research)
"dO" = (/turf/simulated/floor/wood{broken = 1; icon_state = "wood-broken3"},/area/vault/research)
"dP" = (/obj/structure/rack,/obj/item/clothing/suit/space/ancient,/obj/item/clothing/head/helmet/space/ancient,/obj/effect/decal/cleanable/cobweb,/obj/machinery/light/small{dir = 1},/turf/simulated/floor{dir = 1; icon_state = "blue"},/area/vault/research)
"dQ" = (/obj/structure/dispenser/oxygen,/turf/simulated/floor{dir = 1; icon_state = "blue"},/area/vault/research)
"dR" = (/obj/machinery/portable_atmospherics/canister/oxygen,/turf/simulated/floor,/area/vault/research)
"dS" = (/obj/abstract/map/spawner/mobs/medivault,/turf/simulated/floor{dir = 9; icon_state = "yellowfull"},/area/vault/research)
"dT" = (/obj/structure/table,/obj/item/stack/sheet/metal{amount = 50},/obj/item/stack/sheet/mineral/plastic{amount = 50},/obj/item/stack/sheet/glass/glass{amount = 50},/obj/structure/table,/obj/machinery/light/small{dir = 1},/turf/simulated/floor{dir = 9; icon_state = "yellowfull"},/area/vault/research)
"dU" = (/obj/item/weapon/storage/toolbox/syndicate,/obj/effect/decal/cleanable/cobweb,/turf/simulated/floor/carpet,/area/vault/research)
"dV" = (/obj/effect/decal/cleanable/blood,/turf/simulated/floor/carpet,/area/vault/research)
"dW" = (/obj/machinery/door/airlock/external,/turf/simulated/floor/wood,/area/vault/research)
"dX" = (/obj/machinery/door/airlock/external,/turf/simulated/floor,/area/vault/research)
"dY" = (/obj/structure/table,/obj/item/weapon/storage/toolbox/electrical,/obj/abstract/map/spawner/misc/medivault,/turf/simulated/floor{dir = 9; icon_state = "yellowfull"},/area/vault/research)
"dZ" = (/obj/structure/table,/obj/structure/table,/obj/item/weapon/storage/toolbox/mechanical,/turf/simulated/floor{dir = 9; icon_state = "yellowfull"},/area/vault/research)
"ea" = (/obj/machinery/door/airlock/maintenance,/obj/structure/window/barricade/full/block,/turf/simulated/floor/plating,/area/vault/research)
"eb" = (/obj/structure/reagent_dispensers/fueltank,/turf/simulated/floor/plating,/area/vault/research)
"ec" = (/obj/item/clothing/under/rank/centcom/officer,/obj/item/clothing/head/beret/centcom/officer,/turf/simulated/floor/carpet,/area/vault/research)
"ed" = (/obj/abstract/map/spawner/misc/medivault,/turf/simulated/floor/carpet,/area/vault/research)
"ee" = (/obj/structure/flora/pottedplant,/obj/machinery/light,/turf/simulated/floor/wood,/area/vault/research)
"ef" = (/obj/machinery/door/airlock/external,/obj/docking_port/destination/vault/research{dir = 2},/turf/simulated/floor/plating,/area/vault/research)

(1,1,1) = {"
aaaaaaaaaaaaaaaaaaaaaaaaaaaaaaaaaaaaaaaaaaaaaaaaaaaaaaaaaaaaaaaa
aaabababababababababababaaaaaaaaaaaaaaaaaaaaaaaaabababababababab
aaabacadaeabafagahaiaiababababababababababababababajakakakalamab
aaabanaoanabapaqarasatauavawawaxawawawawawaxawayabakakazakakaAab
aaabaBavaCabaDaoanaoaEabanabababababababaFababanabaGaHakakakaIab
abababaJaKabababaJabababanabaLaMaNabaOaPaQaRabaSaTaUakakakakakab
abaVaoaWaxawaXaYaZbaawawaCbbbcbdbebfbgbhbibjabaoabakakakakakakab
abbkabababbbababababababababababababblbmbnboabbpabababababababab
abaoabbqbrbsbtbtabbubvabbwbxabbybvabbfbzbAbBabaoaobCaoaqaobCaoab
abaoabbDbEbFbFbGabbybHabbIbJabbKbLabbMbNbObPababababaEaEaEabaoab
abaoabababbQabababbRbSabbRbSabbRbSabbTbibUbVbWbXbYabababababaoab
abaoabbZcacbcccdabcececfcecececececgbichcicjabckclabbycmcnabaoab
abaobbcbcocbcpcbabbRbSabbRbSabbRbSabbicqcrbicschctabbHbKcuabaoab
abaoabcvcwcxcycbabbyczabbybHabbHcAabcBcicCchabbTcDabcgbSababaoab
abaoabcEcFcFcFcbabbLcGabcHcGabbycGabcIbicJcKabcLcMabcecNcOabaqab
abaoabcPcbcQcRcbabababababababababababcSbzabababababcTcecUabaoab
abaoabcbcVcWcXcbcYcZdadbdcddcZbRdecZbRcZdfdgdhdfdidjcfcNdkabbpab
abaoabdlababdmababcZcZdecZcZcZbAdncZdocZdecZcZcZdpabdqcecUabaoab
abaqabcbabdrdsdtabbRababababbRabduduabdvdwcZdedxdyabdzcedAdBaoab
abaoabcbdCdDdEdFabcbdGdHdIdJcbababababababababbbababdKdLdKabaoab
abaobbcWababdmababdMcbdJdJdNdOabdPdQabcZdfdRabdSdTabababababaoab
abaoabcbabdUdVdtabcbcbcbcRcbcbdWcZcZdXcZdecZabdYdZeaaoaoaoaoaqab
abebabcbdCeceddFabeecdcbcWcbeeababababcZcZcZabababababababababab
ababababababababababababababababaaaaababefababaaaaaaaaaaaaaaaaaa
aaaaaaaaaaaaaaaaaaaaaaaaaaaaaaaaaaaaaaaaaaaaaaaaaaaaaaaaaaaaaaaa
"}
