"aa" = (/turf/space,/area)
"ab" = (/turf/simulated/wall/r_wall,/area/vault/research)
"ac" = (/turf/simulated/floor/plating,/area/vault/research)
"ad" = (/obj/item/stack/cable_coil,/obj/structure/table,/obj/item/stack/sheet/mineral/uranium{amount = 25},/turf/simulated/floor/plating,/area/vault/research)
"ae" = (/obj/structure/table,/turf/simulated/floor/plating,/area/vault/research)
"af" = (/obj/structure/table,/obj/item/weapon/storage/toolbox/emergency,/turf/simulated/floor/plating,/area/vault/research)
"ag" = (/obj/structure/table,/obj/item/weapon/storage/toolbox/mechanical,/obj/item/weapon/storage/box/monkeycubes/farwacubes,/obj/machinery/light{dir = 1},/turf/simulated/floor/plating,/area/vault/research)
"ah" = (/obj/structure/table,/obj/item/weapon/storage/toolbox/electrical,/turf/simulated/floor/plating,/area/vault/research)
"ai" = (/obj/structure/cable{d2 = 2; icon_state = "0-2"; pixel_y = 0},/turf/simulated/floor/plating,/area/vault/research)
"aj" = (/obj/machinery/vending/engivend,/turf/simulated/floor/plating,/area/vault/research)
"ak" = (/obj/abstract/map/spawner/mobs/medivault,/turf/simulated/floor/plating,/area/vault/research)
"al" = (/obj/abstract/map/spawner/misc/medivault,/obj/structure/cable{d1 = 2; d2 = 4; icon_state = "2-4"},/turf/simulated/floor/plating,/area/vault/research)
"am" = (/obj/abstract/map/spawner/mobs/medivault,/obj/structure/cable{d2 = 8; icon_state = "0-8"},/turf/simulated/floor/plating,/area/vault/research)
"an" = (/obj/item/toy/gasha/clown,/turf/simulated/floor/plating,/area/vault/research)
"ao" = (/obj/machinery/power/apc/frame/research_vault,/turf/simulated/wall/r_wall,/area/vault/research)
"ap" = (/obj/structure/cable{d1 = 1; d2 = 2; icon_state = "1-2"; pixel_y = 0},/turf/simulated/floor/plating,/area/vault/research)
"aq" = (/obj/machinery/power/port_gen/pacman/super,/turf/simulated/floor/plating,/area/vault/research)
"ar" = (/obj/machinery/vending/tool,/turf/simulated/floor/plating,/area/vault/research)
"as" = (/obj/machinery/portable_atmospherics/canister/oxygen,/turf/simulated/floor/plating,/area/vault/research)
"at" = (/obj/machinery/vending/wallmed1{pixel_y = 0},/turf/simulated/wall/r_wall,/area/vault/research)
"au" = (/obj/machinery/suit_storage_unit/atmos,/turf/simulated/floor/plating,/area/vault/research)
"av" = (/obj/structure/dispenser/oxygen,/turf/simulated/floor/plating,/area/vault/research)
"aw" = (/obj/machinery/door/airlock/maintenance,/obj/structure/cable{d1 = 1; d2 = 2; icon_state = "1-2"; pixel_y = 0},/turf/simulated/floor/plating,/area/vault/research)
"ax" = (/obj/structure/sign/electricshock,/turf/simulated/wall/r_wall,/area/vault/research)
"ay" = (/obj/structure/crematorium,/turf/simulated/floor{icon_state = "dark"; dir = 6},/area/vault/research)
"az" = (/obj/abstract/map/spawner/mobs/medivault,/obj/machinery/light{dir = 1},/turf/simulated/floor{icon_state = "dark"; dir = 6},/area/vault/research)
"aA" = (/obj/machinery/vending/chapel,/turf/simulated/floor{icon_state = "dark"; dir = 6},/area/vault/research)
"aB" = (/obj/structure/table,/obj/item/weapon/storage/box/handcuffs,/obj/item/weapon/reagent_containers/glass/beaker/mednanobots,/turf/simulated/floor{icon_state = "white"},/area/vault/research)
"aC" = (/obj/structure/table,/obj/item/clothing/suit/straight_jacket,/obj/item/clothing/mask/muzzle,/obj/abstract/map/spawner/misc/medivault,/obj/machinery/light{dir = 1},/turf/simulated/floor{icon_state = "white"},/area/vault/research)
"aD" = (/obj/structure/table,/obj/item/clothing/mask/surgical,/obj/item/weapon/reagent_containers/food/snacks/monkeycube/wrapped,/obj/item/weapon/reagent_containers/food/snacks/monkeycube/wrapped,/obj/item/weapon/reagent_containers/food/snacks/monkeycube/wrapped,/turf/simulated/floor{icon_state = "white"},/area/vault/research)
"aE" = (/obj/structure/table,/obj/item/weapon/switchtool/surgery,/obj/item/weapon/reagent_containers/spray/cleaner{desc = "Someone has crossed out the Space from Space Cleaner and written in Surgery. 'Do not remove under punishment of death!!!' is scrawled on the back."; name = "Surgery Cleaner"; pixel_x = 0; pixel_y = 0},/obj/effect/decal/cleanable/cobweb2,/turf/simulated/floor{icon_state = "white"},/area/vault/research)
"aF" = (/obj/machinery/door/airlock/maintenance,/turf/simulated/floor/plating,/area/vault/research)
"aG" = (/obj/effect/landmark/corpse/doctor,/turf/simulated/floor/plating,/area/vault/research)
"aH" = (/obj/structure/table,/obj/item/weapon/storage/firstaid,/obj/abstract/map/spawner/misc/medivault,/obj/machinery/light{dir = 4},/turf/simulated/floor/plating,/area/vault/research)
"aI" = (/obj/abstract/map/spawner/misc/medivault,/turf/simulated/floor/plating,/area/vault/research)
"aJ" = (/obj/structure/cable{d1 = 1; d2 = 4; icon_state = "1-4"},/turf/simulated/floor/plating,/area/vault/research)
"aK" = (/obj/abstract/map/spawner/mobs/medivault,/obj/structure/cable{d1 = 4; d2 = 8; icon_state = "4-8"; pixel_y = 0},/turf/simulated/floor/plating,/area/vault/research)
"aL" = (/obj/structure/cable{d1 = 4; d2 = 8; icon_state = "4-8"; pixel_y = 0},/turf/simulated/floor/plating,/area/vault/research)
"aM" = (/obj/structure/cable{d2 = 8; icon_state = "0-8"},/turf/simulated/floor/plating,/area/vault/research)
"aN" = (/obj/structure/cable{icon_state = "0-4"; d2 = 4},/obj/item/weapon/wirecutters,/turf/simulated/floor/plating,/area/vault/research)
"aO" = (/obj/structure/cable{d1 = 1; d2 = 8; icon_state = "1-8"},/turf/simulated/floor/plating,/area/vault/research)
"aP" = (/obj/effect/landmark/corpse/engineer,/turf/simulated/floor/plating,/area/vault/research)
"aQ" = (/obj/effect/decal/cleanable/ash,/turf/simulated/floor{icon_state = "dark-markings"; dir = 8},/area/vault/research)
"aR" = (/obj/abstract/map/spawner/misc/medivault,/turf/simulated/floor{icon_state = "dark"; dir = 6},/area/vault/research)
"aS" = (/turf/simulated/floor{icon_state = "dark"; dir = 6},/area/vault/research)
"aT" = (/obj/machinery/door/airlock/vault,/turf/simulated/floor{icon_state = "white"},/area/vault/research)
"aU" = (/obj/item/organ/internal/eyes/tajaran,/turf/simulated/floor{icon_state = "white"},/area/vault/research)
"aV" = (/obj/item/weapon/scalpel/laser/tier2,/obj/item/weapon/storage/box/monkeycubes,/turf/simulated/floor{icon_state = "white"},/area/vault/research)
"aW" = (/mob/living/simple_animal/hostile/humanoid/surgeon/boss,/turf/simulated/floor{icon_state = "white"},/area/vault/research)
"aX" = (/obj/structure/table,/obj/item/weapon/storage/firstaid/regular{pixel_x = 6; pixel_y = 2},/turf/simulated/floor{icon_state = "white"},/area/vault/research)
"aY" = (/obj/structure/table,/obj/item/weapon/dice/d20/cursed,/turf/simulated/floor/plating,/area/vault/research)
"aZ" = (/obj/item/stack/cable_coil,/turf/simulated/floor/plating,/area/vault/research)
"ba" = (/obj/item/weapon/retractor/manager,/turf/simulated/floor{icon_state = "white"},/area/vault/research)
"bb" = (/obj/machinery/optable,/obj/effect/decal/cleanable/blood,/turf/simulated/floor{icon_state = "white"},/area/vault/research)
"bc" = (/obj/item/organ/internal/lungs/filter,/turf/simulated/floor{icon_state = "white"},/area/vault/research)
"bd" = (/obj/machinery/bioprinter,/turf/simulated/floor{icon_state = "white"},/area/vault/research)
"be" = (/obj/effect/decal/cleanable/blood,/turf/simulated/floor/plating,/area/vault/research)
"bf" = (/obj/machinery/gibber,/obj/effect/decal/cleanable/cobweb,/turf/simulated/floor{icon_state = "freezerfloor"},/area/vault/research)
"bg" = (/obj/item/weapon/reagent_containers/spray/cleaner,/obj/machinery/light{dir = 1},/turf/simulated/floor{icon_state = "freezerfloor"},/area/vault/research)
"bh" = (/obj/effect/landmark/corpse/chef,/turf/simulated/floor{icon_state = "freezerfloor"},/area/vault/research)
"bi" = (/obj/structure/closet/secure_closet/freezer/meat,/turf/simulated/floor{icon_state = "freezerfloor"},/area/vault/research)
"bj" = (/obj/effect/decal/cleanable/cobweb,/turf/simulated/shuttle/floor4,/area/vault/research)
"bk" = (/obj/structure/bed,/obj/item/weapon/bedsheet/orange,/obj/machinery/light/small{dir = 1},/turf/simulated/shuttle/floor4,/area/vault/research)
"bl" = (/obj/effect/landmark/corpse/clown,/turf/simulated/shuttle/floor4,/area/vault/research)
"bm" = (/obj/structure/bed,/obj/item/weapon/bedsheet/clown,/obj/abstract/map/spawner/misc/medivault,/obj/machinery/light/small{dir = 1},/turf/simulated/shuttle/floor4,/area/vault/research)
"bn" = (/obj/abstract/map/spawner/mobs/medivault,/turf/simulated/shuttle/floor4,/area/vault/research)
"bo" = (/obj/structure/sign/securearea,/turf/simulated/wall/r_wall,/area/vault/research)
"bp" = (/obj/structure/sign/greencross,/turf/simulated/wall/r_wall,/area/vault/research)
"bq" = (/obj/structure/noticeboard,/turf/simulated/wall/r_wall,/area/vault/research)
"br" = (/obj/item/weapon/kitchen/utensil/knife/large/butch/meatcleaver,/turf/simulated/floor{icon_state = "freezerfloor"},/area/vault/research)
"bs" = (/obj/abstract/map/spawner/mobs/medivault,/turf/simulated/floor{icon_state = "freezerfloor"},/area/vault/research)
"bt" = (/turf/simulated/floor{icon_state = "freezerfloor"},/area/vault/research)
"bu" = (/obj/structure/sink{dir = 4; pixel_x = 11},/turf/simulated/floor{icon_state = "freezerfloor"},/area/vault/research)
"bv" = (/turf/simulated/shuttle/floor4,/area/vault/research)
"bw" = (/obj/item/toy/crayon/rainbow,/turf/simulated/shuttle/floor4,/area/vault/research)
"bx" = (/obj/item/weapon/storage/backpack/clown,/turf/simulated/shuttle/floor4,/area/vault/research)
"by" = (/obj/effect/decal/cleanable/blood,/turf/simulated/shuttle/floor4,/area/vault/research)
"bz" = (/obj/effect/decal/remains,/turf/simulated/shuttle/floor4,/area/vault/research)
"bA" = (/turf/simulated/floor{dir = 1; icon_state = "whiteblue"},/area/vault/research)
"bB" = (/obj/machinery/chem_master,/turf/simulated/floor{dir = 1; icon_state = "whiteblue"},/area/vault/research)
"bC" = (/obj/structure/table,/obj/machinery/reagentgrinder,/obj/machinery/light{dir = 1},/turf/simulated/floor{dir = 1; icon_state = "whiteblue"},/area/vault/research)
"bD" = (/obj/machinery/chem_dispenser,/turf/simulated/floor{dir = 1; icon_state = "whiteblue"},/area/vault/research)
"bE" = (/obj/item/toy/syndicateballoon,/turf/simulated/floor/plating,/area/vault/research)
"bF" = (/obj/machinery/door/airlock/freezer,/turf/simulated/floor,/area/vault/research)
"bG" = (/obj/machinery/door/airlock/vault,/turf/simulated/floor,/area/vault/research)
"bH" = (/obj/structure/grille,/obj/structure/window/full/plasma,/turf/simulated/floor,/area/vault/research)
"bI" = (/obj/item/weapon/reagent_containers/glass/beaker/bluespace/large,/turf/simulated/floor{icon_state = "white"},/area/vault/research)
"bJ" = (/turf/simulated/floor{icon_state = "white"},/area/vault/research)
"bK" = (/obj/item/clothing/under/rank/chemist,/turf/simulated/floor{icon_state = "white"},/area/vault/research)
"bL" = (/obj/effect/landmark/corpse/doctor,/turf/simulated/floor{icon_state = "white"},/area/vault/research)
"bM" = (/obj/structure/sign/chemtable,/turf/simulated/wall/r_wall,/area/vault/research)
"bN" = (/obj/structure/table,/obj/item/weapon/storage/box/beakers,/obj/item/weapon/storage/box/beakers,/obj/item/stack/medical/advanced/bruise_pack{pixel_x = 0; pixel_y = 0},/turf/simulated/floor{icon_state = "white"},/area/vault/research)
"bO" = (/obj/structure/table,/obj/item/weapon/storage/box/autoinjectors,/obj/item/weapon/storage/box/pillbottles{pixel_x = 6; pixel_y = 4},/turf/simulated/floor{icon_state = "white"},/area/vault/research)
"bP" = (/obj/structure/table/woodentable,/obj/machinery/microwave,/turf/simulated/floor/wood,/area/vault/research)
"bQ" = (/obj/structure/table/woodentable,/obj/machinery/chem_dispenser/booze_dispenser,/turf/simulated/floor/wood,/area/vault/research)
"bR" = (/turf/simulated/floor/wood,/area/vault/research)
"bS" = (/obj/machinery/light{dir = 1},/turf/simulated/floor/wood,/area/vault/research)
"bT" = (/turf/simulated/floor/wood{broken = 1; icon_state = "wood-broken6"},/area/vault/research)
"bU" = (/turf/simulated/floor{blocks_air = 1; icon_state = "dark"},/area/vault/research)
"bV" = (/obj/effect/decal/cleanable/blood,/turf/simulated/floor{blocks_air = 1; icon_state = "dark"},/area/vault/research)
"bW" = (/obj/machinery/door/airlock/vault,/turf/simulated/floor{blocks_air = 1; icon_state = "dark"},/area/vault/research)
"bX" = (/obj/abstract/map/spawner/mobs/medivault,/turf/simulated/floor{icon_state = "white"},/area/vault/research)
"bY" = (/obj/abstract/map/spawner/misc/medivault,/turf/simulated/floor{icon_state = "white"},/area/vault/research)
"bZ" = (/obj/machinery/vending/medical,/turf/simulated/floor{icon_state = "white"},/area/vault/research)
"ca" = (/obj/item/weapon/reagent_containers/dropper,/turf/simulated/floor{icon_state = "white"},/area/vault/research)
"cb" = (/obj/structure/table,/obj/item/weapon/storage/box/masks,/obj/item/weapon/storage/box/gloves{pixel_x = 6; pixel_y = 4},/turf/simulated/floor{icon_state = "white"},/area/vault/research)
"cc" = (/obj/machinery/light/small{dir = 1},/turf/simulated/shuttle/floor4,/area/vault/research)
"cd" = (/obj/abstract/map/spawner/misc/medivault,/turf/simulated/shuttle/floor4,/area/vault/research)
"ce" = (/obj/item/weapon/storage/firstaid,/turf/simulated/floor/wood,/area/vault/research)
"cf" = (/obj/structure/table/woodentable,/obj/item/weapon/reagent_containers/glass/rag,/turf/simulated/floor/wood,/area/vault/research)
"cg" = (/obj/structure/bed,/obj/item/weapon/bedsheet/medical,/turf/simulated/floor{icon_state = "white"},/area/vault/research)
"ch" = (/obj/effect/decal/cleanable/blood,/turf/simulated/floor{icon_state = "white"},/area/vault/research)
"ci" = (/obj/machinery/bot/medbot,/turf/simulated/floor{icon_state = "white"},/area/vault/research)
"cj" = (/obj/machinery/door/airlock/glass_science,/turf/simulated/floor{icon_state = "white"},/area/vault/research)
"ck" = (/obj/structure/table,/obj/abstract/map/spawner/medical/pills,/obj/machinery/light{dir = 4},/turf/simulated/floor{icon_state = "white"},/area/vault/research)
"cl" = (/obj/item/weapon/tank/jetpack/oxygen,/turf/simulated/shuttle/floor4,/area/vault/research)
"cm" = (/obj/structure/table/woodentable,/obj/item/weapon/paper_bin,/turf/simulated/floor/wood,/area/vault/research)
"cn" = (/obj/structure/table/woodentable,/obj/item/weapon/pen,/turf/simulated/floor/wood,/area/vault/research)
"co" = (/obj/structure/table/woodentable,/obj/item/weapon/storage/box/donkpockets,/turf/simulated/floor/wood,/area/vault/research)
"cp" = (/obj/structure/table/woodentable,/turf/simulated/floor/wood,/area/vault/research)
"cq" = (/obj/item/weapon/reagent_containers/glass/beaker/noreact,/turf/simulated/shuttle/floor4,/area/vault/research)
"cr" = (/obj/effect/decal/cleanable/cobweb2,/obj/item/weapon/reagent_containers/food/snacks/braincakeslice,/turf/simulated/shuttle/floor4,/area/vault/research)
"cs" = (/obj/item/weapon/reagent_containers/glass/beaker/large,/obj/structure/sink{dir = 8; pixel_x = -12; pixel_y = 0},/turf/simulated/floor{icon_state = "white"},/area/vault/research)
"ct" = (/obj/machinery/iv_drip,/turf/simulated/floor{icon_state = "white"},/area/vault/research)
"cu" = (/obj/structure/table,/obj/abstract/map/spawner/medical/pills,/turf/simulated/floor{icon_state = "white"},/area/vault/research)
"cv" = (/obj/item/weapon/stool,/obj/machinery/light{dir = 8},/turf/simulated/floor/wood,/area/vault/research)
"cw" = (/obj/item/weapon/stool,/turf/simulated/floor/wood,/area/vault/research)
"cx" = (/obj/structure/bed,/obj/item/weapon/bedsheet/orange,/obj/machinery/light/small,/turf/simulated/shuttle/floor4,/area/vault/research)
"cy" = (/obj/item/weapon/reagent_containers/glass/beaker/bluespace/large,/turf/simulated/shuttle/floor4,/area/vault/research)
"cz" = (/obj/machinery/bodyscanner,/turf/simulated/floor{icon_state = "white"},/area/vault/research)
"cA" = (/obj/structure/bed,/obj/item/weapon/bedsheet/medical,/obj/machinery/light,/turf/simulated/floor{icon_state = "white"},/area/vault/research)
"cB" = (/obj/structure/table,/obj/structure/bedsheetbin,/turf/simulated/floor{icon_state = "white"},/area/vault/research)
"cC" = (/obj/structure/table,/obj/item/weapon/reagent_containers/blood/OPlus,/obj/item/weapon/reagent_containers/blood/OPlus,/obj/item/weapon/reagent_containers/blood/OPlus,/obj/item/stack/medical/advanced/ointment,/obj/item/weapon/reagent_containers/glass/beaker/noreact,/obj/item/weapon/switchtool/surgery,/turf/simulated/floor{icon_state = "white"},/area/vault/research)
"cD" = (/obj/structure/table,/obj/item/weapon/storage/firstaid/regular{pixel_x = 6; pixel_y = 2},/obj/item/weapon/storage/firstaid/regular{pixel_x = -2; pixel_y = 2},/obj/item/weapon/storage/firstaid/regular{pixel_x = 0; pixel_y = 0},/turf/simulated/floor{icon_state = "white"},/area/vault/research)
"cE" = (/obj/abstract/map/spawner/mobs/medivault,/turf/simulated/floor{blocks_air = 1; icon_state = "dark"},/area/vault/research)
"cF" = (/obj/structure/closet/wardrobe/red,/turf/simulated/floor{blocks_air = 1; icon_state = "dark"},/area/vault/research)
"cG" = (/obj/effect/landmark/corpse/doctor,/turf/simulated/floor/wood,/area/vault/research)
"cH" = (/turf/simulated/floor/wood{broken = 1; icon_state = "wood-broken"},/area/vault/research)
"cI" = (/obj/abstract/map/spawner/mobs/medivault,/turf/simulated/floor/wood,/area/vault/research)
"cJ" = (/obj/structure/table,/obj/item/weapon/storage/box/sunglasses,/obj/item/weapon/storage/box/smokebombs{pixel_x = 3; pixel_y = 5},/turf/simulated/floor{blocks_air = 1; icon_state = "dark"},/area/vault/research)
"cK" = (/obj/structure/closet/secure_closet/security,/turf/simulated/floor{blocks_air = 1; icon_state = "dark"},/area/vault/research)
"cL" = (/obj/item/weapon/reagent_containers/food/drinks/coffee,/turf/simulated/floor/wood,/area/vault/research)
"cM" = (/obj/effect/decal/cleanable/blood,/turf/simulated/floor/wood,/area/vault/research)
"cN" = (/obj/machinery/light,/turf/simulated/floor/wood,/area/vault/research)
"cO" = (/obj/machinery/door/airlock/glass_science,/turf/simulated/floor,/area/vault/research)
"cP" = (/turf/simulated/floor,/area/vault/research)
"cQ" = (/obj/structure/table,/obj/item/weapon/paper/pamphlet/medivault,/obj/machinery/light{dir = 1},/turf/simulated/floor,/area/vault/research)
"cR" = (/obj/structure/table,/turf/simulated/floor,/area/vault/research)
"cS" = (/obj/structure/table,/obj/item/weapon/disk/shuttle_coords/vault/research,/turf/simulated/floor,/area/vault/research)
"cT" = (/obj/structure/table,/obj/machinery/light{dir = 1},/turf/simulated/floor,/area/vault/research)
"cU" = (/obj/effect/decal/cleanable/blood,/turf/simulated/floor,/area/vault/research)
"cV" = (/obj/machinery/light{dir = 1},/turf/simulated/floor,/area/vault/research)
"cW" = (/obj/machinery/vending/snack,/turf/simulated/floor,/area/vault/research)
"cX" = (/obj/machinery/vending/coffee,/turf/simulated/floor,/area/vault/research)
"cY" = (/turf/simulated/floor{icon_state = "red"; dir = 5},/area/vault/research)
"cZ" = (/obj/machinery/door/airlock/security{name = "Armory"; req_access = null; req_access_txt = "3"},/turf/simulated/floor,/area/vault/research)
"da" = (/obj/structure/closet/secure_closet/security,/obj/machinery/light{dir = 4},/turf/simulated/floor{blocks_air = 1; icon_state = "dark"},/area/vault/research)
"db" = (/obj/machinery/door/airlock/glass_science,/turf/simulated/floor/wood,/area/vault/research)
"dc" = (/obj/machinery/light/small{dir = 8},/turf/simulated/floor,/area/vault/research)
"dd" = (/obj/structure/sign/biohazard,/turf/simulated/wall/r_wall,/area/vault/research)
"de" = (/turf/simulated/floor{icon_state = "red"; dir = 4},/area/vault/research)
"df" = (/obj/structure/table,/obj/item/weapon/storage/lockbox/loyalty,/turf/simulated/floor{blocks_air = 1; icon_state = "dark"},/area/vault/research)
"dg" = (/obj/effect/decal/cleanable/cobweb,/turf/simulated/floor/carpet,/area/vault/research)
"dh" = (/obj/effect/landmark/corpse/doctor,/turf/simulated/floor/carpet,/area/vault/research)
"di" = (/obj/structure/closet/cabinet/medivault,/turf/simulated/floor/carpet,/area/vault/research)
"dj" = (/obj/structure/rack,/obj/item/clothing/suit/bio_suit/virology,/obj/item/clothing/head/bio_hood/virology,/turf/simulated/floor,/area/vault/research)
"dk" = (/obj/structure/flora/pottedplant,/turf/simulated/floor,/area/vault/research)
"dl" = (/obj/machinery/light,/turf/simulated/floor,/area/vault/research)
"dm" = (/obj/effect/landmark/corpse/engineer,/turf/simulated/floor,/area/vault/research)
"dn" = (/obj/structure/flora/pottedplant,/turf/simulated/floor{icon_state = "red"; dir = 6},/area/vault/research)
"do" = (/obj/abstract/map/spawner/misc/medivault,/turf/simulated/floor{blocks_air = 1; icon_state = "dark"},/area/vault/research)
"dp" = (/obj/item/weapon/storage/box/emps,/turf/simulated/floor{blocks_air = 1; icon_state = "dark"},/area/vault/research)
"dq" = (/obj/machinery/door/airlock/research,/turf/simulated/floor/carpet,/area/vault/research)
"dr" = (/obj/abstract/map/spawner/mobs/medivault,/turf/simulated/floor/carpet,/area/vault/research)
"ds" = (/obj/item/weapon/storage/pill_bottle/dice,/turf/simulated/floor/carpet,/area/vault/research)
"dt" = (/obj/structure/bed,/obj/item/weapon/bedsheet/green,/obj/machinery/light/small{dir = 4},/turf/simulated/floor/carpet,/area/vault/research)
"du" = (/obj/machinery/door/window/plasma,/turf/simulated/floor/wood,/area/vault/research)
"dv" = (/turf/simulated/floor/carpet,/area/vault/research)
"dw" = (/obj/item/weapon/stool,/obj/effect/landmark/corpse/commander,/turf/simulated/floor/carpet,/area/vault/research)
"dx" = (/obj/structure/table/woodentable,/turf/simulated/floor/carpet,/area/vault/research)
"dy" = (/obj/machinery/suit_storage_unit/security,/turf/simulated/floor{blocks_air = 1; icon_state = "dark"},/area/vault/research)
"dz" = (/obj/machinery/suit_storage_unit/security,/obj/machinery/light,/turf/simulated/floor{blocks_air = 1; icon_state = "dark"},/area/vault/research)
"dA" = (/obj/machinery/light{dir = 8},/turf/simulated/floor/wood,/area/vault/research)
"dB" = (/obj/structure/table/woodentable,/obj/item/weapon/phone,/turf/simulated/floor/carpet,/area/vault/research)
"dC" = (/turf/simulated/floor/wood{broken = 1; icon_state = "wood-broken3"},/area/vault/research)
"dD" = (/obj/structure/rack,/obj/item/clothing/suit/space/ancient,/obj/item/clothing/head/helmet/space/ancient,/obj/effect/decal/cleanable/cobweb,/obj/machinery/light/small{dir = 1},/turf/simulated/floor{dir = 1; icon_state = "blue"},/area/vault/research)
"dE" = (/obj/structure/dispenser/oxygen,/turf/simulated/floor{dir = 1; icon_state = "blue"},/area/vault/research)
"dF" = (/obj/machinery/portable_atmospherics/canister/oxygen,/turf/simulated/floor,/area/vault/research)
"dG" = (/obj/abstract/map/spawner/mobs/medivault,/turf/simulated/floor{dir = 9; icon_state = "yellowfull"},/area/vault/research)
"dH" = (/obj/structure/table,/obj/item/stack/sheet/metal{amount = 50},/obj/item/stack/sheet/mineral/plastic{amount = 50},/obj/item/stack/sheet/glass/glass{amount = 50},/obj/structure/table,/turf/simulated/floor{dir = 9; icon_state = "yellowfull"},/area/vault/research)
"dI" = (/obj/item/weapon/storage/toolbox/syndicate,/obj/effect/decal/cleanable/cobweb,/turf/simulated/floor/carpet,/area/vault/research)
"dJ" = (/obj/effect/decal/cleanable/blood,/turf/simulated/floor/carpet,/area/vault/research)
"dK" = (/obj/machinery/door/airlock/external,/turf/simulated/floor/wood,/area/vault/research)
"dL" = (/obj/machinery/door/airlock/external,/turf/simulated/floor,/area/vault/research)
"dM" = (/obj/structure/table,/obj/item/weapon/storage/toolbox/electrical,/obj/abstract/map/spawner/misc/medivault,/turf/simulated/floor{dir = 9; icon_state = "yellowfull"},/area/vault/research)
"dN" = (/obj/structure/table,/obj/structure/table,/obj/item/weapon/storage/toolbox/mechanical,/turf/simulated/floor{dir = 9; icon_state = "yellowfull"},/area/vault/research)
"dO" = (/obj/structure/reagent_dispensers/fueltank,/turf/simulated/floor/plating,/area/vault/research)
"dP" = (/obj/item/clothing/under/rank/centcom/officer,/obj/item/clothing/head/beret/centcom/officer,/turf/simulated/floor/carpet,/area/vault/research)
"dQ" = (/obj/abstract/map/spawner/misc/medivault,/turf/simulated/floor/carpet,/area/vault/research)
"dR" = (/obj/structure/flora/pottedplant,/obj/machinery/light,/turf/simulated/floor/wood,/area/vault/research)
"dS" = (/obj/machinery/door/airlock/external,/obj/docking_port/destination/vault/research{dir = 2},/turf/simulated/floor/plating,/area/vault/research)

(1,1,1) = {"
aaaaaaaaaaaaaaaaaaaaaaaaaaaaaaaaaaaaaaaaaaaaaaaaaaaaaaaaaaaa
aaaaababababababababababaaaaaaaaaaaaaaaaaaaaaaaaaaaaaaaaaaaa
aaaaabacadabaeafagahahababababababababababababababaaaaaaaaaa
aaaaabaiacabajakalamanaoacacacakacacacacacakacacabababababaa
aaaaabapaqabaracapacasabacabababababababatababacabasauavabaa
abababawaxabababawabababacabayazaAabaBaCaDaEabacaFaGakaHabaa
abaIacaJaKaLaMaNaOaPacacacaFaQaRaSaTaUaVaWaXabacabauauaYabaa
abaZabababaFababababababababababababbabbbcbdabbeabababababaa
abacabbfbgbhbibiabbjbkabblbmabbnbkabaTbobpbqabacacakacababab
abacabbrbsbtbtbuabbnbvabbwbxabbybzabbAbBbCbDababababacacbEab
abacabababbFabababbGbHabbGbHabbGbHabbIbJbKbLbMbNbOababababab
abacabbPbQbRbSbTabbUbUbVbUbUbUbUbUbWbJbXbYbZabcacbabbncccdab
abacaFbRcebRcfbRabbGbHabbGbHabbGbHabcgchcibJcjbXckabbvbyclab
abacabcmcncocpbRabbncqabbnbvabbvcrabcsbYctbXabbIcuabbWbHabab
abacabcvcwcwcwbRabbzcxabcycxabbncxabczbJcAcBabcCcDabbUcEcFab
abacabcGbRcHcIbRabababababababababababaTboabababababcJbUcKab
abacabbRcLcMcNbRcOcPcQcRcScTcPbGcUcPbGcPcVcWcXcVcYcZbVcEdaab
abacabdbabababababcPcPcUcPcPcPbpdccPddcPcUcPcPcPdeabdfbUcKab
abakabbRabdgdhdiabbGababababbGabdjdjabdkdlcPcUdmdnabdobUdpab
abacabbRdqdrdsdtabbRdudvdwdxbRababababababababaFababdydzdyab
abacaFcMabababababdAbRdxdxdBdCabdDdEabcPcVdFabdGdHababababab
abacabbRabdIdJdiabbRbRbRcIbRbRdKcPcPdLcPcUcPabdMdNabaaaaaaaa
abdOabbRdqdPdQdtabdRbTbRcMbRdRababababcPcPcPababababaaaaaaaa
ababababababababababababababababaaaaababdSababaaaaaaaaaaaaaa
aaaaaaaaaaaaaaaaaaaaaaaaaaaaaaaaaaaaaaaaaaaaaaaaaaaaaaaaaaaa
"}
