//MAP CONVERTED BY dmm2tgm.py THIS HEADER COMMENT PREVENTS RECONVERSION, DO NOT REMOVE
"aa" = (
/turf/space,
/area)
"ab" = (
/obj/structure/shuttle/diag_wall/smooth/black{
	dir = 8
	},
/turf/space,
/area/vault/syndiecargo)
"ac" = (
/obj/structure/shuttle/engine/propulsion/burst{
	dir = 1;
	icon_state = "burst_l";
	tag = "icon-burst_l (NORTH)"
	},
/turf/simulated/floor/shuttle/plating,
/area/vault/syndiecargo)
"ad" = (
/obj/structure/shuttle/diag_wall/smooth/black{
	dir = 1
	},
/turf/space,
/area/vault/syndiecargo)
"af" = (
/obj/structure/shuttle/engine/heater{
	dir = 1;
	tag = "icon-heater (NORTH)"
	},
/obj/structure/window/reinforced/plasma,
/obj/structure/window/reinforced/plasma{
	dir = 8
	},
/turf/simulated/floor/shuttle/plating,
/area/vault/syndiecargo)
"ag" = (
/obj/structure/shuttle/engine/heater{
	dir = 1;
	tag = "icon-heater (NORTH)"
	},
/obj/structure/window/reinforced/plasma,
/turf/simulated/floor/shuttle/plating,
/area/vault/syndiecargo)
"ah" = (
/obj/structure/shuttle/engine/heater{
	dir = 1;
	tag = "icon-heater (NORTH)"
	},
/obj/structure/window/reinforced/plasma,
/obj/structure/window/reinforced/plasma{
	dir = 4
	},
/turf/simulated/floor/shuttle/plating,
/area/vault/syndiecargo)
"al" = (
/obj/structure/closet/toolcloset,
/turf/simulated/floor/shuttle/plating,
/area/vault/syndiecargo)
"am" = (
/turf/simulated/floor/shuttle/plating,
/area/vault/syndiecargo)
"an" = (
/obj/machinery/vending/tool,
/turf/simulated/floor/shuttle/plating,
/area/vault/syndiecargo)
"ao" = (
/obj/structure/rack,
/obj/item/weapon/gun/projectile/automatic/c20r,
/obj/item/ammo_storage/magazine/a12mm/ops,
/turf/simulated/floor/shuttle{
	icon_state = "floor4";
	tag = "icon-floor4"
	},
/area/vault/syndiecargo)
"ap" = (
/obj/machinery/light/small{
	dir = 1;
	tag = "icon-lbulb1 (NORTH)"
	},
/obj/machinery/nuclearbomb,
/turf/simulated/floor/shuttle{
	icon_state = "floor4";
	tag = "icon-floor4"
	},
/area/vault/syndiecargo)
"aq" = (
/obj/structure/safe,
/obj/item/weapon/gun/projectile/deagle/camo,
/obj/item/toy/syndicateballoon,
/turf/simulated/floor/shuttle{
	icon_state = "floor4";
	tag = "icon-floor4"
	},
/area/vault/syndiecargo)
"ar" = (
/obj/structure/closet/crate/trashcart,
/turf/simulated/floor/shuttle/plating,
/area/vault/syndiecargo)
"as" = (
/obj/structure/closet/crate/internals,
/turf/simulated/floor/shuttle/plating,
/area/vault/syndiecargo)
"at" = (
/obj/structure/closet/crate,
/obj/abstract/map/spawner/misc/syndiecargo,
/turf/simulated/floor/shuttle/plating,
/area/vault/syndiecargo)
"au" = (
/obj/machinery/light/small{
	dir = 4;
	tag = "icon-lbulb1 (EAST)"
	},
/obj/item/toy/foamblade,
/turf/simulated/floor/shuttle/plating,
/area/vault/syndiecargo)
"av" = (
/obj/structure/rack,
/obj/item/weapon/gun/projectile/colt,
/obj/item/ammo_storage/speedloader/a357,
/turf/simulated/floor/shuttle{
	icon_state = "floor4";
	tag = "icon-floor4"
	},
/area/vault/syndiecargo)
"aw" = (
/turf/simulated/floor/shuttle{
	icon_state = "floor4";
	tag = "icon-floor4"
	},
/area/vault/syndiecargo)
"ax" = (
/obj/structure/rack,
/obj/item/ammo_storage/magazine/a50,
/obj/item/ammo_storage/magazine/a50,
/obj/item/ammo_storage/box/a357,
/turf/simulated/floor/shuttle{
	icon_state = "floor4";
	tag = "icon-floor4"
	},
/area/vault/syndiecargo)
"ay" = (
/obj/machinery/light/small{
	dir = 8;
	tag = "icon-lbulb1 (WEST)"
	},
/turf/simulated/floor/shuttle/plating,
/area/vault/syndiecargo)
"az" = (
/obj/machinery/vending/engineering,
/turf/simulated/floor/shuttle/plating,
/area/vault/syndiecargo)
"aB" = (
/obj/structure/closet/hydrant,
/turf/simulated/wall/shuttle/black,
/area/vault/syndiecargo)
"aC" = (
/obj/machinery/door/airlock/external,
/turf/simulated/floor/shuttle/plating,
/area/vault/syndiecargo)
"aF" = (
/obj/machinery/door/airlock/vault{
	name = "Armory"
	},
/obj/machinery/door/poddoor{
	id_tag = 350;
	name = "Armory Shutters"
	},
/turf/simulated/floor/shuttle{
	icon_state = "floor4";
	tag = "icon-floor4"
	},
/area/vault/syndiecargo)
"aG" = (
/turf/simulated/floor/shuttle,
/area/vault/syndiecargo)
"aH" = (
/obj/machinery/vending/cigarette,
/turf/simulated/floor/shuttle{
	icon_state = "floor4";
	tag = "icon-floor4"
	},
/area/vault/syndiecargo)
"aI" = (
/obj/machinery/light{
	dir = 1;
	tag = "icon-ltube1 (NORTH)"
	},
/turf/simulated/floor/shuttle{
	icon_state = "floor4";
	tag = "icon-floor4"
	},
/area/vault/syndiecargo)
"aJ" = (
/obj/structure/grille/window_spawner/reinforced_plasma/full,
/turf/simulated/floor/shuttle/plating,
/area/vault/syndiecargo)
"aK" = (
/obj/machinery/vending/coffee,
/turf/simulated/floor/shuttle{
	icon_state = "floor4";
	tag = "icon-floor4"
	},
/area/vault/syndiecargo)
"aL" = (
/obj/structure/table/reinforced,
/obj/item/weapon/storage/box/donkpockets/random_amount{
	pixel_x = 10;
	pixel_y = 5
	},
/obj/item/weapon/storage/box/donkpockets/random_amount,
/turf/simulated/floor/shuttle{
	icon_state = "floor4";
	tag = "icon-floor4"
	},
/area/vault/syndiecargo)
"aM" = (
/obj/structure/table/reinforced,
/obj/abstract/map/spawner/misc/syndiecargo,
/turf/simulated/floor/shuttle{
	icon_state = "floor4";
	tag = "icon-floor4"
	},
/area/vault/syndiecargo)
"aN" = (
/obj/machinery/vending/groans,
/turf/simulated/floor/shuttle{
	icon_state = "floor4";
	tag = "icon-floor4"
	},
/area/vault/syndiecargo)
"aO" = (
/obj/item/trash/bustanuts,
/turf/simulated/floor/shuttle{
	icon_state = "floor4";
	tag = "icon-floor4"
	},
/area/vault/syndiecargo)
"aP" = (
/obj/machinery/door/airlock/glass_security{
	name = "Security Door"
	},
/turf/simulated/floor/shuttle{
	icon_state = "floor4";
	tag = "icon-floor4"
	},
/area/vault/syndiecargo)
"aQ" = (
/mob/living/simple_animal/hostile/humanoid/syndicate/melee,
/turf/simulated/floor/shuttle{
	icon_state = "floor4";
	tag = "icon-floor4"
	},
/area/vault/syndiecargo)
"aR" = (
/obj/structure/table/reinforced,
/obj/item/weapon/phone,
/turf/simulated/floor/shuttle{
	icon_state = "floor4";
	tag = "icon-floor4"
	},
/area/vault/syndiecargo)
"aT" = (
/mob/living/simple_animal/hostile/humanoid/syndicate/ranged/laser,
/turf/simulated/floor/shuttle{
	icon_state = "floor4";
	tag = "icon-floor4"
	},
/area/vault/syndiecargo)
"aV" = (
/obj/structure/flora/pottedplant/random,
/turf/simulated/floor/shuttle{
	icon_state = "floor4";
	tag = "icon-floor4"
	},
/area/vault/syndiecargo)
"aW" = (
/obj/machinery/light,
/turf/simulated/floor/shuttle{
	icon_state = "floor4";
	tag = "icon-floor4"
	},
/area/vault/syndiecargo)
"aX" = (
/mob/living/simple_animal/hostile/humanoid/syndicate/ranged,
/turf/simulated/floor/shuttle{
	icon_state = "floor4";
	tag = "icon-floor4"
	},
/area/vault/syndiecargo)
"ba" = (
/obj/machinery/door/airlock/multi_tile/glass,
/turf/simulated/floor/shuttle{
	icon_state = "floor4";
	tag = "icon-floor4"
	},
/area/vault/syndiecargo)
"bb" = (
/turf/simulated/wall/shuttle/black,
/area/vault/syndiecargo)
"bc" = (
/obj/machinery/vending/medical,
/turf/simulated/floor/shuttle{
	icon_state = "floor3";
	tag = "icon-floor3"
	},
/area/vault/syndiecargo)
"bd" = (
/obj/structure/table,
/obj/item/weapon/switchtool/surgery,
/obj/item/clothing/accessory/stethoscope,
/turf/simulated/floor/shuttle{
	icon_state = "floor3";
	tag = "icon-floor3"
	},
/area/vault/syndiecargo)
"be" = (
/obj/structure/closet/crate/freezer/surgery,
/turf/simulated/floor/shuttle{
	icon_state = "floor3";
	tag = "icon-floor3"
	},
/area/vault/syndiecargo)
"bf" = (
/obj/machinery/light{
	dir = 8;
	tag = "icon-ltube1 (WEST)"
	},
/mob/living/simple_animal/hostile/humanoid/syndicate/melee,
/turf/simulated/floor/shuttle{
	icon_state = "floor4";
	tag = "icon-floor4"
	},
/area/vault/syndiecargo)
"bg" = (
/obj/machinery/door/airlock/glass_medical{
	name = "Medical Area"
	},
/turf/simulated/floor/shuttle{
	icon_state = "floor4";
	tag = "icon-floor4"
	},
/area/vault/syndiecargo)
"bh" = (
/obj/machinery/light{
	dir = 4;
	tag = "icon-ltube1 (EAST)"
	},
/turf/simulated/floor/shuttle{
	icon_state = "floor4";
	tag = "icon-floor4"
	},
/area/vault/syndiecargo)
"bi" = (
/obj/structure/sign/double/map/left,
/obj/structure/table/reinforced,
/turf/simulated/floor/shuttle{
	icon_state = "floor4";
	tag = "icon-floor4"
	},
/area/vault/syndiecargo)
"bj" = (
/obj/structure/sign/double/map/right,
/obj/structure/table/reinforced,
/turf/simulated/floor/shuttle{
	icon_state = "floor4";
	tag = "icon-floor4"
	},
/area/vault/syndiecargo)
"bk" = (
/obj/item/trash/syndi_cakes,
/turf/simulated/floor/shuttle{
	icon_state = "floor4";
	tag = "icon-floor4"
	},
/area/vault/syndiecargo)
"bl" = (
/obj/structure/sign/redcross,
/turf/simulated/wall/shuttle/black,
/area/vault/syndiecargo)
"bm" = (
/obj/structure/closet/crate/medical,
/turf/simulated/floor/shuttle{
	icon_state = "floor4";
	tag = "icon-floor4"
	},
/area/vault/syndiecargo)
"bn" = (
/obj/machinery/vending/wallmed1,
/turf/simulated/wall/shuttle/black,
/area/vault/syndiecargo)
"bo" = (
/obj/machinery/computer/security/telescreen,
/turf/simulated/wall/shuttle/black,
/area/vault/syndiecargo)
"bq" = (
/obj/structure/sign/vacuum,
/turf/simulated/wall/shuttle/black,
/area/vault/syndiecargo)
"br" = (
/obj/machinery/sleeper,
/turf/simulated/floor/shuttle{
	icon_state = "floor3";
	tag = "icon-floor3"
	},
/area/vault/syndiecargo)
"bs" = (
/obj/machinery/optable,
/turf/simulated/floor/shuttle{
	icon_state = "floor3";
	tag = "icon-floor3"
	},
/area/vault/syndiecargo)
"bt" = (
/obj/structure/bed/chair/office/dark,
/turf/simulated/floor/shuttle{
	icon_state = "floor4";
	tag = "icon-floor4"
	},
/area/vault/syndiecargo)
"bu" = (
/obj/structure/bed/chair/office/dark,
/mob/living/simple_animal/hostile/humanoid/syndicate/ranged/laser,
/turf/simulated/floor/shuttle{
	icon_state = "floor4";
	tag = "icon-floor4"
	},
/area/vault/syndiecargo)
"bv" = (
/obj/machinery/door_control{
	id_tag = 350;
	name = "Shutter Controll";
	pixel_x = 32
	},
/mob/living/simple_animal/hostile/humanoid/syndicate/melee,
/turf/simulated/floor/shuttle{
	icon_state = "floor4";
	tag = "icon-floor4"
	},
/area/vault/syndiecargo)
"bw" = (
/obj/structure/closet/crate/bin,
/obj/machinery/light/small{
	dir = 8;
	tag = "icon-lbulb1 (WEST)"
	},
/turf/simulated/floor/shuttle/plating,
/area/vault/syndiecargo)
"bx" = (
/obj/structure/closet/emcloset,
/obj/machinery/light/small{
	dir = 4;
	tag = "icon-lbulb1 (EAST)"
	},
/turf/simulated/floor/shuttle/plating,
/area/vault/syndiecargo)
"by" = (
/obj/machinery/computer/message_monitor,
/turf/simulated/floor/shuttle{
	icon_state = "floor4";
	tag = "icon-floor4"
	},
/area/vault/syndiecargo)
"bz" = (
/obj/machinery/computer/crew,
/turf/simulated/floor/shuttle{
	icon_state = "floor4";
	tag = "icon-floor4"
	},
/area/vault/syndiecargo)
"bA" = (
/obj/machinery/computer/fluff/shuttle_control/syndicate,
/turf/simulated/floor/shuttle{
	icon_state = "floor4";
	tag = "icon-floor4"
	},
/area/vault/syndiecargo)
"bB" = (
/obj/machinery/computer/security,
/turf/simulated/floor/shuttle{
	icon_state = "floor4";
	tag = "icon-floor4"
	},
/area/vault/syndiecargo)
"bC" = (
/obj/structure/shuttle/diag_wall/smooth/black,
/turf/space,
/area/vault/syndiecargo)
"bD" = (
/obj/machinery/door/airlock/external{
	icon_state = "door_locked";
	locked = 1
	},
/turf/simulated/floor/shuttle/plating,
/area/vault/syndiecargo)
"bE" = (
/obj/structure/shuttle/diag_wall/smooth/black{
	dir = 4
	},
/turf/space,
/area/vault/syndiecargo)
"bF" = (
/obj/machinery/door/poddoor{
	id_tag = 350;
	name = "Shutters"
	},
/obj/structure/grille/window_spawner/reinforced_plasma/full,
/turf/simulated/floor/shuttle/plating,
/area/vault/syndiecargo)

(1,1,1) = {"
aa
aa
aa
aa
ab
bb
bb
bb
bb
bb
bb
bb
bb
bb
bb
bb
bC
"}
(2,1,1) = {"
ab
bb
bb
bb
bb
aH
aN
aw
aw
aM
aM
bf
aw
aV
bq
bw
bb
"}
(3,1,1) = {"
ac
af
al
at
aB
aw
aO
aw
aw
aw
aw
aw
aw
aw
aC
am
bD
"}
(4,1,1) = {"
ac
ag
am
am
aC
aw
aw
aw
aw
aw
aX
aw
bk
aw
aC
am
bD
"}
(5,1,1) = {"
ac
ah
an
au
bb
aI
aw
aw
aw
aw
aw
aw
aw
aV
bq
bx
bb
"}
(6,1,1) = {"
ad
bb
bb
bb
bb
aJ
aP
aJ
aJ
bb
bb
bg
bl
bb
bb
bb
bE
"}
(7,1,1) = {"
aa
bb
ao
av
bb
aw
aw
aw
aV
bb
bc
aw
bm
aw
br
bb
aa
"}
(8,1,1) = {"
aa
bb
ap
aw
aF
aw
aw
aT
aw
bb
bd
aw
aw
aw
br
bb
aa
"}
(9,1,1) = {"
aa
bb
aq
ax
bb
aK
aw
aw
aw
bb
be
bh
aw
aw
bs
bb
aa
"}
(10,1,1) = {"
ab
bb
bb
bb
aG
aL
aw
aw
aW
bb
bb
bb
bn
bo
bb
bb
bC
"}
(11,1,1) = {"
ac
af
ar
ay
bb
aw
aQ
aw
aw
bb
aI
aw
aw
aQ
bt
by
bF
"}
(12,1,1) = {"
ac
ag
am
am
aC
aw
aw
aw
aX
ba
aw
bi
aw
aw
bu
bz
bF
"}
(13,1,1) = {"
ac
ah
as
az
bb
aI
aw
aw
aw
aw
aw
bj
aw
aT
bt
bA
bF
"}
(14,1,1) = {"
ad
bb
bb
bb
bb
aM
aR
aM
aw
bb
aI
aw
aw
aw
bv
bB
bF
"}
(15,1,1) = {"
aa
aa
aa
aa
ad
bb
bb
bb
bb
bb
bb
bb
bb
bb
bb
bb
bE
"}
