"a" = (/turf/space,/area)
"b" = (/turf/unsimulated/mineral/random/high_chance,/area/vault/tommyboyasteroid)
"c" = (/turf/unsimulated/mineral/random/high_chance_clown,/area/vault/tommyboyasteroid)
"d" = (/turf/unsimulated/mineral/random/high_chance,/turf/unsimulated/mineral/gibtonite,/area/vault/tommyboyasteroid)
"e" = (/turf/unsimulated/floor/asteroid/cave,/area/vault/tommyboyasteroid)
"f" = (/obj/effect/decal/cleanable/dirt,/obj/structure/shuttle/diag_wall/smooth{dir = 8},/turf/unsimulated/floor/asteroid/cave,/area/vault/tommyboyasteroid)
"g" = (/obj/effect/decal/cleanable/dirt,/obj/effect/alien/weeds,/mob/living/simple_animal/hostile/alien/sentinel,/turf/unsimulated/floor/asteroid/cave,/area/vault/tommyboyasteroid)
"h" = (/obj/effect/decal/cleanable/dirt,/obj/effect/alien/weeds,/turf/unsimulated/floor/asteroid/cave,/area/vault/tommyboyasteroid)
"i" = (/obj/effect/decal/remains/xeno,/obj/effect/decal/cleanable/dirt,/obj/effect/alien/weeds,/turf/unsimulated/floor/asteroid/cave,/area/vault/tommyboyasteroid)
"j" = (/obj/effect/decal/cleanable/dirt,/obj/structure/shuttle/diag_wall/smooth{dir = 1},/turf/simulated/floor/shuttle,/area/vault/tommyboyasteroid)
"k" = (/obj/effect/decal/cleanable/dirt,/obj/effect/alien/resin/wall,/obj/effect/alien/weeds,/turf/unsimulated/floor/asteroid/plating,/area/vault/tommyboyasteroid)
"m" = (/obj/effect/decal/cleanable/dirt,/obj/effect/alien/weeds/node,/turf/unsimulated/floor/asteroid/cave,/area/vault/tommyboyasteroid)
"o" = (/obj/effect/decal/cleanable/dirt,/turf/unsimulated/floor/asteroid/plating,/area/vault/tommyboyasteroid)
"p" = (/obj/item/weapon/shard{icon_state = "small"},/obj/effect/decal/cleanable/dirt,/turf/unsimulated/floor/asteroid/plating,/area/vault/tommyboyasteroid)
"q" = (/obj/effect/decal/cleanable/dirt,/obj/item/clothing/head/helmet/space/ancient{desc = "While still in a servicable condition, nothing on this helmet is readable anymore."},/turf/simulated/floor/shuttle,/area/vault/tommyboyasteroid)
"r" = (/obj/effect/decal/cleanable/dirt,/turf/simulated/floor/shuttle,/area/vault/tommyboyasteroid)
"t" = (/obj/effect/decal/cleanable/dirt,/obj/item/clothing/under/color/blue{desc = "A mostly torn label adorns the back. You can read the first and third letters, which are 'N' and 'S' respectively. The front had a nametag at once, now all the remains is the abbreviation 'Maj.'"; name = "ancient blue jumpsuit"},/obj/effect/alien/weeds,/turf/unsimulated/floor/asteroid/cave,/area/vault/tommyboyasteroid)
"u" = (/obj/effect/decal/remains/human,/obj/effect/decal/cleanable/dirt,/obj/effect/alien/weeds,/turf/unsimulated/floor/asteroid/cave,/area/vault/tommyboyasteroid)
"v" = (/obj/structure/grille/broken,/obj/item/stack/rods,/obj/item/weapon/shard,/obj/item/weapon/shard{icon_state = "small"},/obj/effect/decal/cleanable/dirt,/obj/effect/alien/resin/wall,/obj/effect/alien/weeds,/turf/unsimulated/floor/asteroid/plating,/area/vault/tommyboyasteroid)
"w" = (/obj/machinery/computer/shuttle,/obj/effect/decal/cleanable/dirt,/obj/item/weapon/paper/tommyboy,/turf/unsimulated/floor/asteroid/plating,/area/vault/tommyboyasteroid)
"x" = (/obj/effect/decal/cleanable/dirt,/obj/effect/alien/resin/wall,/turf/unsimulated/floor/asteroid/plating,/area/vault/tommyboyasteroid)
"y" = (/obj/effect/decal/cleanable/dirt,/obj/effect/alien/resin/wall,/turf/simulated/floor/shuttle,/area/vault/tommyboyasteroid)
"z" = (/obj/effect/decal/cleanable/dirt,/turf/unsimulated/floor/asteroid/cave,/area/vault/tommyboyasteroid)
"A" = (/obj/effect/decal/cleanable/dirt,/obj/structure/shuttle/diag_wall/smooth,/turf/unsimulated/floor/asteroid/cave,/area/vault/tommyboyasteroid)
"B" = (/obj/effect/decal/cleanable/dirt,/obj/structure/bed,/obj/item/clothing/suit/space/syndicate/orange{desc = "The labels are faded beyond recognition, except for the second letter on the back logo, 'A'."; name = "ancient orange space suit"},/turf/simulated/floor/shuttle,/area/vault/tommyboyasteroid)
"C" = (/obj/effect/decal/cleanable/dirt,/obj/structure/shuttle/diag_wall/smooth{dir = 4},/turf/unsimulated/floor/asteroid/cave,/area/vault/tommyboyasteroid)
"D" = (/obj/effect/decal/cleanable/dirt,/turf/simulated/wall/shuttle,/area/vault/tommyboyasteroid)

(1,1,1) = {"
aaaaaaaaaaaaaaaaaaaaaaaaa
aaaaaaaaaaaaaaaaaaaaaaaaa
aaaaaaaaaaaaaaaaaaabbbaaa
aaaaaaaaaaaaaaaaaabcccbaa
aaaaaabdbaaaaaaaaabcdccba
aaaaabbbbbbeeeaaaabcccbba
aaaabbbcbbbbeeeebaabbbaaa
aaabbbbbbbbbdcebbbaaaaaaa
aaaebbdbbbbbbbbbbbbbaaaaa
aaeecbbbbbbbbbbcbbbbbbaaa
aaebbbbbbghhhbbbbbdbcbaaa
aaebbbbchihfkDbbDbbDbbbaa
abbbbdbbhhmDopdoqpbrDbbaa
abbbbbbtuhhvwrxroryrxzbba
abdbbbbhhhhDjByrpdxobzzza
abbbbbbhhmiADbDDbbDDCzbza
abbbcbbbhhghbbbcbbbdbcbba
abbbbbbbbbbbbbbbbbbbbbbaa
abdbeeebbdbcbbbbbbbbbaaaa
aaaeeeeeebbbbbbbbaaaaaaaa
aaaaaeeeeeebbbbbaaabbbaaa
aaaaaaaaaaaaaaaaaabccbaaa
aaaaaaaaaaaaaaaaaaadcbaaa
aaaaaaaaaaaaaaaaaaabbaaaa
aaaaaaaaaaaaaaaaaaaaaaaaa
"}
