"a" = (/turf/unsimulated/wall,/area/vault)
"b" = (/turf/unsimulated/floor,/area/vault)
"c" = (/turf/unsimulated/wall/fakeglass,/area/vault)
"d" = (/obj/effect/mapping/playable_mob/team{name = "Tito's crew"},/mob/living/simple_animal/hostile/humanoid/pirate{name = "Tito 'Dickman' Dick"},/turf/unsimulated/floor,/area/vault)
"e" = (/obj/effect/mapping/playable_mob/team{name = "Abominations"},/mob/living/simple_animal/hostile/hivebot{name = "Horatio"},/turf/unsimulated/floor,/area/vault)
"f" = (/obj/effect/mapping/playable_mob/team{name = "Abominations"},/mob/living/simple_animal/hostile/humanoid/tajaran{name = "Cherry Pie"},/turf/unsimulated/floor,/area/vault)
"g" = (/obj/machinery/floodlight/on/infinite,/turf/unsimulated/floor,/area/vault)
"h" = (/obj/effect/mapping/playable_mob/single{name = "cat"},/mob/living/simple_animal/cat{desc = "Freak of the week"; name = "Chita"},/turf/unsimulated/floor,/area/vault)
"i" = (/obj/effect/mapping/playable_mob/team{name = "Tito's crew"},/mob/living/simple_animal/hostile/humanoid/jackal{name = "Phil"},/turf/unsimulated/floor,/area/vault)
"j" = (/obj/effect/mapping/playable_mob/team{name = "Tito's crew"},/mob/living/simple_animal/hostile/humanoid/diona/junkie{name = "Jack"},/turf/unsimulated/floor,/area/vault)

(1,1,1) = {"
aaaaaaaaaa
abbcbbcbba
abdcbbceba
acccbbccca
abfcggchba
acccbbccca
abicbbcjba
abbcbbcbba
abbcbbcbba
aaaaaaaaaa
"}
