"a" = (/turf/simulated/wall/invulnerable/ice,/area/awaymission/articwasteland)
"b" = (/turf/simulated/floor/plating/snow,/area/awaymission/articwasteland)
"c" = (/turf/simulated/wall/r_wall,/area/awaymission/articwasteland/gateway)
"d" = (/turf/unsimulated/floor/snow,/area/awaymission/articwasteland)
"e" = (/obj/structure/flora/tree/pine,/obj/structure/flora/tree/pine,/turf/unsimulated/floor/snow,/area/awaymission/articwasteland)
"f" = (/obj/structure/ladder{height = 0; id = "arcticwaste"},/turf/simulated/floor/plating/snow,/area/awaymission/articwasteland/gateway)
"g" = (/turf/simulated/floor/plating/snow{icon_state = "platingdrift"},/area/awaymission/articwasteland/gateway)
"h" = (/obj/machinery/light/small{dir = 4},/turf/simulated/floor/plating,/area/awaymission/articwasteland/gateway)
"i" = (/turf/simulated/floor/plating,/area/awaymission/articwasteland/gateway)
"j" = (/obj/structure/table/glass,/obj/item/stack/sheet/glass/glass/bigstack,/turf/simulated/floor/plating,/area/awaymission/articwasteland/gateway)
"k" = (/obj/machinery/light{dir = 1},/turf/simulated/floor/plating,/area/awaymission/articwasteland/gateway)
"l" = (/obj/machinery/space_heater,/turf/simulated/floor/plating,/area/awaymission/articwasteland/gateway)
"m" = (/obj/structure/table/glass,/obj/item/stack/sheet/metal/bigstack,/turf/simulated/floor/plating,/area/awaymission/articwasteland/gateway)
"n" = (/obj/machinery/light{dir = 8},/turf/simulated/floor/plating,/area/awaymission/articwasteland/gateway)
"o" = (/turf/simulated/floor/plating{tag = "icon-warnplate (NORTHWEST)"; icon_state = "warnplate"; dir = 9},/area/awaymission/articwasteland/gateway)
"p" = (/turf/simulated/floor/plating{tag = "icon-warnplate (NORTH)"; icon_state = "warnplate"; dir = 1},/area/awaymission/articwasteland/gateway)
"q" = (/turf/simulated/floor/plating{tag = "icon-warnplate (NORTHEAST)"; icon_state = "warnplate"; dir = 5},/area/awaymission/articwasteland/gateway)
"r" = (/obj/machinery/light{icon_state = "tube1"; dir = 4},/turf/simulated/floor/plating,/area/awaymission/articwasteland/gateway)
"s" = (/obj/machinery/vending/robotics,/turf/simulated/floor/plating{tag = "icon-warnplate (EAST)"; icon_state = "warnplate"; dir = 4},/area/awaymission/articwasteland/gateway)
"t" = (/turf/simulated/floor/plating{tag = "icon-warnplate (WEST)"; icon_state = "warnplate"; dir = 8},/area/awaymission/articwasteland/gateway)
"u" = (/obj/item/weapon/paper/pamphlet,/turf/simulated/floor/plating,/area/awaymission/articwasteland/gateway)
"v" = (/turf/simulated/floor/plating{tag = "icon-warnplate (EAST)"; icon_state = "warnplate"; dir = 4},/area/awaymission/articwasteland/gateway)
"w" = (/obj/machinery/vending/engineering,/turf/simulated/floor/plating{tag = "icon-warnplate (WEST)"; icon_state = "warnplate"; dir = 8},/area/awaymission/articwasteland/gateway)
"x" = (/obj/machinery/vending/tool,/turf/simulated/floor/plating{tag = "icon-warnplate (EAST)"; icon_state = "warnplate"; dir = 4},/area/awaymission/articwasteland/gateway)
"y" = (/obj/machinery/gateway{dir = 9},/turf/simulated/floor/plating,/area/awaymission/articwasteland/gateway)
"z" = (/obj/machinery/gateway{dir = 1},/turf/simulated/floor/plating,/area/awaymission/articwasteland/gateway)
"A" = (/obj/machinery/gateway{dir = 5},/turf/simulated/floor/plating,/area/awaymission/articwasteland/gateway)
"B" = (/obj/machinery/vending/assist,/turf/simulated/floor/plating{tag = "icon-warnplate (WEST)"; icon_state = "warnplate"; dir = 8},/area/awaymission/articwasteland/gateway)
"C" = (/obj/machinery/vending/cigarette,/turf/simulated/floor/plating{tag = "icon-warnplate (EAST)"; icon_state = "warnplate"; dir = 4},/area/awaymission/articwasteland/gateway)
"D" = (/obj/machinery/gateway{dir = 8},/turf/simulated/floor/plating,/area/awaymission/articwasteland/gateway)
"E" = (/obj/machinery/gateway/centeraway{calibrated = 0},/turf/simulated/floor/plating,/area/awaymission/articwasteland/gateway)
"F" = (/obj/machinery/gateway{dir = 4},/turf/simulated/floor/plating,/area/awaymission/articwasteland/gateway)
"G" = (/obj/machinery/vending/engivend,/turf/simulated/floor/plating{tag = "icon-warnplate (WEST)"; icon_state = "warnplate"; dir = 8},/area/awaymission/articwasteland/gateway)
"H" = (/turf/simulated/floor/plating{tag = "icon-warnplate (SOUTHWEST)"; icon_state = "warnplate"; dir = 10},/area/awaymission/articwasteland/gateway)
"I" = (/turf/simulated/floor/plating{dir = 2; icon_state = "warnplate"},/area/awaymission/articwasteland/gateway)
"J" = (/obj/machinery/gateway{dir = 10},/turf/simulated/floor/plating{tag = "icon-warnplate (SOUTHEAST)"; icon_state = "warnplate"; dir = 6},/area/awaymission/articwasteland/gateway)
"K" = (/obj/machinery/gateway,/turf/simulated/floor/plating,/area/awaymission/articwasteland/gateway)
"L" = (/obj/machinery/gateway{dir = 6},/turf/simulated/floor/plating{tag = "icon-warnplate (SOUTHWEST)"; icon_state = "warnplate"; dir = 10},/area/awaymission/articwasteland/gateway)
"M" = (/obj/machinery/space_heater,/turf/simulated/floor/plating{dir = 2; icon_state = "warnplate"},/area/awaymission/articwasteland/gateway)
"N" = (/turf/simulated/floor/plating{tag = "icon-warnplate (SOUTHEAST)"; icon_state = "warnplate"; dir = 6},/area/awaymission/articwasteland/gateway)
"O" = (/turf/simulated/wall/mineral/sandstone,/area/awaymission/articwasteland)
"P" = (/obj/structure/table/glass,/obj/item/stack/sheet/wood/bigstack,/turf/simulated/floor/plating,/area/awaymission/articwasteland/gateway)
"Q" = (/obj/machinery/light,/turf/simulated/floor/plating,/area/awaymission/articwasteland/gateway)
"R" = (/obj/structure/flora/tree/pine,/turf/unsimulated/floor/snow,/area/awaymission/articwasteland)
"S" = (/obj/structure/ladder{height = 1; id = "arcticwaste"},/turf/unsimulated/floor/snow,/area/awaymission/articwasteland)
"T" = (/obj/structure/flora/bush,/turf/unsimulated/floor/snow,/area/awaymission/articwasteland)
"U" = (/obj/structure/flora/tree/pine,/obj/structure/flora/grass/both,/turf/unsimulated/floor/snow,/area/awaymission/articwasteland)
"V" = (/obj/structure/flora/grass/both,/turf/unsimulated/floor/snow,/area/awaymission/articwasteland)
"W" = (/obj/effect/landmark{name = "awaystart"},/turf/unsimulated/floor/snow,/area/awaymission/articwasteland)
"X" = (/obj/structure/flora/grass/both,/obj/effect/landmark{name = "awaystart"},/turf/unsimulated/floor/snow,/area/awaymission/articwasteland)

(1,1,1) = {"
aaaaaaaaaaaaaaaaaaaaaaaaaaaaaaaaaaaaaaaaaaaaaaaaaaaaaaaaaaaaaaaaaaaaaaaaaaaaaaaaaaaaaaaaaaaaaaaaaaaaaaaaaaaaa
aaaaaaaaaaaaaaaaaaaaaaaaaaaaaaaaaaaaaaaaaaaaaaaaaaaaaaaaaaaaaaaaaaaaaaaaaaaaaaaaaaaaaaaaaaaaaaaaaaaaaaaaaaaaa
aaaaaaaaaaaaaaaaaaaaaaaaaaaaaaaaaaaaaaaaaaaaaaaaaaaaaaaaaaaaaaaaaaaaaaaaaaaaaaaaaaaaaaaaaaaaaaaaaaaaaaaaaaaaa
aaaaaaaaaaaaaaaaaaaaaaaaaaaaaaaaaaaaaaaaaaaaaaaaaaaaaaaaaaaaaaaaaaaaaaaaaaaaaaaaaaaaaaaaaaaaaaaaaaaaaaaaaaaaa
aaaaaaaaaaaaaaaaaaaaaaaaaaaaaaaaaaaaaaaaaaaaaaaaaaaaaaaaaaaaaaaaaaaaaaaaaaaaaaaaaaaaaaaaaaaaaaaaaaaaaaaaaaaaa
aaaaaaaaaaaaaaaaaaaaaaaaaaaaaaaaaaaaaaaaaaaaaaaaaaaaaaaaaaaaaaaaaaaaaaaaaaaaaaaaaaaaaaaaaaaaaaaaaaaaaaaaaaaaa
aaaaaaadddddddddddddddddddddddddddddddddddddddddddddddddddddddddddddddaaaaaaaaaaaaaaaaaaaaaacccccaaaaaaaaaaaa
aaaaaaaeRRRRRRRRRRRRRRRRRRRRRRRRRRRRRRRRRRRRRRRRRRRRRRRRRRRRRRRRRRRRRRaaaaaaaaaaaaaaaaaaaaaaccfccaaaaaaaaaaaa
aaaaaaaRdddddddddddddddddddddddddddddddddddddddddddddddddddddddddddRRdaaaaaaaaaaaaaaaaaccccaccgccaccccaaaaaaa
aaaaaaaRddddddddddddddddddddddddddddddddddddddddddddddddddddddddddddddaaaaaaaaaaaaaaaacccccccchccccccccaaaaaa
aaaaaaaRdddddddddddddddddddddddddddddddddddddddddddddddddddddddddddddRaaaaaaaaaaaaaaaacccccccciccccccccaaaaaa
aaaaaaaRdddddddddddddddddddddddddddddddddddddddddddddddddddddddddddddRaaaaaaaaaaaaaaaaccjiikiiiiiklimccaaaaaa
aaaaaaaRddddddddddddddddddddddddddddddddddddddddddddddddddddddddddddddddaaaaaaaaaaaaaaccnopppppppppqrccaaaaaa
aaaaaaaRddddddddddddddddddddddddddddddddddddddddddddddddddddddddddddddddaaaaaaaaaaaaaacsitiiiiiiiuiviwcaaaaaa
aaaaaaaRddddddddddddddddddddddddddddddddddddddddddddddddddddddddddddddRddaaaaaaaaaaaaacxitliiyzAiiiviBcaaaaaa
aaaaaaaRdddddddddddddddddddddddddddddddddddddddddddddddddddddddddddddddRdaaaaaaaaaaaaacCitiiiDEFiiiviGcaaaaaa
aaaaaaaRdddddddddddddddddddddddddddddddddddddddddddddddddddddddddddddddddaaaaaaaaaaaaaccnHIIIJKLMIINrccaaaaaa
aaaaaaaRdddddddddddddddddddddddddddddddddddddddddddddddddddddddddddddddRdOaaaaaaaaaaaaccPiiQiiiiiQiiPccaaaaaa
aaaaaaaRdddddddddddddddddddddddddddddddddddddddddddddddddddddddddddddddRdRaaaaaaaaaaaacccccccccccccccccaaaaaa
aaaaaaaRdddddddddddddddddddddddddddddddddddddddddddddddddddddddddddddddddddaaaaaaaaaaaaaaaaaaaaaaaaaaaaaaaaaa
aaaaaaaRdddddddddddddddddddddddddddddddddddddddddddddddddddddddddddddddddddaaaaaaaaaaaaaaaaaaaaaaaaaaaaaaaaaa
aaaaaaaRddddddddddddddddddddddddddddddddddddddddddddddddddddddddddddddddRRdaaaaaaaaaaaaaaaaaaaaaaaaaaaaaaaaaa
aaaaaaaRddddddddddddddddddddddddddddddddddddddddddddddddddddddddddddddddRddaaaaaaaaaaaaaaaaaaaaaaaaaaaaaaaaaa
aaaaaaaRddddddddddddddddddddddddddddddddddddddddddddddddddddddddddddddddddddaaaaaaaaaaaaaaaaaaaaaaaaaaaaaaaaa
aaaaaaaRdddddddddddddddddddddddddddddddddddddddddddddddddddddddddddddddddRRdaaaaaaaaaaaaaaaaaaaaaaaaaaaaaaaaa
aaaaaaaRddddddddddddddddddddddddddddddddddddddddddddddddddddddddddddddddddddaaaaaaaaaaaaaaaaaaaaaaaaaaaaaaaaa
aaaaaaaRddddddddddddddddddddddddddddddddddddddddddddddddddddddddddddddddddddaaaaaaaaaaaaaaaaaaaaaaaaaaaaaaaaa
aaaaaaaRddddddddddddddddddddddddddddddddddddddddddddddddddddddddddddddddddRdaaaaaaaaaaaaaaaaaaaaaaaaaaaaaaaaa
aaaaaaaRddddddddddddddddddddddddddddddddddddddddddddddddddddddddddddddddddddddaaaaaaaaaaaaaaaaaaaaaaaaaaaaaaa
aaaaaaaRdddddddddddddddddddddddddddddddddddddddddddddddddddddddddddddddddddddddaaaaaaaaaaaaaaaaaaaaaaaaaaaaaa
aaaaaaaRdddddddddddddddddddddddddddddddddddddddddddddddddddddddddddddddddddRdRdddaaaaaaaaaaaaaaaaaaaaaaaaaaaa
aaaaaaaRdddddddddddddddddddddddddddddddddddddddddddddddddddddddddddddddddddddddRddaaaaaaaaaaaaaaaaaaaaaaaaaaa
aaaaaaaRddddddddddddddddddddddddddddddddddddddddddddddddddddddddddddddddddddddddddaaaaaaaaaaaaaaaaaaaaaaaaaaa
aaaaaaaRdddddddddddddddddddddddddddddddddddddddddddddddddddddddddddddddddddddddddRdaaaaaaaaaaaaaaaaaaaaaaaaaa
aaaaaaaRdddddddddddddddddddddddddddddddddddddddddddddddddddddddddddddddddddddddddddddbaaaaaaaaaaaaaaaaaaaaaaa
aaaaaaaRdddddddddddddddddddddddddddddddddddddddddddddddddddddddddddddddddddddddddddRdRddaaaaaaaaaaaaaaaaaaaaa
aaaaaaaRdddddddddddddddddddddddddddddddddddddddddddddddddddddddddddddddddddddddddddddRdRaaaaaaaaaaaaaaaaaaaaa
aaaaaaaRddddddddddddddddddddddddddddddddddddddddddddddddddddddddddddddddddddddddddddddddaaaaaaaaaaaaaaaaaaaaa
aaaaaaaRdddddddddddddddddddddddddddddddddddddddddddddddddddddddddddddddddddddddddddddddRddaaaaaaaaaaaaaaaaaaa
aaaaaaaRddddddddddddddddddddddddddddddddddddddddddddddddddddddddddddddddddddddddddddddddRdaaaaaaaaaaaaaaaaaaa
aaaaaaaRdddddddddddddddddddddddddddddddddddddddddddddddddddddddddddddddddddddddddddddddddddaaaaaaaaaaaaaaaaaa
aaaaaaaRdddddddddddddddddddddddddddddddddddddddddddddddddddddddddddddddddddddddddddddddddddaaaaaaaaaaaaaaaaaa
aaaaaaaRdddddddddddddddddddddddddddddddddddddddddddddddddddddddddddddddddddddddddddddddddRdaaaaaaaaaaaaaaaaaa
aaaaaaaRdddddddddddddddddddddddddddddddddddddddddddddddddddddddddddddddddddddddddddddddddddaaaaaaaaaaaaaaaaaa
aaaaaaaRdddddddddddddddddddddddddddddddddddddddddddddddddddddddddddddddddddddddddddddddddddaaaaaaaaaaaaaaaaaa
aaaaaaaRdddddddddddddddddddddddddddddddddddddddddddddddddddddddddddddddddddddddddddddddddRdaaaaaaaaaaaaaaaaaa
aaaaaaaRdddddddddddddddddddddddddddddddddddddddddddddddddddddddddddddddddddddddddddddddddddaaaaaaaaaaaaaaaaaa
aaaaaaaRddddddddddddddddddddddddddddddddddddddddddddddddddddddSddddddddddddddddddddddddddddaaaaaaaaaaaaaaaaaa
aaaaaaaRdddddddddddddddddddddddddddddddddddddddddddddddddddddddddddddddddddddddddddddddddRdaaaaaaaaaaaaaaaaaa
aaaaaaaRdddddddddddddddddddddddddddddddddddddddddddddddddddddddddddddddddddddddddddddddddddaaaaaaaaaaaaaaaaaa
aaaaaaaRdddddddddddddddddddddddddddddddddddddddddddddddddddddddddddddddddddddddddddddddddddaaaaaaaaaaaaaaaaaa
aaaaaaaRdddddddddddddddddddddddddddddddddddddddddddddddddddddddddddddddddddddddddddddddddRdaaaaaaaaaaaaaaaaaa
aaaaaaaRdddddddddddddddddddddddddddddddddddddddddddddddddddddddddddddddddddddddddddddddddRdaaaaaaaaaaaaaaaaaa
aaaaaaaRddddddddddddddddddddddddddddddddddddddddddddddddddddddddddddddddddddddddddddddddddddaaaaaaaaaaaaaaaaa
aaaaaaaRdddddddddddddddddddddddddddddddddddddddddddddddddddddddddddddddddddddddddddddddddddddaaaaaaaaaaaaaaaa
aaaaaaaRddddddddddddddddddddddddddddddddddddddddddddddddddddddddddddddddddddddddddddddddddRddaaaaaaaaaaaaaaaa
aaaaaaaRddddddddddddddddddddddddddddddddddddddddddddddddddddddddddddddddddddddddddddddddddRddaaaaaaaaaaaaaaaa
aaaaaaaRddddddddddddddddddddddddddddddddddddddddddddddddddddddddddddddTdddddddddddddddddddddddaaaaaaaaaaaaaaa
aaaaaaaRddddddddddddddddddddddddddddddddddddddddddddddddddddddddddddddddddddddddddddddddddddRdbaaaaaaaaaaaaaa
aaaaaaaRddddddddddddddddddddddddddddddddddddddddddddddddddddddddddddddddddddddddddddddddddddddRaaaaaaaaaaaaaa
aaaaaaaRdddddddddddddddddddddddddddddddddddddddddddddddddddddddddddddddddddddddddddddddddddddddddaaaaaaaaaaaa
aaaaaaaRdddddddddddddddddddddddddddddddddddddddddddddddddddddddddddddddddddddddddddddddddddddddddaaaaaaaaaaaa
aaaaaaaRdddddddddddddddddddddddddddddddddddddddddddddddddddddddddddddddddddddddddddddddddddddddRddaaaaaaaaaaa
aaaaaaaRddddddddddddddddddddddddddddddddddddddddddddddddddddTddddddddddddddddddddddddddddddddddddddaaaaaaaaaa
aaaaaaaRdddddddddddddddddddddddddddddddddddddddddddddddddddddddddddddddddddddddddddddddddddddddddRdaaaaaaaaaa
aaaaaaaRdddddddddddddddddddddddddddddddddddddddddddddddddddddddddddddddddddddddddddddddddddddddddddbbaaaaaaaa
aaaaaaaRdddddddddddddddddddddddddddddddddddddddddddddddddddddddddddddddddddddddddddddddddddddddddddRRddaaaaaa
aaaaaaaRdddddddddddddddddddddddddddddddddddddddddddddddddddddddddddddddddddddddddddddddddddddddddddddRRaaaaaa
aaaaaaaRddddddddddddddddddddddddddddddddddddddddddddddddddddddddddddddddddddddddddddddddddddddddddddddRaaaaaa
aaaaaaaRdddddddddddddddddddddddddddddddddddddddddddddddddddddddddddddddddddddddddddddddddddddddddddddRRaaaaaa
aaaaaaaRddddddddddddddddddddddddddddddddddddddddddddddddddddddddddddddddddddddddddddddddddddddddddddddRaaaaaa
aaaaaaaRddddddddddddddddddddddddddddddddddddddddddddddddddddddddddddddddddddddddddddddddddddddddddddddRaaaaaa
aaaaaaaRddddddddddddddddddddddddddddddddddddddddddddTdddddddddddddddddddddddddddddddddddddddddddddddddRaaaaaa
aaaaaaaRddddddddddddddddddddddddddddddddddddddddddddddddddddddddddddddddddddddddddddddddddddddddddddddRaaaaaa
aaaaaaaRddddddddddddddddddddddddddddddddddddddddddddddddddddddddddddddddddddddddddddddddddddddddddddddRaaaaaa
aaaaaaaRddddddddddddddddddddddddddddddddddddddddddddddddddddddddddddddddddddddddddddddddddddddddddddddRaaaaaa
aaaaaaaRddddddddddddddddddddddddddddddddddddddddddddddddddddddddddddddddddddddddddddddddddddddddddddddRaaaaaa
aaaaaaaRddddddddddddddddddddddddddddddddddddddddddddddddddddddddddddddddddddddddddddddddddddddddddddddRaaaaaa
aaaaaaaRddddddddddddddddddddddddddddddddddddddddddddddddddddddddddddddddddddddddddddddddddddddddddddddRaaaaaa
aaaaaaaRddddddddddddddddddddddddddddddddddddddddddddddddddddddddddddddddddddddddddddddddddddddddddddddRaaaaaa
aaaaaaaRddddddddddddddddddddddddddddddddddddddddddddddddddddddddddddddddddddddddddddddddddddddddddddddRaaaaaa
aaaaaaaRddddddddddddddddddddddddddddddddddddddddddddddddddddddddddddddddddddddddddddddddddddddddddddddRaaaaaa
aaaaaaaRdddddddddddddddddddddddddddddddddddddddddddTddddddddddddddddddddddddddddddddddddddddddddddddddRaaaaaa
aaaaaaaRddddddddddddddddddddddddddddddddddddddddddddddddddddddddddddddddddddddddddddddddddddddddddddddRaaaaaa
aaaaaaaRddddddddddddddddddddddddddddddddddddddddddddddddddddddddddddddddddddddddddddddddddddddddddddddRaaaaaa
aaaaaaaRddddddddddddddddddddddddddddddddddddddddddddddddddddddddddddddddddddddddddddddddddddddddddddddRaaaaaa
aaaaaaaRddddddddddddddddddddddddddddddddddddddddddddddddddddddddddddddddddddddddddddddddddddddddddddddRaaaaaa
aaaaaaaRddddddddddddddddddddddddddddddddddddddddddddddddddddddddddddddddddddddddddddddddddddddddddddddRaaaaaa
aaaaaaaRddddddddddddddddddddddddddddddddddddddddddddddddddddddddddddddddddddddddddddddddddddddddddddddRaaaaaa
aaaaaaaRddddddddddddddddddddddddddddddddddddTdddddddddddddddddddddddddddddddddddddddddddddddddddddddddRaaaaaa
aaaaaaaRddddddddddddddddddddddddddddddddddddddddddddddddddddddddddddddddddddddddddddddddddddddddddddddRaaaaaa
aaaaaaaRddddddddddddddddddddddddddddddddddddddddddddddddddddddddddddddddddddddddddddddddddddddddddddddRaaaaaa
aaaaaaaRddddddddddddddddddddddddddddddddddddddddddddddddddddddddddddddddddddddddddddddddddddddddddddddRaaaaaa
aaaaaaaRUddddddddVddddddddddddddddddddddddddddddddddddddddddddddddddddddddddddddddddddddddddddddddddVdRaaaaaa
aaaaaaaRdVdddRddRdddddddddRddddddddddddddddddddddddddddddddddddddddddddddddddddddddddddddddddddddddWdRRaaaaaa
aaaaaaaRdRdRdVddddddRVdddVdVddddddddVRddddVddVdRddVddVdddddddddddddddddddVddddddddddddddddddddVddddVddRaaaaaa
aaaaaaaRdVWddddddRddddddVdddddRVVRdddWddUdddddddddddddRdVddddddRVdddddVddddRVdddddddVdddddVdddddddddRdRaaaaaa
aaaaaaaRRddUddRddVddddRdRddRdddddddddddddddRddRdVRddddVRddddVdUddddRVddRdddddRddddVRddRddRdddddRdVRddVRaaaaaa
aaaaaaaRdddddRdVddRddRVdWUddVRdRdRddRdRVdRddVddRdddXRdddddVRdddddVRddRddRVddVddXdRdddVdRVdddRdVRRdddddRaaaaaa
aaaaaaaRddRdddVdRdddddddddRdddddddddddddddRddddddddddddddRdddddRddddddddddRdddRdRdddRdRdddRdRRddRdRdRdRaaaaaa
aaaaaaaRdddddddddddRddddddddddddddRddddddddddddddRdddddddddddddddddddddRddddddddddddddddddddddddddddddRaaaaaa
aaaaaaaRRRRRRRRRRRRRRRRRRRRRRRRRRRRRRRRRRRRRRRRRRRRRRRRRRRRRRRRRRRRRRRRRRRRRRRRRRRRRRRRRRRRRRRRRRRRRRRRaaaaaa
aaaaaaaaaaaaaaaaaaaaaaaaaaaaaaaaaaaaaaaaaaaaaaaaaaaaaaaaaaaaaaaaaaaaaaaaaaaaaaaaaaaaaaaaaaaaaaaaaaaaaaaaaaaaa
aaaaaaaaaaaaaaaaaaaaaaaaaaaaaaaaaaaaaaaaaaaaaaaaaaaaaaaaaaaaaaaaaaaaaaaaaaaaaaaaaaaaaaaaaaaaaaaaaaaaaaaaaaaaa
aaaaaaaaaaaaaaaaaaaaaaaaaaaaaaaaaaaaaaaaaaaaaaaaaaaaaaaaaaaaaaaaaaaaaaaaaaaaaaaaaaaaaaaaaaaaaaaaaaaaaaaaaaaaa
aaaaaaaaaaaaaaaaaaaaaaaaaaaaaaaaaaaaaaaaaaaaaaaaaaaaaaaaaaaaaaaaaaaaaaaaaaaaaaaaaaaaaaaaaaaaaaaaaaaaaaaaaaaaa
aaaaaaaaaaaaaaaaaaaaaaaaaaaaaaaaaaaaaaaaaaaaaaaaaaaaaaaaaaaaaaaaaaaaaaaaaaaaaaaaaaaaaaaaaaaaaaaaaaaaaaaaaaaaa
aaaaaaaaaaaaaaaaaaaaaaaaaaaaaaaaaaaaaaaaaaaaaaaaaaaaaaaaaaaaaaaaaaaaaaaaaaaaaaaaaaaaaaaaaaaaaaaaaaaaaaaaaaaaa
aaaaaaaaaaaaaaaaaaaaaaaaaaaaaaaaaaaaaaaaaaaaaaaaaaaaaaaaaaaaaaaaaaaaaaaaaaaaaaaaaaaaaaaaaaaaaaaaaaaaaaaaaaaaa
"}
