//MAP CONVERTED BY dmm2tgm.py THIS HEADER COMMENT PREVENTS RECONVERSION, DO NOT REMOVE
"aa" = (
/turf/simulated/wall/invulnerable/ice,
/area)
"ab" = (
/turf/unsimulated/mineral/internal/ice,
/area/mine/unexplored)
"ad" = (
/turf/simulated/floor/plating/snow,
/area/awaymission/snowplanet)
"af" = (
/obj/structure/flora/ausbushes/fullgrass,
/turf/simulated/floor/plating/snow,
/area/awaymission/snowplanet)
"ag" = (
/obj/structure/flora/rock,
/turf/simulated/floor/plating/snow,
/area/awaymission/snowplanet)
"ah" = (
/obj/structure/flora/rock/pile/snow,
/turf/simulated/floor/plating/snow,
/area/awaymission/snowplanet)
"aj" = (
/obj/structure/flora/bush,
/turf/simulated/floor/plating/snow,
/area/awaymission/snowplanet)
"ak" = (
/obj/structure/flora/tree/pine,
/turf/simulated/floor/plating/snow,
/area/awaymission/snowplanet)
"al" = (
/obj/structure/flora/rock/pile,
/turf/simulated/floor/plating/snow,
/area/awaymission/snowplanet)
"am" = (
/obj/structure/flora/tree/dead,
/turf/simulated/floor/plating/snow,
/area/awaymission/snowplanet)
"an" = (
/obj/structure/flora/grass/both,
/turf/simulated/floor/plating/snow,
/area/awaymission/snowplanet)
"ao" = (
/turf/simulated/wall,
/area/awaymission/snowplanet)
"ap" = (
/obj/structure/window/reinforced,
/obj/structure/window/reinforced{
	dir = 1
	},
/obj/structure/window/reinforced{
	dir = 4
	},
/obj/structure/window/reinforced{
	dir = 8
	},
/obj/structure/grille,
/turf/simulated/floor/plating,
/area/awaymission/snowplanet)
"aq" = (
/turf/simulated/floor{
	icon_state = "dark"
	},
/area/awaymission/snowplanet)
"ar" = (
/obj/effect/decal/warning_stripes{
	dir = 9;
	icon_state = "warning";
	tag = "icon-warning (NORTHWEST)"
	},
/turf/simulated/floor/bluegrid,
/area/awaymission/snowplanet)
"as" = (
/turf/simulated/floor/bluegrid,
/area/awaymission/snowplanet)
"at" = (
/obj/effect/decal/warning_stripes{
	dir = 5;
	icon_state = "warning";
	tag = "icon-warning (NORTHEAST)"
	},
/turf/simulated/floor/bluegrid,
/area/awaymission/snowplanet)
"au" = (
/obj/structure/flora/tree_stump,
/turf/simulated/floor/plating/snow,
/area/awaymission/snowplanet)
"aw" = (
/obj/machinery/gateway/center/away,
/obj/effect/decal/warning_stripes{
	dir = 4;
	icon_state = "unloading"
	},
/turf/simulated/floor/light,
/area/awaymission/snowplanet)
"ay" = (
/obj/effect/decal/warning_stripes{
	dir = 10;
	icon_state = "warning";
	tag = "icon-warning (SOUTHWEST)"
	},
/turf/simulated/floor/bluegrid,
/area/awaymission/snowplanet)
"az" = (
/obj/machinery/gateway/away,
/obj/effect/decal/warning_stripes{
	icon_state = "loading_area";
	tag = "icon-loading_area"
	},
/turf/simulated/floor/bluegrid,
/area/awaymission/snowplanet)
"aA" = (
/obj/effect/decal/warning_stripes{
	dir = 6;
	icon_state = "warning";
	tag = "icon-warning (SOUTHEAST)"
	},
/turf/simulated/floor/bluegrid,
/area/awaymission/snowplanet)
"aB" = (
/mob/living/simple_animal/crab/snowy,
/turf/simulated/floor/plating/snow,
/area/awaymission/snowplanet)
"aC" = (
/turf/simulated/wall/mineral/wood,
/area/awaymission/snowplanet)
"aD" = (
/obj/structure/window/reinforced{
	dir = 1
	},
/obj/structure/window/reinforced{
	dir = 4
	},
/obj/structure/window/reinforced{
	dir = 8
	},
/obj/structure/grille,
/obj/structure/window/reinforced/tinted,
/turf/simulated/floor/plating,
/area/awaymission/snowplanet)
"aE" = (
/obj/machinery/door/mineral/wood,
/turf/simulated/floor/wood,
/area/awaymission/snowplanet)
"aF" = (
/obj/structure/hanging_lantern{
	dir = 8
	},
/turf/simulated/floor/wood,
/area/awaymission/snowplanet)
"aG" = (
/turf/simulated/floor/wood,
/area/awaymission/snowplanet)
"aH" = (
/obj/machinery/space_heater/campfire/stove/fireplace,
/turf/simulated/floor/wood,
/area/awaymission/snowplanet)
"aI" = (
/obj/item/stack/sheet/wood,
/obj/item/stack/sheet/wood,
/obj/item/weapon/lighter/zippo,
/turf/simulated/floor/wood,
/area/awaymission/snowplanet)
"aJ" = (
/obj/structure/bed/chair/comfy/brown{
	dir = 4
	},
/turf/simulated/floor/wood,
/area/awaymission/snowplanet)
"aK" = (
/obj/structure/table/woodentable,
/turf/simulated/floor/wood,
/area/awaymission/snowplanet)
"aL" = (
/obj/structure/bed/chair/comfy/brown{
	dir = 8
	},
/turf/simulated/floor/wood,
/area/awaymission/snowplanet)
"aM" = (
/obj/structure/bed/chair/wood/normal,
/turf/simulated/floor/wood,
/area/awaymission/snowplanet)
"aN" = (
/obj/structure/bed/chair/wood/normal{
	dir = 1
	},
/turf/simulated/floor/wood,
/area/awaymission/snowplanet)
"aO" = (
/mob/living/simple_animal/corgi/saint,
/turf/simulated/floor/wood,
/area/awaymission/snowplanet)
"aP" = (
/obj/structure/hanging_lantern{
	dir = 4
	},
/turf/simulated/floor/wood,
/area/awaymission/snowplanet)
"aQ" = (
/obj/structure/window/reinforced{
	dir = 8
	},
/obj/structure/window/reinforced{
	dir = 4
	},
/obj/structure/window/reinforced{
	dir = 1
	},
/obj/structure/grille,
/turf/simulated/floor/plating,
/area/awaymission/snowplanet)
"aR" = (
/obj/structure/closet/cabinet/snow,
/turf/simulated/floor/wood,
/area/awaymission/snowplanet)
"aS" = (
/obj/structure/window/reinforced{
	dir = 8
	},
/obj/structure/window/reinforced{
	dir = 4
	},
/obj/structure/window/reinforced,
/obj/structure/grille,
/turf/simulated/floor/plating,
/area/awaymission/snowplanet)
"aT" = (
/obj/structure/window/barricade/snow,
/turf/simulated/floor/plating/snow,
/area/awaymission/snowplanet)
"aU" = (
/obj/structure/flora/ausbushes/sparsegrass,
/turf/simulated/floor/plating/snow,
/area/awaymission/snowplanet)
"aV" = (
/obj/structure/flora/tree,
/turf/simulated/floor/plating/snow,
/area/awaymission/snowplanet)
"aW" = (
/obj/structure/flora/bush,
/obj/structure/hanging_lantern{
	dir = 4
	},
/turf/simulated/floor/plating/snow,
/area/awaymission/snowplanet)
"aX" = (
/obj/structure/hanging_lantern,
/turf/simulated/floor/wood,
/area/awaymission/snowplanet)
"aY" = (
/obj/machinery/door/airlock/external,
/turf/simulated/floor/plating/snow,
/area/awaymission/snowplanet)
"aZ" = (
/obj/structure/hanging_lantern{
	dir = 8
	},
/turf/simulated/floor/plating/snow,
/area/awaymission/snowplanet)
"ba" = (
/obj/structure/flora/ausbushes/ywflowers,
/turf/simulated/floor/plating/snow,
/area/awaymission/snowplanet)
"bb" = (
/obj/structure/flora/ausbushes/sunnybush,
/turf/simulated/floor/plating/snow,
/area/awaymission/snowplanet)
"bc" = (
/obj/item/clothing/shoes/clown_shoes/elf,
/obj/item/clothing/under/elf,
/obj/item/clothing/head/elfhat,
/turf/simulated/floor/plating/snow,
/area/awaymission/snowplanet)

(1,1,1) = {"
aa
aa
aa
aa
aa
aa
aa
aa
aa
aa
aa
aa
aa
aa
aa
aa
aa
aa
aa
aa
aa
aa
aa
aa
aa
aa
aa
aa
aa
aa
aa
aa
aa
aa
aa
aa
aa
aa
aa
aa
aa
aa
aa
aa
aa
aa
aa
aa
aa
aa
aa
aa
aa
aa
aa
aa
aa
aa
aa
aa
aa
aa
"}
(2,1,1) = {"
aa
aa
aa
aa
aa
aa
aa
aa
aa
aa
aa
aa
aa
aa
aa
aa
aa
aa
aa
aa
aa
aa
aa
aa
aa
aa
aa
aa
aa
aa
aa
aa
aa
aa
aa
aa
aa
aa
aa
aa
aa
aa
aa
aa
aa
aa
aa
aa
aa
aa
aa
aa
aa
aa
aa
aa
aa
aa
aa
aa
aa
aa
"}
(3,1,1) = {"
aa
aa
aa
aa
aa
aa
aa
aa
aa
aa
aa
aa
aa
aa
aa
aa
aa
aa
aa
aa
aa
aa
aa
aa
aa
aa
aa
aa
aa
aa
aa
aa
aa
aa
aa
aa
aa
aa
aa
aa
aa
aa
aa
aa
aa
aa
aa
aa
aa
aa
aa
aa
aa
aa
aa
aa
aa
aa
aa
aa
aa
aa
"}
(4,1,1) = {"
aa
aa
aa
aa
aa
aa
aa
aa
aa
aa
aa
aa
aa
aa
aa
aa
aa
aa
aa
aa
aa
aa
aa
aa
aa
aa
aa
aa
aa
aa
aa
aa
aa
aa
aa
aa
aa
aa
aa
aa
aa
aa
aa
aa
aa
aa
aa
aa
aa
aa
aa
aa
aa
aa
aa
aa
aa
aa
aa
aa
aa
aa
"}
(5,1,1) = {"
aa
aa
aa
aa
aa
aa
aa
aa
aa
aa
aa
aa
aa
aa
aa
aa
aa
aa
aa
aa
aa
aa
aa
aa
aa
aa
aa
aa
aa
aa
aa
aa
aa
aa
aa
aa
aa
aa
aa
aa
aa
aa
aa
aa
aa
aa
aa
aa
aa
aa
aa
aa
aa
aa
aa
aa
aa
aa
aa
aa
aa
aa
"}
(6,1,1) = {"
aa
aa
aa
aa
aa
aa
aa
aa
aa
aa
aa
aa
aa
aa
aa
aa
aa
aa
aa
aa
aa
aa
aa
aa
aa
aa
aa
aa
aa
aa
aa
aa
aa
aa
aa
aa
aa
aa
aa
aa
aa
aa
aa
aa
aa
aa
aa
aa
aa
aa
aa
aa
aa
aa
aa
aa
aa
aa
aa
aa
aa
aa
"}
(7,1,1) = {"
aa
aa
aa
aa
aa
aa
aa
aa
aa
aa
aa
aa
aa
aa
aa
aa
aa
aa
aa
aa
aa
aa
aa
aa
aa
aa
aa
aa
aa
aa
aa
aa
aa
aa
aa
aa
aa
aa
aa
aa
aa
aa
aa
aa
aa
aa
aa
aa
aa
aa
aa
aa
aa
aa
aa
aa
aa
aa
aa
aa
aa
aa
"}
(8,1,1) = {"
aa
aa
aa
aa
aa
aa
aa
ab
af
ad
af
ad
ad
ad
ad
ad
ad
ad
ad
ad
ad
ad
ad
ad
ad
ad
ad
ad
ad
ad
ad
ad
ad
ad
ad
ad
ad
ad
ad
ad
ad
ab
ab
ab
ab
ab
ab
ab
ab
ab
ab
ab
ab
ab
ab
aa
aa
aa
aa
aa
aa
aa
"}
(9,1,1) = {"
aa
aa
aa
aa
aa
aa
aa
ad
ad
ab
ab
af
ad
am
ad
ad
ad
ad
ad
ad
ad
ad
ad
ad
ad
aj
ad
ad
ad
ad
ad
ad
ad
ad
ad
ad
ad
ad
ad
al
ad
ad
ab
ab
ab
ab
ab
ab
ab
ab
ab
ab
ab
ab
ab
aa
aa
aa
aa
aa
aa
aa
"}
(10,1,1) = {"
aa
aa
aa
aa
aa
aa
aa
ad
af
ad
ab
ab
ad
ad
ah
ad
ad
ad
ad
ad
aj
ad
ad
ad
ad
ad
ak
ad
ad
ad
ad
ad
ak
ad
ah
ad
ad
al
ad
ad
ad
ad
ad
ab
ab
ab
ab
ab
ab
ab
ab
ab
ab
ab
ab
aa
aa
aa
aa
aa
aa
aa
"}
(11,1,1) = {"
aa
aa
aa
aa
aa
aa
aa
af
ad
af
ab
ab
ad
al
ad
ad
ad
ah
ad
an
ad
ad
ad
ad
ad
ad
ad
ad
am
ad
ad
ad
ad
ad
ad
aj
ad
ad
aj
ad
ad
ab
ad
ab
ab
ab
ab
ab
ab
ab
ab
ab
ab
ab
ab
aa
aa
aa
aa
aa
aa
aa
"}
(12,1,1) = {"
aa
aa
aa
aa
aa
aa
aa
ab
ab
ad
af
ad
ad
an
ad
ad
ad
ad
ad
ad
ad
ad
ad
ad
ad
ah
ad
an
ad
ad
ad
ad
ad
ad
ad
ad
ad
ad
ad
ak
ad
ab
ab
ab
ab
ab
ab
ab
ab
ab
ab
ab
ab
ab
ab
aa
aa
aa
aa
aa
aa
aa
"}
(13,1,1) = {"
aa
aa
aa
aa
aa
aa
aa
ab
ab
ad
ad
ad
ad
ad
ad
ad
ad
ad
ad
ad
ak
ad
ad
ad
ad
ad
ad
ad
ad
ad
ah
ad
ad
ad
ad
ad
ad
ad
ad
ad
ad
ab
ad
ab
ab
ah
ab
ab
ab
ab
ab
ab
ab
ab
ab
aa
aa
aa
aa
aa
aa
aa
"}
(14,1,1) = {"
aa
aa
aa
aa
aa
aa
aa
ad
ag
ad
al
ad
ad
ad
ak
ad
aj
ad
ad
ad
ad
ad
ad
aU
ad
ad
ad
ad
ad
ad
aj
ad
ad
ad
ad
ak
ad
ad
ad
ad
ad
an
ab
ab
ab
an
ad
ab
ab
ab
ab
ab
ab
ah
ab
aa
aa
aa
aa
aa
aa
aa
"}
(15,1,1) = {"
aa
aa
aa
aa
aa
aa
aa
ad
ad
ad
ad
ad
ad
ad
ad
ad
ad
ad
ad
ad
ad
ad
ad
ad
aj
ad
ad
ad
ad
ad
ad
ad
an
ad
ad
ad
ah
ad
ad
ad
an
ad
ab
ab
ab
ab
ab
ab
ab
ab
ab
ab
ab
ab
ab
aa
aa
aa
aa
aa
aa
aa
"}
(16,1,1) = {"
aa
aa
aa
aa
aa
aa
aa
ad
ad
ad
ah
an
ad
ad
ad
ad
ak
ad
ah
ad
ad
ad
ad
ak
ad
ad
ad
aV
ad
ad
ad
ad
ad
ad
ad
ad
ad
ad
ad
ad
ad
ab
ab
ab
ab
ab
ab
ab
ab
ab
ab
ab
ab
ab
ab
aa
aa
aa
aa
aa
aa
aa
"}
(17,1,1) = {"
aa
aa
aa
aa
aa
aa
aa
ad
ad
ad
ad
ad
ad
aj
ad
ad
ad
ad
ad
ad
ad
ad
ad
ad
ad
ad
ad
ad
ad
ad
ah
ad
ad
ad
ad
ad
ad
ad
ad
ad
ad
ad
ab
ab
ab
ab
ab
ab
ab
ab
ab
ab
ab
ab
ab
aa
aa
aa
aa
aa
aa
aa
"}
(18,1,1) = {"
aa
aa
aa
aa
aa
aa
aa
ad
ah
ad
ad
ad
ad
ad
ad
ad
an
ad
an
ad
aB
ad
ad
ad
ad
ad
ad
ad
ad
ad
ad
ad
am
ad
ad
ad
ad
ad
ad
ad
ad
ab
ag
ab
ab
ab
ab
ab
ab
ab
ab
ab
ab
ab
ab
aa
aa
aa
aa
aa
aa
aa
"}
(19,1,1) = {"
aa
aa
aa
aa
aa
aa
aa
ad
ad
ad
ad
ad
ad
ad
ak
ad
ad
ad
ad
ad
ad
ad
ad
an
ad
ad
ad
ak
ad
ad
ad
ad
ad
ad
ad
ad
ad
ad
ak
ad
ad
al
ad
ab
ab
ab
ab
ab
ab
ab
ab
ab
ab
ab
ab
aa
aa
aa
aa
aa
aa
aa
"}
(20,1,1) = {"
aa
aa
aa
aa
aa
aa
aa
ad
ad
ad
ad
ad
ad
ad
ad
ad
ad
ad
ad
ad
ad
ad
ad
ah
ad
ad
ad
ad
ad
ad
ad
ad
ad
ad
ad
ah
ad
ad
ad
ad
ad
ab
ab
ab
ab
ab
ab
ab
ab
ab
ad
ab
ab
ab
ab
aa
aa
aa
aa
aa
aa
aa
"}
(21,1,1) = {"
aa
aa
aa
aa
aa
aa
aa
ad
ad
aj
ad
ah
ad
ad
ad
ad
ah
ad
ad
ak
ad
ad
ad
ad
ad
ad
ad
ah
ad
ad
ad
ad
ad
ad
ad
ad
ad
ad
ad
ad
ad
ab
ab
ab
ab
ab
ab
ab
ab
ab
an
ab
ab
ab
ab
aa
aa
aa
aa
aa
aa
aa
"}
(22,1,1) = {"
aa
aa
aa
aa
aa
aa
aa
ad
ad
ak
ad
an
ad
ad
ad
am
ad
ad
ad
ad
ad
ad
ad
ad
ad
ad
ad
ad
ad
ad
an
ad
ah
ad
ad
ad
ad
ad
ad
ad
ad
ab
ab
ab
ab
ab
ab
ab
ab
ab
ab
ab
ab
ab
ab
aa
aa
aa
aa
aa
aa
aa
"}
(23,1,1) = {"
aa
aa
aa
aa
aa
aa
aa
ad
ad
ad
ad
ad
ad
ad
ad
ad
ad
ad
ad
ad
ad
ad
ad
aj
ad
an
aj
ad
ad
au
ad
ad
ad
ad
ad
an
an
ad
ad
ad
ad
ad
ab
ab
ab
ab
ab
ad
ad
an
ah
ab
ab
ab
ab
aa
aa
aa
aa
aa
aa
aa
"}
(24,1,1) = {"
aa
aa
aa
aa
aa
aa
aa
ad
ad
ak
ad
ad
ad
ad
ad
ad
ad
ad
ad
ad
ad
aj
ad
ad
ad
ad
ad
ad
ad
ad
ad
ad
ad
ad
ad
an
an
ad
ad
ah
ad
ad
ab
ab
ab
ad
ad
ad
ab
ab
ab
ab
al
ab
ab
aa
aa
aa
aa
aa
aa
aa
"}
(25,1,1) = {"
aa
aa
aa
aa
aa
aa
aa
ad
ad
ad
ah
ad
ad
ad
ad
ad
an
ad
ad
ad
aj
ad
ad
au
ad
aj
ad
ad
ad
ad
ad
ad
ag
ad
ad
ad
ad
ad
an
ad
ad
ab
ad
ad
ad
ad
ab
ab
ad
ad
ab
ab
ad
ad
ab
aa
aa
aa
aa
aa
aa
aa
"}
(26,1,1) = {"
aa
aa
aa
aa
aa
aa
aa
ad
ad
ad
ad
ad
aj
ad
ad
ad
ad
ad
ad
ad
ad
ad
ad
ad
ad
ad
aT
aT
aT
aT
aT
aT
aT
aT
aT
aT
aT
au
ad
ad
an
ad
ad
ad
ad
ad
ad
ad
ad
ad
an
ad
ad
ah
ad
aa
aa
aa
aa
aa
aa
aa
"}
(27,1,1) = {"
aa
aa
aa
aa
aa
aa
aa
ad
ad
ad
ad
ad
ad
ad
ak
ad
ad
ad
ad
ad
aT
aT
aT
aT
aT
aT
aT
aC
aC
ap
aC
ap
aC
ap
aC
aC
aT
ad
ad
ad
ad
ad
ad
ad
ad
al
ad
ad
ad
ad
ad
ad
al
ad
an
aa
aa
aa
aa
aa
aa
aa
"}
(28,1,1) = {"
aa
aa
aa
aa
aa
aa
aa
ad
ad
ad
ak
ad
ad
ad
ad
an
ad
ad
ah
ad
aT
ao
ao
ap
ao
ap
ao
ao
aF
aG
aG
aG
aG
aG
aG
aC
aT
aT
aW
ba
ba
ad
ad
ad
am
ad
ad
ad
ad
ad
ad
ad
ad
ad
ad
aa
aa
aa
aa
aa
aa
aa
"}
(29,1,1) = {"
aa
aa
aa
aa
aa
aa
aa
ad
ad
ad
ad
ad
am
an
ad
ad
ad
ad
ad
au
aT
ao
aq
aq
aq
aq
aq
aD
aG
aG
aJ
aG
aG
aG
aO
aC
aQ
aS
aC
ba
ba
aj
ad
ad
ad
ad
an
ad
ad
ad
an
an
ad
ad
ad
aa
aa
aa
aa
aa
aa
aa
"}
(30,1,1) = {"
aa
aa
aa
aa
aa
aa
aa
ad
ad
ad
ad
ad
ad
ad
ad
ad
ad
ak
ad
ad
aT
ao
ar
as
ay
aq
aq
ao
aG
aG
aK
aG
aG
aG
aG
aC
aR
aR
aC
ba
ba
au
ad
ad
ad
ad
ad
ad
ad
ad
ad
ad
ad
ad
ad
aa
aa
aa
aa
aa
aa
aa
"}
(31,1,1) = {"
aa
aa
aa
aa
aa
aa
aa
ad
ad
ak
ad
ad
ad
ad
ah
ad
ad
ad
ad
ad
aT
ap
as
aw
az
aq
aq
aE
aG
aG
aL
aG
aG
aG
aG
aE
aG
aG
aY
ad
ad
ad
ad
ad
ad
ad
ad
ad
ad
ad
ad
ak
ad
ad
an
aa
aa
aa
aa
aa
aa
aa
"}
(32,1,1) = {"
aa
aa
aa
aa
aa
aa
aa
ad
ad
ad
ad
ad
ad
ak
ad
ad
ad
ad
ad
ad
aT
ao
at
as
aA
aq
aq
ao
aG
aG
aG
aG
aG
aG
aG
aC
aG
aX
aC
ba
ba
bb
ad
ad
ad
ad
ak
ad
ad
ak
ad
ad
ad
ad
ad
aa
aa
aa
aa
aa
aa
aa
"}
(33,1,1) = {"
aa
aa
aa
aa
aa
aa
aa
ad
ad
ad
ah
ad
ad
ad
ad
ad
ad
ad
ak
ad
aT
ao
aq
aq
aq
aq
aq
ao
aH
aG
aG
aG
aG
aG
aG
aC
aQ
aS
aC
ba
ba
ah
ad
ad
ad
ad
ad
ad
ah
ad
ad
ad
ad
ak
ad
aa
aa
aa
aa
aa
aa
aa
"}
(34,1,1) = {"
aa
aa
aa
aa
aa
aa
aa
ad
ad
ad
ad
ad
ad
ad
ad
ad
ad
ad
ad
ad
aT
ao
ao
ap
ao
ap
ao
ao
aI
aG
aM
aK
aN
aG
aP
aC
aT
aT
aZ
ba
ba
ad
ad
ad
ad
ad
ad
an
ad
ad
an
ad
ad
ad
ad
aa
aa
aa
aa
aa
aa
aa
"}
(35,1,1) = {"
aa
aa
aa
aa
aa
aa
aa
ad
ad
ad
ak
ad
ad
ak
ad
ad
ad
ad
ad
ad
aT
aT
aT
aT
aT
aT
aT
aC
aC
ap
aC
ap
aC
ap
aC
aC
aT
ad
ad
ad
ad
ad
ad
ad
ad
ad
ad
ad
ad
ad
ad
ad
ad
ad
ak
aa
aa
aa
aa
aa
aa
aa
"}
(36,1,1) = {"
aa
aa
aa
aa
aa
aa
aa
ad
ad
ad
ad
ad
ad
ad
ad
ad
ad
ad
ak
ad
ad
ad
ad
ad
ad
ad
aT
aT
aT
aT
aT
aT
aT
aT
aT
aT
aT
ad
aj
ad
ad
ad
ad
ad
ad
an
al
ad
ad
ak
an
bc
an
ad
ad
aa
aa
aa
aa
aa
aa
aa
"}
(37,1,1) = {"
aa
aa
aa
aa
aa
aa
aa
ad
ad
ad
ad
ad
ad
ad
ad
ad
ad
ad
ad
ad
ad
ad
ad
au
ad
ad
ad
ag
ad
ad
au
ad
ad
au
ad
ad
ad
ad
ad
ad
ad
ad
ad
ad
ad
ad
ad
ad
ad
ad
ad
ah
ad
ad
ak
aa
aa
aa
aa
aa
aa
aa
"}
(38,1,1) = {"
aa
aa
aa
aa
aa
aa
aa
ad
ad
ad
ad
ad
ad
ad
ad
ak
ad
ad
ad
ad
ad
ad
ad
ad
ad
aj
ad
ad
ad
ad
ad
ad
ad
ad
ad
ad
ad
ad
ad
ad
ad
ad
ad
ad
ad
ak
ad
an
ad
an
ad
ad
ad
ad
ad
aa
aa
aa
aa
aa
aa
aa
"}
(39,1,1) = {"
aa
aa
aa
aa
aa
aa
aa
ad
ad
ad
ad
ad
ad
ad
ad
ad
an
ad
ad
ad
ad
ak
ad
ad
ad
ad
ad
ad
ad
ad
an
ad
ad
ad
ad
ad
ad
ad
ad
ad
ad
ad
ad
ad
ad
ad
ak
ad
ad
an
ad
ad
ad
ak
ad
aa
aa
aa
aa
aa
aa
aa
"}
(40,1,1) = {"
aa
aa
aa
aa
aa
aa
aa
ad
ad
ad
ak
ad
ad
ah
ak
ad
ad
ad
ad
ad
ad
ad
aj
ad
ad
ad
ad
ak
ad
ad
ad
ad
ad
ad
ad
ad
ad
ad
ad
ad
ad
ad
ad
ad
ad
ad
ad
ad
ad
ad
ad
ad
ad
ad
ad
aa
aa
aa
aa
aa
aa
aa
"}
(41,1,1) = {"
aa
aa
aa
aa
aa
aa
aa
ad
ad
ad
ad
ad
ad
ad
ad
ad
ad
ad
ad
ad
ad
ad
ad
ad
ad
ad
ad
ad
ad
ad
ad
ad
ad
am
ad
ad
an
ad
ad
ak
ad
ad
ad
ad
ad
ad
ad
ad
ak
ad
ad
ak
ad
ad
ad
aa
aa
aa
aa
aa
aa
aa
"}
(42,1,1) = {"
aa
aa
aa
aa
aa
aa
aa
ad
ad
ad
ad
ad
ad
ad
ad
ad
an
ad
aj
ad
ad
ad
ad
ad
ad
ad
ad
ad
ad
ad
ad
ad
ad
ad
ad
ad
ah
ad
ad
ad
ad
ad
ad
ad
ad
ad
ad
ad
ad
ad
ad
ad
ad
ad
ad
aa
aa
aa
aa
aa
aa
aa
"}
(43,1,1) = {"
aa
aa
aa
aa
aa
aa
aa
ad
ad
ad
ad
ad
aj
ad
ad
ad
ad
ad
ad
ad
ad
ad
ad
ah
ad
ad
ad
ad
ak
ad
ad
ad
aj
ad
ad
ad
ad
ad
ad
ad
ad
ad
ad
ad
ad
ad
ad
ad
ad
ad
ad
ad
ad
ad
ad
aa
aa
aa
aa
aa
aa
aa
"}
(44,1,1) = {"
aa
aa
aa
aa
aa
aa
aa
ad
ad
ad
ad
ad
ad
ad
ak
ad
ad
ad
ad
ak
ad
ad
am
ad
ad
ad
ad
ad
ad
ad
ad
ad
ad
ad
ad
ad
ad
ad
ad
ad
ad
ad
ah
am
ad
ad
ad
ad
ad
ad
ad
ah
ad
ad
ad
aa
aa
aa
aa
aa
aa
aa
"}
(45,1,1) = {"
aa
aa
aa
aa
aa
aa
aa
ad
ad
ad
ak
ad
ad
ad
ad
ad
ah
ad
ad
ad
ad
ad
ad
ad
an
ad
ad
ad
ad
ad
an
ad
ad
ad
ad
ad
ad
ad
ad
ad
ad
ad
ad
ad
ad
ad
ad
ad
ad
an
ad
am
ad
ad
ad
aa
aa
aa
aa
aa
aa
aa
"}
(46,1,1) = {"
aa
aa
aa
aa
aa
aa
aa
ad
ad
ad
ad
ad
ad
ad
ad
ad
ad
ad
ad
ad
ad
ad
ad
ad
ad
ad
ad
ad
an
ad
ad
ad
ah
ad
ad
ad
ak
ad
ad
an
aj
ad
ad
ad
ad
ad
ad
ad
ad
ad
ad
ad
ad
ad
ad
aa
aa
aa
aa
aa
aa
aa
"}
(47,1,1) = {"
aa
aa
aa
aa
aa
aa
aa
ad
ad
ad
ad
an
ad
ad
an
ad
an
ad
ad
ad
an
ad
ad
ad
ad
ad
ad
ak
ad
ad
ad
ad
ad
ad
ad
ad
ad
ad
ad
ad
ad
ad
an
ad
ad
ad
ad
ak
ad
ad
ad
ad
ad
ad
ad
aa
aa
aa
aa
aa
aa
aa
"}
(48,1,1) = {"
aa
aa
aa
aa
aa
aa
aa
ad
ad
ad
ad
ad
ah
ad
ad
ad
ad
ad
ad
ad
ad
ak
ad
an
ad
ad
ad
ad
ad
ad
ad
ad
am
ad
ad
ad
ad
an
ad
ad
ad
ad
ad
ad
ad
ad
ad
ad
ad
an
ad
ad
ad
ad
ad
aa
aa
aa
aa
aa
aa
aa
"}
(49,1,1) = {"
aa
aa
aa
aa
aa
aa
aa
ad
ad
ad
ad
ad
ad
ad
ad
ad
ad
ad
ad
ad
ad
ad
ad
ad
ad
ad
ad
an
ad
ad
ad
ad
ad
ad
ad
ad
ad
ad
ad
ad
ad
ad
ak
an
ad
ad
ad
ad
ad
ad
ad
ad
ad
ad
ad
aa
aa
aa
aa
aa
aa
aa
"}
(50,1,1) = {"
aa
aa
aa
aa
aa
aa
aa
ad
ad
ad
ad
ad
ad
ad
ad
ak
ad
ad
aj
ad
ad
ad
ad
ad
ad
aj
ad
ah
ad
ad
an
ad
ad
ad
an
ad
ad
ad
ak
ad
ad
ad
ad
ad
ad
ad
ad
ad
ah
ad
ad
ad
ad
ad
ad
aa
aa
aa
aa
aa
aa
aa
"}
(51,1,1) = {"
aa
aa
aa
aa
aa
aa
aa
ad
ad
ad
am
ad
ad
ad
ad
ad
ad
ad
ad
ad
ad
ad
ad
ak
ad
ad
ad
ad
ad
ad
ad
ad
ad
ad
ad
ad
ad
ad
ad
ad
ad
ad
ad
ad
ad
ad
ak
ad
ad
ad
ad
ad
ak
ad
ad
aa
aa
aa
aa
aa
aa
aa
"}
(52,1,1) = {"
aa
aa
aa
aa
aa
aa
aa
ad
ad
ad
ad
ad
ad
ad
ad
ad
ad
ad
ah
ad
ad
ad
ad
ad
ad
ad
ad
ad
ad
ak
ad
ad
ad
ad
ak
ad
ad
ad
ad
ad
ad
ad
ak
ad
ad
ad
ad
ad
ad
ad
ad
ad
ad
ad
ad
aa
aa
aa
aa
aa
aa
aa
"}
(53,1,1) = {"
aa
aa
aa
aa
aa
aa
aa
ad
ad
ad
ad
ad
aj
ad
ad
ad
ad
ad
ad
ad
ad
ad
ad
aj
ad
ad
ad
ad
ad
ad
ad
ad
ad
ad
ad
ad
ad
ad
ad
ad
ad
ad
ad
ad
ad
ad
ad
an
ah
an
ad
ad
ad
ad
ad
aa
aa
aa
aa
aa
aa
aa
"}
(54,1,1) = {"
aa
aa
aa
aa
aa
aa
aa
ad
ad
ad
ad
ad
ad
ad
ad
ad
ad
ad
ad
ad
ad
ad
ad
ad
ad
ad
ad
ad
ad
ad
ad
ad
ad
ad
ad
ad
ah
ad
ad
ad
ad
ad
ad
ad
ad
ad
ad
ad
ad
ad
ad
ad
ad
ad
ad
aa
aa
aa
aa
aa
aa
aa
"}
(55,1,1) = {"
aa
aa
aa
aa
aa
aa
aa
ad
ad
ad
ad
ad
ad
ad
ad
ad
ad
ad
ad
ad
ad
ad
ad
ad
ad
ad
ad
ad
ad
ad
ad
ad
ad
ad
ad
ad
ad
ad
ad
ad
ad
ad
ad
ad
ad
ad
ad
ad
ad
ad
ad
ad
ad
ad
ad
aa
aa
aa
aa
aa
aa
aa
"}
(56,1,1) = {"
aa
aa
aa
aa
aa
aa
aa
aa
aa
aa
aa
aa
aa
aa
aa
aa
aa
aa
aa
aa
aa
aa
aa
aa
aa
aa
aa
aa
aa
aa
aa
aa
aa
aa
aa
aa
aa
aa
aa
aa
aa
aa
aa
aa
aa
aa
aa
aa
aa
aa
aa
aa
aa
aa
aa
aa
aa
aa
aa
aa
aa
aa
"}
(57,1,1) = {"
aa
aa
aa
aa
aa
aa
aa
aa
aa
aa
aa
aa
aa
aa
aa
aa
aa
aa
aa
aa
aa
aa
aa
aa
aa
aa
aa
aa
aa
aa
aa
aa
aa
aa
aa
aa
aa
aa
aa
aa
aa
aa
aa
aa
aa
aa
aa
aa
aa
aa
aa
aa
aa
aa
aa
aa
aa
aa
aa
aa
aa
aa
"}
(58,1,1) = {"
aa
aa
aa
aa
aa
aa
aa
aa
aa
aa
aa
aa
aa
aa
aa
aa
aa
aa
aa
aa
aa
aa
aa
aa
aa
aa
aa
aa
aa
aa
aa
aa
aa
aa
aa
aa
aa
aa
aa
aa
aa
aa
aa
aa
aa
aa
aa
aa
aa
aa
aa
aa
aa
aa
aa
aa
aa
aa
aa
aa
aa
aa
"}
(59,1,1) = {"
aa
aa
aa
aa
aa
aa
aa
aa
aa
aa
aa
aa
aa
aa
aa
aa
aa
aa
aa
aa
aa
aa
aa
aa
aa
aa
aa
aa
aa
aa
aa
aa
aa
aa
aa
aa
aa
aa
aa
aa
aa
aa
aa
aa
aa
aa
aa
aa
aa
aa
aa
aa
aa
aa
aa
aa
aa
aa
aa
aa
aa
aa
"}
(60,1,1) = {"
aa
aa
aa
aa
aa
aa
aa
aa
aa
aa
aa
aa
aa
aa
aa
aa
aa
aa
aa
aa
aa
aa
aa
aa
aa
aa
aa
aa
aa
aa
aa
aa
aa
aa
aa
aa
aa
aa
aa
aa
aa
aa
aa
aa
aa
aa
aa
aa
aa
aa
aa
aa
aa
aa
aa
aa
aa
aa
aa
aa
aa
aa
"}
(61,1,1) = {"
aa
aa
aa
aa
aa
aa
aa
aa
aa
aa
aa
aa
aa
aa
aa
aa
aa
aa
aa
aa
aa
aa
aa
aa
aa
aa
aa
aa
aa
aa
aa
aa
aa
aa
aa
aa
aa
aa
aa
aa
aa
aa
aa
aa
aa
aa
aa
aa
aa
aa
aa
aa
aa
aa
aa
aa
aa
aa
aa
aa
aa
aa
"}
(62,1,1) = {"
aa
aa
aa
aa
aa
aa
aa
aa
aa
aa
aa
aa
aa
aa
aa
aa
aa
aa
aa
aa
aa
aa
aa
aa
aa
aa
aa
aa
aa
aa
aa
aa
aa
aa
aa
aa
aa
aa
aa
aa
aa
aa
aa
aa
aa
aa
aa
aa
aa
aa
aa
aa
aa
aa
aa
aa
aa
aa
aa
aa
aa
aa
"}
