"a" = (/turf/simulated/wall/invulnerable/ice,/area)
"b" = (/turf/unsimulated/mineral/random/high_chance,/area/mine/unexplored)
"c" = (/turf/simulated/floor/plating/snow/cold,/area/awaymission/snowplanet)
"d" = (/obj/structure/flora/ausbushes/fullgrass,/turf/simulated/floor/plating/snow/cold,/area/awaymission/snowplanet)
"e" = (/obj/structure/flora/rock,/turf/simulated/floor/plating/snow/cold,/area/awaymission/snowplanet)
"f" = (/obj/structure/flora/rock/pile/snow,/turf/simulated/floor/plating/snow/cold,/area/awaymission/snowplanet)
"g" = (/obj/structure/flora/bush,/turf/simulated/floor/plating/snow/cold,/area/awaymission/snowplanet)
"h" = (/obj/structure/flora/tree/pine,/turf/simulated/floor/plating/snow/cold,/area/awaymission/snowplanet)
"i" = (/obj/structure/flora/rock/pile,/turf/simulated/floor/plating/snow/cold,/area/awaymission/snowplanet)
"j" = (/obj/structure/flora/tree/dead,/turf/simulated/floor/plating/snow/cold,/area/awaymission/snowplanet)
"k" = (/obj/structure/flora/grass/both,/turf/simulated/floor/plating/snow/cold,/area/awaymission/snowplanet)
"l" = (/obj/structure/flora/tree_stump,/turf/simulated/floor/plating/snow/cold,/area/awaymission/snowplanet)
"m" = (/mob/living/simple_animal/crab/snowy,/turf/simulated/floor/plating/snow/cold,/area/awaymission/snowplanet)
"n" = (/obj/structure/window/barricade/snow,/turf/simulated/floor/plating/snow/cold,/area/awaymission/snowplanet)
"o" = (/turf/simulated/wall,/area/awaymission/snowplanet)
"p" = (/obj/structure/window/reinforced,/obj/structure/window/reinforced{dir = 1},/obj/structure/window/reinforced{dir = 4},/obj/structure/window/reinforced{dir = 8},/obj/structure/grille,/turf/simulated/floor/plating,/area/awaymission/snowplanet)
"q" = (/turf/simulated/floor{icon_state = "dark"},/area/awaymission/snowplanet)
"r" = (/obj/machinery/gateway{dir = 9},/obj/effect/decal/warning_stripes{tag = "icon-warning (NORTHWEST)"; icon_state = "warning"; dir = 9},/turf/simulated/floor/bluegrid,/area/awaymission/snowplanet)
"s" = (/obj/machinery/gateway{dir = 1},/turf/simulated/floor/bluegrid,/area/awaymission/snowplanet)
"t" = (/obj/machinery/gateway{dir = 5},/obj/effect/decal/warning_stripes{tag = "icon-warning (NORTHEAST)"; icon_state = "warning"; dir = 5},/turf/simulated/floor/bluegrid,/area/awaymission/snowplanet)
"u" = (/obj/structure/flora/ausbushes/sparsegrass,/turf/simulated/floor/plating/snow/cold,/area/awaymission/snowplanet)
"v" = (/obj/machinery/gateway{dir = 8},/turf/simulated/floor/bluegrid,/area/awaymission/snowplanet)
"w" = (/obj/machinery/gateway/centeraway,/obj/effect/decal/warning_stripes{dir = 4; icon_state = "unloading"},/turf/simulated/floor/light,/area/awaymission/snowplanet)
"x" = (/obj/machinery/gateway{dir = 4},/turf/simulated/floor/bluegrid,/area/awaymission/snowplanet)
"y" = (/obj/machinery/gateway{dir = 10},/obj/effect/decal/warning_stripes{tag = "icon-warning (SOUTHWEST)"; icon_state = "warning"; dir = 10},/turf/simulated/floor/bluegrid,/area/awaymission/snowplanet)
"z" = (/obj/machinery/gateway,/obj/effect/decal/warning_stripes{tag = "icon-loading_area"; icon_state = "loading_area"; dir = 2},/turf/simulated/floor/bluegrid,/area/awaymission/snowplanet)
"A" = (/obj/machinery/gateway{dir = 6},/obj/effect/decal/warning_stripes{tag = "icon-warning (SOUTHEAST)"; icon_state = "warning"; dir = 6},/turf/simulated/floor/bluegrid,/area/awaymission/snowplanet)
"B" = (/obj/structure/flora/tree,/turf/simulated/floor/plating/snow/cold,/area/awaymission/snowplanet)
"C" = (/turf/simulated/wall/mineral/wood,/area/awaymission/snowplanet)
"D" = (/obj/structure/window/reinforced{dir = 1},/obj/structure/window/reinforced{dir = 4},/obj/structure/window/reinforced{dir = 8},/obj/structure/grille,/obj/structure/window/reinforced/tinted,/turf/simulated/floor/plating,/area/awaymission/snowplanet)
"E" = (/obj/machinery/door/mineral/wood,/turf/simulated/floor/wood,/area/awaymission/snowplanet)
"F" = (/obj/structure/hanging_lantern{dir = 8},/turf/simulated/floor/wood,/area/awaymission/snowplanet)
"G" = (/turf/simulated/floor/wood,/area/awaymission/snowplanet)
"H" = (/obj/machinery/space_heater/campfire/stove/fireplace,/turf/simulated/floor/wood,/area/awaymission/snowplanet)
"I" = (/obj/structure/bed/chair/comfy/brown{dir = 4},/turf/simulated/floor/wood,/area/awaymission/snowplanet)
"J" = (/obj/structure/table/woodentable,/turf/simulated/floor/wood,/area/awaymission/snowplanet)
"K" = (/obj/structure/bed/chair/comfy/brown{dir = 8},/turf/simulated/floor/wood,/area/awaymission/snowplanet)
"L" = (/obj/structure/bed/chair/wood/normal,/turf/simulated/floor/wood,/area/awaymission/snowplanet)
"M" = (/obj/structure/bed/chair/wood/normal{dir = 1},/turf/simulated/floor/wood,/area/awaymission/snowplanet)
"N" = (/mob/living/simple_animal/corgi/saint,/turf/simulated/floor/wood,/area/awaymission/snowplanet)
"O" = (/obj/structure/hanging_lantern{dir = 4},/turf/simulated/floor/wood,/area/awaymission/snowplanet)
"P" = (/obj/structure/window/reinforced{dir = 8},/obj/structure/window/reinforced{dir = 4},/obj/structure/window/reinforced{dir = 1},/obj/structure/grille,/turf/simulated/floor/plating,/area/awaymission/snowplanet)
"Q" = (/obj/structure/closet/cabinet/snow,/turf/simulated/floor/wood,/area/awaymission/snowplanet)
"R" = (/obj/structure/window/reinforced{dir = 8},/obj/structure/window/reinforced{dir = 4},/obj/structure/window/reinforced,/obj/structure/grille,/turf/simulated/floor/plating,/area/awaymission/snowplanet)
"S" = (/obj/machinery/door/airlock/external,/turf/simulated/floor/plating/snow/cold,/area/awaymission/snowplanet)
"T" = (/obj/structure/flora/ausbushes/ywflowers,/turf/simulated/floor/plating/snow/cold,/area/awaymission/snowplanet)
"U" = (/turf/unsimulated/mineral/random,/area/mine/unexplored)
"V" = (/obj/structure/flora/ausbushes/sunnybush,/turf/simulated/floor/plating/snow/cold,/area/awaymission/snowplanet)
"W" = (/turf/unsimulated/mineral/random/high_chance_clown,/area/mine/unexplored)

(1,1,1) = {"
aaaaaaaaaaaaaaaaaaaaaaaaaaaaaaaaaaaaaaaaaaaaaaaaaa
abccdbbcccccccccccccccccccccccccccccccccccccccccca
adcdcbbecccfccccccccccccccccccccccccccccccccccccca
acbcdcccccccccghchcccccchcccccccccccccccccccccccca
adbbbdcicfccccccccfcchccccfchcccchcccchcccccjcccca
acdbbcccckccccfkcccccccccccccccccccccccckcccccccca
accccccccccccccccccgccjcccccccccccccgccccfccccgcca
acjcikccccgccccccccccckcchcchccccfccccccccccccccca
accfccchcccchccccccchcccfcccccccchccchcckcccccccca
accccccccccccccjccccckccccccccchccccccccccchccccca
accccccgchckccfccckccccccccccccckcckccfckcccccccca
acccfcccccccccccccccccchccccccccccccccccccccccccca
accccccccfckcccccccccfcccchcchcccccgcccccccgcfccca
accckccccccccchccccccclcccccccccccccchccccccccccca
accgcchccccmccccccgcnnnnnnnnnccccccccccckcccccccca
accccccccccccccccgccnooopooonccchcccccccchccccccca
acccccccccccccccccccnoqrstqonccccgcccjccccccccccca
accccccuchcckfccgclcnpqvwxqpnclcccccfcccckcchcgcca
acccccccgcccccccccccnoqyzAqonccccccccckcccccccccca
acgccfcccccccccckcgcnpqqqqqpnccgcccccccccccgccccca
acchccccccccccccgccnnoqqqqqonnccccccccccccccccccca
acccckcccBcchcfccccnCoDoEoooCnecchcccccchckfccccca
acccjccccccccccccccnCFGGGGHGCncccccchcckccccccccca
accccccccccccccclccnpGGGGGGGpnccccccccccccccchccca
acccccfgccfcccckcccnCGIJKGGLCnlckccccckcccckccccca
accccccccccccccccccnpGGGGGGJpnccccccccccccccccccca
acchcccckccjcccfccenCGGGGGGMCnccccccgccfcjccccccca
accccccccccccccccccnpGGGGGGGpnlcccjcccccccccccccca
accfcccccccccccccccnCGNGGGGOCnccccccccccccckchccca
acccgcchcccccfcckkcnCCCCECCCCnccccccccccccccccccca
acccccccfccccccckkcnnnPQGGPnnncccckfccchcccccccfca
acciccccccccccccccclcnRQGGRnccccccccccccckccccccca
acccgccccccchccccckccgCCSCCccgccccccccccccchccccca
acicchcccccccccccfcccTTTcTTTcccccchcccckccccccccca
accccccckcccccccccckcTTTcTTTcccccccccccgccccccccca
aUccUUUkcUcUiUUUccUcccglcVfcccccccccccccccccccccca
aUUccUcUUUUecUUUUUcccccccccccccccccccfcckchcchccca
aUUUUUUUUUUUUUbbbUcccccccccccccccccccjcccckcccccca
aUUUUUUUUbUUUbbbUUcccjccccccccccccccccccccccccccca
aUUUUUfkUUUUbbbbUcccicccccccckchccccccccccccccccca
aUUUUUUcUUUbbUbbUcUccckcchcccicchccccccccccchcccca
aUUUUUUUUUbbbbbUccUcccccccckccckcccccccchccccckcca
aUUbbUUUbbUbbUUUcUccccccccfccccccchccccccccfccfcca
aUUUbbbbbUUbUUUUkUccccccchccchckkccccckcckcccckcca
aUUUbUUbUbbUUckUfUUkcckcccckckccccccccccccccccccca
aUUbbUUUUUbUUUUUUUUccckchcccccfccchccfjcccccccccca
aWWWWUUUUUbbUUUUUiccicccccccckcccccccccccccchcccca
aWWWWUUfUUUUUUUUUUcfcccccchccccchcccccccccccccccca
aWWWWUUUUUUUUUUUUUUckccckccchchcccccccccccccccccca
aaaaaaaaaaaaaaaaaaaaaaaaaaaaaaaaaaaaaaaaaaaaaaaaaa
"}
