//MAP CONVERTED BY dmm2tgm.py THIS HEADER COMMENT PREVENTS RECONVERSION, DO NOT REMOVE
"a" = (
/turf/unsimulated/floor/brimstone,
/area/hell)
"o" = (
/turf/unsimulated/wall/rock,
/area/hell)

(1,1,1) = {"
o
o
o
o
o
o
o
o
o
o
o
o
o
o
o
o
o
o
o
o
o
o
o
o
o
o
o
o
o
o
o
o
o
o
o
o
o
o
o
o
o
o
o
o
o
o
o
o
o
o
o
o
o
o
o
o
o
o
o
o
o
o
o
o
"}
(2,1,1) = {"
o
o
o
o
o
o
o
o
o
o
o
o
o
o
o
o
o
o
o
o
o
o
o
o
a
a
a
a
a
a
a
o
o
o
o
a
a
a
a
a
a
a
o
o
o
o
o
o
o
o
o
o
o
o
o
o
o
o
o
o
o
o
o
o
"}
(3,1,1) = {"
o
o
o
o
o
o
o
a
a
a
a
a
o
o
o
o
a
a
a
a
a
a
a
a
a
a
a
a
a
a
a
a
a
a
a
a
a
a
a
a
a
a
a
a
a
o
o
o
a
a
a
a
o
o
o
o
o
o
o
o
o
o
o
o
"}
(4,1,1) = {"
o
o
o
a
a
a
a
a
a
a
a
a
a
a
a
a
a
a
a
a
a
a
a
a
a
a
a
a
a
a
a
a
a
a
a
a
a
a
a
a
a
a
a
a
a
a
a
a
a
a
a
a
a
a
a
a
a
a
a
a
a
o
o
o
"}
(5,1,1) = {"
o
o
o
a
a
a
a
a
a
a
a
a
a
a
a
a
a
a
a
a
a
a
a
a
a
a
a
a
a
a
a
a
a
a
a
a
a
a
a
a
a
a
a
a
a
a
a
a
a
a
a
a
a
a
a
a
a
a
a
a
a
o
o
o
"}
(6,1,1) = {"
o
o
o
a
a
a
a
a
a
a
a
a
a
a
a
a
a
a
a
a
a
a
a
a
a
a
a
a
a
a
a
a
a
a
a
a
a
a
a
a
a
a
a
a
a
a
a
a
a
a
a
a
a
a
a
a
a
a
a
a
a
o
o
o
"}
(7,1,1) = {"
o
o
a
a
a
a
a
a
a
a
a
a
a
a
a
a
a
a
a
a
a
a
a
a
a
a
a
a
a
a
a
a
a
a
a
a
a
a
a
a
a
a
a
a
a
a
a
a
a
a
a
a
a
a
a
a
a
a
a
a
a
o
o
o
"}
(8,1,1) = {"
o
o
a
a
a
a
a
a
a
a
a
a
a
a
a
a
a
a
a
a
a
a
a
a
a
a
a
a
a
a
a
a
a
a
a
a
a
a
a
a
a
a
a
a
a
a
a
a
a
a
a
a
a
a
a
a
a
a
a
a
a
o
o
o
"}
(9,1,1) = {"
o
o
a
a
a
a
a
a
a
a
a
a
a
a
a
a
a
a
a
a
a
a
a
a
a
a
a
a
a
a
a
a
a
a
a
a
a
a
a
a
a
a
a
a
a
a
a
a
a
a
a
a
a
a
a
a
a
a
a
a
a
o
o
o
"}
(10,1,1) = {"
o
o
a
a
a
a
a
a
a
a
a
a
a
a
a
a
a
a
a
a
a
a
a
a
a
a
a
a
a
a
a
a
a
a
a
a
a
a
a
a
a
a
a
a
a
a
a
a
a
a
a
a
a
a
a
a
a
a
a
a
a
a
o
o
"}
(11,1,1) = {"
o
o
a
a
a
a
a
a
a
a
a
a
a
a
a
a
a
a
a
a
a
a
a
a
a
a
a
a
a
a
a
a
a
a
a
a
a
a
a
a
a
a
a
a
a
a
a
a
a
a
a
a
a
a
a
a
a
a
a
a
a
a
o
o
"}
(12,1,1) = {"
o
o
o
a
a
a
a
a
a
a
a
a
a
a
a
a
a
a
a
a
a
a
a
a
a
a
a
a
a
a
a
a
a
a
a
a
a
a
a
a
a
a
a
a
a
a
a
a
a
a
a
a
a
a
a
a
a
a
a
a
a
a
o
o
"}
(13,1,1) = {"
o
o
o
a
a
a
a
a
a
a
a
a
a
a
a
a
a
a
o
o
a
a
a
a
a
a
a
a
a
a
a
a
a
a
a
a
a
a
a
a
a
a
a
a
a
a
o
o
a
a
a
a
a
a
a
a
a
a
a
a
a
a
o
o
"}
(14,1,1) = {"
o
o
o
a
a
a
a
a
a
a
a
a
a
a
a
a
o
o
o
o
o
o
a
a
a
a
a
a
a
a
a
a
a
a
a
a
a
a
a
a
a
a
a
a
o
o
o
o
o
a
a
a
a
a
a
a
a
a
a
a
a
a
o
o
"}
(15,1,1) = {"
o
o
o
a
a
a
a
a
a
a
a
a
a
a
a
o
o
o
o
o
o
o
o
a
a
a
a
a
a
a
a
a
a
a
a
a
a
a
a
a
a
a
a
o
o
o
o
o
o
o
a
a
a
a
a
a
a
a
a
a
a
o
o
o
"}
(16,1,1) = {"
o
o
a
a
a
a
a
a
a
a
a
a
a
a
a
o
o
o
o
o
o
o
o
a
a
a
a
a
a
a
a
a
a
a
a
a
a
a
a
a
a
a
a
o
o
o
o
o
o
o
a
a
a
a
a
a
a
a
a
a
a
o
o
o
"}
(17,1,1) = {"
o
o
a
a
a
a
a
a
a
a
a
a
a
a
a
o
o
o
o
o
o
o
o
a
a
a
a
a
a
a
a
a
a
a
a
a
a
a
a
a
a
a
a
o
o
o
o
o
o
o
a
a
a
a
a
a
a
a
a
a
a
o
o
o
"}
(18,1,1) = {"
o
o
a
a
a
a
a
a
a
a
a
a
a
a
a
a
o
o
o
o
o
o
a
a
a
a
a
a
a
a
a
a
a
a
a
a
a
a
a
a
a
a
a
a
o
o
o
o
o
a
a
a
a
a
a
a
a
a
a
a
a
o
o
o
"}
(19,1,1) = {"
o
o
a
a
a
a
a
a
a
a
a
a
a
a
a
a
o
o
o
o
o
o
a
a
a
a
a
a
a
a
a
a
a
a
a
a
a
a
a
a
a
a
a
a
a
a
o
o
a
a
a
a
a
a
a
a
a
a
a
a
a
a
o
o
"}
(20,1,1) = {"
o
o
a
a
a
a
a
a
a
a
a
a
a
a
a
a
a
a
o
o
a
a
a
a
a
a
a
a
a
a
a
a
a
a
a
a
a
a
a
a
a
a
a
a
a
a
a
a
a
a
a
a
a
a
a
a
a
a
a
a
a
a
o
o
"}
(21,1,1) = {"
o
o
a
a
a
a
a
a
a
a
a
a
a
a
a
a
a
a
a
a
a
a
a
a
a
a
a
a
a
a
a
a
a
a
a
a
a
a
a
a
a
a
a
a
a
a
a
a
a
a
a
a
a
a
a
a
a
a
a
a
a
a
o
o
"}
(22,1,1) = {"
o
o
a
a
a
a
a
a
a
a
a
a
a
a
a
a
a
a
a
a
a
a
a
a
a
a
a
a
a
a
a
a
a
a
a
a
a
a
a
a
a
a
a
a
a
a
a
a
a
a
a
a
a
a
a
a
a
a
a
a
a
a
o
o
"}
(23,1,1) = {"
o
a
a
a
a
a
a
a
a
a
a
a
a
a
a
a
a
a
a
a
a
a
a
a
a
a
a
a
a
a
a
a
a
a
a
a
a
a
a
a
a
a
a
a
a
a
a
a
a
a
a
a
a
a
a
a
a
a
a
a
a
a
o
o
"}
(24,1,1) = {"
o
a
a
a
a
a
a
a
a
a
a
a
a
a
a
a
a
a
a
a
a
a
a
a
a
a
a
a
a
a
a
a
a
a
a
a
a
a
a
a
a
a
a
a
a
a
a
a
a
a
a
a
a
a
a
a
a
a
a
a
a
a
a
o
"}
(25,1,1) = {"
o
a
a
a
a
a
a
a
a
a
a
a
a
a
a
a
a
a
a
a
a
a
a
a
a
a
a
a
a
a
a
o
o
a
a
a
a
a
a
a
a
a
a
a
a
a
a
a
a
a
a
a
a
a
a
a
a
a
a
a
a
a
a
o
"}
(26,1,1) = {"
o
a
a
a
a
a
a
a
a
a
a
a
a
a
a
a
a
a
a
a
a
a
a
a
a
a
a
a
a
a
o
o
o
o
a
a
a
a
a
a
a
a
a
a
a
a
a
a
a
a
a
a
a
a
a
a
a
a
a
a
a
a
a
o
"}
(27,1,1) = {"
o
a
a
a
a
a
a
a
a
a
a
a
a
a
a
a
a
a
a
a
a
a
a
a
a
a
a
a
a
a
o
o
o
o
a
a
a
a
a
a
a
a
a
a
a
a
a
a
a
a
a
a
a
a
a
a
a
a
a
a
a
a
a
o
"}
(28,1,1) = {"
o
a
a
a
a
a
a
a
a
a
a
a
a
a
a
a
a
a
a
a
a
a
a
a
a
a
a
a
a
a
o
o
o
o
a
a
a
a
a
a
a
a
a
a
a
a
a
a
a
a
a
a
a
a
a
a
a
a
a
a
a
a
a
o
"}
(29,1,1) = {"
o
a
a
a
a
a
a
a
a
a
a
a
a
a
a
a
a
a
a
a
a
a
a
a
a
a
a
a
a
o
o
o
o
o
o
a
a
a
a
a
a
a
a
a
a
a
a
a
a
a
a
a
a
a
a
a
a
a
a
a
a
a
a
o
"}
(30,1,1) = {"
o
a
a
a
a
a
a
a
a
a
a
a
a
a
a
a
a
a
a
a
a
a
a
a
a
a
o
o
o
o
o
o
o
o
o
o
o
o
a
a
a
a
a
a
a
a
a
a
a
a
a
a
a
a
a
o
o
a
a
a
a
a
a
o
"}
(31,1,1) = {"
o
a
a
a
a
a
a
a
a
a
a
a
a
a
a
a
a
a
a
a
a
a
a
a
a
o
o
o
o
o
o
o
o
o
o
o
o
o
o
a
a
a
a
a
a
a
a
a
a
a
a
a
a
a
o
o
o
o
a
a
a
a
a
o
"}
(32,1,1) = {"
o
a
a
a
a
a
a
a
a
a
a
a
a
a
a
a
a
a
a
a
a
a
a
a
a
o
o
o
o
o
o
o
o
o
o
o
o
o
o
a
a
a
a
a
a
a
a
a
a
a
a
a
a
a
o
o
o
o
a
a
a
a
o
o
"}
(33,1,1) = {"
o
a
a
a
a
a
a
a
a
a
a
a
a
a
a
a
a
a
a
a
a
a
a
a
a
a
o
o
o
o
o
o
o
o
o
o
o
o
a
a
a
a
a
a
a
a
a
a
a
a
a
a
a
a
o
o
o
o
a
a
a
a
o
o
"}
(34,1,1) = {"
o
o
a
a
a
a
a
a
a
a
a
a
a
a
a
a
a
a
a
a
a
a
a
a
a
a
o
o
o
o
o
o
o
o
o
o
o
o
a
a
a
a
a
a
a
a
a
a
a
a
a
a
a
a
a
o
o
a
a
a
a
a
o
o
"}
(35,1,1) = {"
o
o
a
a
a
a
a
a
a
a
a
a
a
a
a
a
a
a
a
a
a
a
a
a
a
a
a
o
o
o
o
o
o
o
o
o
o
a
a
a
a
a
a
a
a
a
a
a
a
a
a
a
a
a
a
a
a
a
a
a
a
a
o
o
"}
(36,1,1) = {"
o
o
a
a
a
a
a
a
a
a
o
o
o
a
a
a
a
a
a
a
a
a
a
a
a
a
a
a
a
o
o
o
o
o
o
a
a
a
a
a
a
a
a
a
a
a
a
a
a
a
a
a
a
a
a
a
a
a
a
a
a
a
o
o
"}
(37,1,1) = {"
o
o
a
a
a
a
a
a
a
o
o
o
o
o
a
a
a
a
a
a
a
a
a
a
a
a
a
a
a
o
o
o
o
o
o
a
a
a
a
a
a
a
a
a
a
a
a
a
a
a
a
a
a
a
a
a
a
a
a
a
a
a
a
o
"}
(38,1,1) = {"
o
o
a
a
a
a
a
a
o
o
o
o
o
o
o
a
a
a
a
a
a
a
a
a
a
a
a
a
a
a
o
o
o
o
a
a
a
a
a
a
a
a
a
a
a
a
a
a
a
a
a
a
a
a
a
a
a
a
a
a
a
a
a
o
"}
(39,1,1) = {"
o
o
a
a
a
a
a
a
o
o
o
o
o
o
o
a
a
a
a
a
a
a
a
a
a
a
a
a
a
a
o
o
o
o
a
a
a
a
a
a
a
a
a
a
a
a
a
a
a
a
a
a
a
a
a
a
a
a
a
a
a
a
a
o
"}
(40,1,1) = {"
o
o
a
a
a
a
a
a
o
o
o
o
o
o
o
a
a
a
a
a
a
a
a
a
a
a
a
a
a
a
o
o
o
o
a
a
a
a
a
a
a
a
a
a
a
a
a
a
a
a
a
a
a
a
a
a
a
a
a
a
a
a
a
o
"}
(41,1,1) = {"
o
a
a
a
a
a
a
a
a
o
o
o
o
o
a
a
a
a
a
a
a
a
a
a
a
a
a
a
a
a
a
o
o
a
a
a
a
a
a
a
a
a
a
a
a
a
a
a
a
a
a
a
a
a
a
a
a
a
a
a
a
a
a
o
"}
(42,1,1) = {"
o
a
a
a
a
a
a
a
a
o
o
o
o
o
a
a
a
a
a
a
a
a
a
a
a
a
a
a
a
a
a
a
a
a
a
a
a
a
a
a
a
a
a
a
a
a
a
a
a
a
a
a
a
a
a
a
a
a
a
a
a
a
a
o
"}
(43,1,1) = {"
o
a
a
a
a
a
a
a
a
a
o
o
o
a
a
a
a
a
a
a
a
a
a
a
a
a
a
a
a
a
a
a
a
a
a
a
a
a
a
a
a
a
a
a
a
a
a
a
a
a
a
a
a
a
a
a
a
a
a
a
a
a
a
o
"}
(44,1,1) = {"
o
a
a
a
a
a
a
a
a
a
a
a
a
a
a
a
a
a
a
a
a
a
a
a
a
a
a
a
a
a
a
a
a
a
a
a
a
a
a
a
a
a
a
a
a
a
a
a
a
a
a
a
a
a
a
a
a
a
a
a
a
a
a
o
"}
(45,1,1) = {"
o
a
a
a
a
a
a
a
a
a
a
a
a
a
a
a
a
a
a
a
a
a
a
a
a
a
a
a
a
a
a
a
a
a
a
a
a
a
a
a
a
a
a
a
a
a
a
a
a
a
a
a
a
a
a
a
a
a
a
a
a
a
a
o
"}
(46,1,1) = {"
o
a
a
a
a
a
a
a
a
a
a
a
a
a
a
a
a
a
a
a
a
a
a
a
a
a
a
a
a
a
a
a
a
a
a
a
a
a
a
a
a
a
a
a
a
a
a
a
a
a
a
a
a
a
a
a
a
a
a
a
a
a
o
o
"}
(47,1,1) = {"
o
a
a
a
a
a
a
a
a
a
a
a
a
a
a
a
a
a
a
a
a
a
a
a
a
a
a
a
a
a
a
a
a
a
a
a
a
a
a
a
a
a
a
a
a
a
a
a
a
a
a
a
a
a
a
a
a
a
a
a
a
a
o
o
"}
(48,1,1) = {"
o
a
a
a
a
a
a
a
a
a
a
a
a
a
a
a
a
a
a
a
a
a
a
a
a
a
a
a
a
a
a
a
a
a
a
a
a
a
a
a
a
a
a
a
a
a
a
a
a
a
a
a
a
a
a
a
a
a
a
a
a
a
o
o
"}
(49,1,1) = {"
o
a
a
a
a
a
a
a
a
a
a
a
a
a
a
a
a
a
a
a
a
a
a
a
a
a
a
a
a
a
a
a
a
a
a
a
a
a
a
a
a
a
a
o
o
o
o
a
a
a
a
a
a
a
a
a
a
a
a
a
a
o
o
o
"}
(50,1,1) = {"
o
a
a
a
a
a
a
a
a
a
a
a
a
a
a
a
a
a
a
a
a
a
a
a
a
a
a
a
a
a
a
a
a
a
a
a
a
a
a
a
a
a
o
o
o
o
o
o
a
a
a
a
a
a
a
a
a
a
a
a
a
o
o
o
"}
(51,1,1) = {"
o
o
a
a
a
a
a
a
a
a
a
a
a
a
a
a
a
a
a
a
a
a
a
a
a
a
a
a
a
a
a
a
a
a
a
a
a
a
a
a
a
o
o
o
o
o
o
o
a
a
a
a
a
a
a
a
a
a
a
a
a
o
o
o
"}
(52,1,1) = {"
o
o
a
a
a
a
a
a
a
a
a
a
a
a
a
a
a
a
a
a
o
o
a
a
a
a
a
a
a
a
a
a
a
a
a
a
a
a
a
a
a
o
o
o
o
o
o
o
a
a
a
a
a
a
a
a
a
a
a
a
a
a
o
o
"}
(53,1,1) = {"
o
o
o
a
a
a
a
a
a
a
a
a
a
a
a
a
a
a
a
o
o
o
o
a
a
a
a
a
a
a
a
a
a
a
a
a
a
a
a
a
a
o
o
o
o
o
o
o
a
a
a
a
a
a
a
a
a
a
a
a
a
a
o
o
"}
(54,1,1) = {"
o
o
o
a
a
a
a
a
a
a
a
a
a
a
a
a
a
a
a
o
o
o
o
a
a
a
a
a
a
a
a
a
a
a
a
a
a
a
a
a
a
a
o
o
o
o
o
a
a
a
a
a
a
a
a
a
a
a
a
a
a
a
o
o
"}
(55,1,1) = {"
o
o
o
a
a
a
a
a
a
a
a
a
a
a
a
a
a
a
a
a
o
o
a
a
a
a
a
a
a
a
a
a
a
a
a
a
a
a
a
a
a
a
a
a
a
a
a
a
a
a
a
a
a
a
a
a
a
a
a
a
a
a
o
o
"}
(56,1,1) = {"
o
o
a
a
a
a
a
a
a
a
a
a
a
a
a
a
a
a
a
a
a
a
a
a
a
a
a
a
a
a
a
a
a
a
a
a
a
a
a
a
a
a
a
a
a
a
a
a
a
a
a
a
a
a
a
a
a
a
a
a
a
a
o
o
"}
(57,1,1) = {"
o
o
a
a
a
a
a
a
a
a
a
a
a
a
a
a
a
a
a
a
a
a
a
a
a
a
a
a
a
a
a
a
a
a
a
a
a
a
a
a
a
a
a
a
a
a
a
a
a
a
a
a
a
a
a
a
a
a
a
a
a
o
o
o
"}
(58,1,1) = {"
o
o
o
a
a
a
a
a
a
a
a
a
a
a
a
a
a
a
a
a
a
a
a
a
a
a
a
a
a
a
a
a
a
a
a
a
a
a
a
a
a
a
a
a
a
a
a
a
a
a
a
a
a
a
a
a
a
a
a
a
a
o
o
o
"}
(59,1,1) = {"
o
o
o
a
a
a
a
a
a
a
a
a
a
a
a
a
a
a
a
a
a
a
a
a
a
a
a
a
a
a
a
a
a
a
a
a
a
a
a
a
a
a
a
a
a
a
a
a
a
a
a
a
a
a
a
a
a
a
a
a
a
o
o
o
"}
(60,1,1) = {"
o
o
o
a
a
a
a
a
a
a
a
a
a
a
a
a
a
a
a
a
a
a
a
a
a
a
a
a
a
a
a
a
a
a
a
a
a
a
a
a
a
a
a
a
a
a
a
a
a
a
a
a
a
a
a
a
a
a
a
a
a
o
o
o
"}
(61,1,1) = {"
o
o
o
a
a
a
a
a
a
a
a
a
a
a
a
a
a
a
a
a
a
a
a
a
a
a
a
a
a
a
a
a
a
a
a
a
a
a
a
a
a
a
a
a
a
a
a
a
a
a
a
a
a
a
a
a
a
a
a
a
a
o
o
o
"}
(62,1,1) = {"
o
o
o
o
o
o
o
o
o
a
a
a
a
a
a
o
o
o
o
o
o
o
o
a
a
a
a
a
a
a
a
a
a
a
a
a
a
a
a
a
a
a
a
a
a
a
a
a
a
a
o
o
a
a
a
a
a
o
o
o
o
o
o
o
"}
(63,1,1) = {"
o
o
o
o
o
o
o
o
o
o
o
o
o
o
o
o
o
o
o
o
o
o
o
o
o
o
o
o
o
o
a
a
a
a
a
a
o
o
a
a
a
a
a
a
a
o
o
o
o
o
o
o
o
o
o
o
o
o
o
o
o
o
o
o
"}
(64,1,1) = {"
o
o
o
o
o
o
o
o
o
o
o
o
o
o
o
o
o
o
o
o
o
o
o
o
o
o
o
o
o
o
o
o
o
o
o
o
o
o
o
o
o
o
o
o
o
o
o
o
o
o
o
o
o
o
o
o
o
o
o
o
o
o
o
o
"}
