"af" = (/obj/machinery/atmospherics/unary/tank/air{dir = 8},/turf/simulated/floor/plating{icon_state = "asteroidplating"},/area/shack)
"cu" = (/obj/machinery/atmospherics/pipe/manifold/supply/hidden,/obj/effect/decal/cleanable/generic,/turf/simulated/floor/wood/floor_tile,/area/shack)
"gK" = (/obj/machinery/atmospherics/pipe/simple/supply/hidden{req_access_txt = 1},/obj/effect/decal/cleanable/dirt,/turf/simulated/floor{icon_state = "showroomfloor"},/area/shack)
"is" = (/obj/machinery/atmospherics/pipe/manifold/supply/hidden{dir = 1},/obj/structure/reagent_dispensers/fueltank,/turf/simulated/floor/plating{icon_state = "asteroidplating"},/area/shack)
"iu" = (/obj/effect/decal/warning_stripes{dir = 8; icon_state = "loading_area"; tag = "icon-loading_area (WEST)"},/turf/unsimulated/floor/airless{icon_state = "asteroidplating"},/area/mine/explored)
"kz" = (/obj/machinery/atmospherics/pipe/simple/supply/hidden{req_access_txt = 1},/turf/simulated/floor/plating{icon_state = "asteroidplating"},/area/shack)
"kI" = (/obj/structure/safe,/obj/abstract/map/spawner/safe/medical,/obj/abstract/map/spawner/safe/food,/turf/simulated/floor/wood/floor_tile,/area/shack)
"kW" = (/obj/structure/table/woodentable,/obj/item/weapon/reagent_containers/food/drinks/beer,/obj/item/weapon/reagent_containers/food/drinks/beer,/obj/item/weapon/reagent_containers/food/drinks/beer,/turf/simulated/floor/plating{icon_state = "asteroidfloor"},/area/shack)
"li" = (/obj/structure/grille,/obj/structure/window/reinforced,/obj/structure/window/reinforced{dir = 1},/obj/structure/window/reinforced{dir = 4},/turf/simulated/floor/plating{icon_state = "asteroidplating"},/area/shack)
"lF" = (/turf/simulated/wall/mineral/wood,/area/shack)
"lQ" = (/obj/structure/closet/cabinet,/obj/effect/decal/cleanable/cobweb2,/obj/item/weapon/reagent_containers/food/drinks/beer,/obj/item/weapon/reagent_containers/food/drinks/beer,/obj/item/weapon/reagent_containers/food/drinks/beer,/obj/item/stack/sheet/glass/glass/bigstack,/obj/item/stack/sheet/metal/bigstack,/obj/item/stack/rods,/obj/item/stack/sheet/wood/bigstack,/turf/simulated/floor/wood/floor_tile,/area/shack)
"mi" = (/obj/structure/cable/yellow{d2 = 4; icon_state = "0-4"},/obj/machinery/power/apc{cell_type = 0; icon_state = "apc1"; opened = 1; pixel_y = -24},/obj/item/weapon/cell/potato,/turf/simulated/floor/plating{icon_state = "asteroidplating"},/area/shack)
"mM" = (/obj/structure/sink{dir = 4; pixel_x = 11},/turf/simulated/floor{icon_state = "showroomfloor"},/area/shack)
"mQ" = (/obj/structure/table/woodentable,/obj/machinery/microwave{pixel_y = 6},/turf/simulated/floor/plating{icon_state = "asteroidplating"},/area/shack)
"no" = (/obj/machinery/atmospherics/pipe/simple/supply/hidden{dir = 4},/obj/effect/decal/cleanable/generic,/turf/simulated/floor/plating{icon_state = "asteroidplating"},/area/shack)
"pC" = (/obj/structure/bed/chair/wood/normal{dir = 8},/obj/effect/decal/cleanable/dirt,/obj/effect/landmark/hobostart,/turf/simulated/floor/plating{icon_state = "asteroidfloor"},/area/shack)
"rN" = (/obj/machinery/atmospherics/unary/vent_pump{dir = 1; on = 1},/obj/machinery/light/small{dir = 8},/turf/simulated/floor/plating{icon_state = "asteroidfloor"},/area/shack)
"sE" = (/obj/machinery/atmospherics/pipe/simple/supply/hidden{req_access_txt = 1},/obj/machinery/door/mineral/wood{name = "Wooden Door"},/turf/simulated/floor/wood/floor_tile,/area/shack)
"uP" = (/turf/simulated/floor/plating{icon_state = "asteroidplating"},/area/shack)
"uX" = (/obj/structure/bed/chair/wood/normal{dir = 4},/obj/effect/decal/cleanable/dirt,/obj/effect/landmark/hobostart,/turf/simulated/floor/plating{icon_state = "asteroidfloor"},/area/shack)
"vp" = (/obj/structure/bed,/obj/machinery/light/small{dir = 4},/obj/effect/landmark/hobostart,/turf/simulated/floor/wood/floor_tile,/area/shack)
"wk" = (/obj/machinery/atmospherics/pipe/simple/supply/hidden{req_access_txt = 1},/obj/machinery/atmospherics/pipe/simple/supply/hidden{req_access_txt = 1},/obj/machinery/door/mineral/wood{name = "Wooden Door"},/turf/simulated/floor/plating{icon_state = "asteroidplating"},/area/shack)
"wm" = (/obj/machinery/atmospherics/pipe/simple/supply/hidden{dir = 4},/obj/machinery/door/mineral/wood{name = "Wooden Door"},/turf/simulated/floor/wood/floor_tile,/area/shack)
"wq" = (/obj/machinery/door/window{dir = 2},/obj/machinery/door/window{dir = 1},/turf/simulated/floor/plating{icon_state = "asteroidplating"},/area/shack)
"wK" = (/obj/structure/table/woodentable,/obj/item/weapon/storage/box/donkpockets,/obj/item/weapon/storage/wallet/random,/obj/item/weapon/storage/wallet/random,/obj/item/weapon/storage/wallet/random,/turf/simulated/floor/plating{icon_state = "asteroidplating"},/area/shack)
"yp" = (/obj/machinery/computer/smelting{smelter_tag = "shack_smelter"},/turf/unsimulated/floor/airless{icon_state = "asteroidplating"},/area/mine/explored)
"zr" = (/obj/machinery/atmospherics/pipe/simple/supply/hidden{dir = 4},/obj/machinery/portable_atmospherics/canister/nitrogen,/turf/simulated/floor/plating{icon_state = "asteroidplating"},/area/shack)
"zH" = (/turf/simulated/wall/r_rock/porous,/area/shack)
"Bt" = (/obj/machinery/power/port_gen/pacman{anchored = 1},/obj/structure/cable/yellow{d2 = 8; icon_state = "0-8"},/obj/item/stack/sheet/mineral/plasma{amount = 30},/turf/simulated/floor/plating{icon_state = "asteroidplating"},/area/shack)
"BF" = (/obj/structure/ore_box,/turf/unsimulated/floor/airless{icon_state = "asteroidplating"},/area/mine/explored)
"Cp" = (/obj/structure/window/reinforced,/obj/structure/window/reinforced{dir = 8},/obj/structure/grille/broken,/turf/simulated/floor/plating{icon_state = "asteroidplating"},/area/shack)
"Ds" = (/turf/unsimulated/floor/airless{icon_state = "asteroidplating"},/area/mine/explored)
"EH" = (/obj/machinery/atmospherics/pipe/simple/supply/hidden{req_access_txt = 1},/turf/simulated/floor/wood{broken = 1; icon_state = "wood-broken"},/area/shack)
"Fy" = (/turf/simulated/floor/plating{icon_state = "asteroidfloor"},/area/shack)
"Fz" = (/obj/structure/mirror{pixel_y = 32},/obj/machinery/atmospherics/unary/vent_pump{on = 1},/turf/simulated/floor{icon_state = "showroomfloor"},/area/shack)
"Gw" = (/obj/structure/toilet{dir = 8},/obj/machinery/light/small{dir = 1},/obj/effect/decal/cleanable/dirt,/turf/simulated/floor{icon_state = "showroomfloor"},/area/shack)
"Gx" = (/obj/machinery/atmospherics/pipe/simple/supply/hidden{dir = 4},/obj/effect/decal/cleanable/generic,/obj/item/blueprints/construction_permit,/turf/simulated/floor/plating{icon_state = "asteroidplating"},/area/shack)
"Hg" = (/obj/structure/forge,/turf/simulated/floor/plating{icon_state = "asteroidfloor"},/area/shack)
"Kr" = (/turf/unsimulated/mineral/random,/area/mine/explored)
"Lo" = (/obj/effect/decal/cleanable/dirt,/turf/simulated/floor/plating{icon_state = "asteroidplating"},/area/shack)
"LR" = (/turf/unsimulated/floor/asteroid,/area/mine/explored)
"Od" = (/obj/structure/grille,/obj/structure/window/reinforced,/obj/structure/window/reinforced{dir = 1},/obj/structure/window/reinforced{dir = 4},/obj/structure/window/reinforced{dir = 8},/turf/simulated/floor/plating{icon_state = "asteroidplating"},/area/shack)
"QD" = (/obj/structure/table/woodentable,/obj/item/weapon/storage/toolbox/mechanical,/obj/item/weapon/storage/toolbox/mechanical,/obj/item/weapon/storage/toolbox/mechanical,/turf/simulated/floor/plating{icon_state = "asteroidplating"},/area/shack)
"Rz" = (/obj/item/anvil,/turf/simulated/floor/plating{icon_state = "asteroidfloor"},/area/shack)
"Ta" = (/obj/machinery/mineral/processing_unit{id_tag = "shack_smelter"; in_dir = 4; out_dir = 8},/turf/unsimulated/floor/airless{icon_state = "asteroidplating"},/area/mine/explored)
"Ts" = (/obj/machinery/atmospherics/unary/vent_pump{dir = 1; on = 1},/turf/simulated/floor/plating{icon_state = "asteroidplating"},/area/shack)
"Tw" = (/obj/machinery/atmospherics/pipe/manifold/supply/hidden{dir = 8},/turf/simulated/floor/plating{icon_state = "asteroidfloor"},/area/shack)
"WD" = (/obj/machinery/atmospherics/pipe/simple/supply/hidden{dir = 4},/obj/effect/decal/cleanable/dirt,/turf/simulated/floor/plating{icon_state = "asteroidfloor"},/area/shack)
"XL" = (/obj/machinery/light/small{dir = 4},/turf/simulated/floor/plating{icon_state = "asteroidplating"},/area/shack)
"Yn" = (/obj/structure/rack,/obj/item/weapon/pickaxe/shovel,/obj/item/device/flashlight/lantern,/obj/item/weapon/storage/bag/ore,/obj/item/weapon/pickaxe/hand,/obj/item/weapon/storage/belt/mining,/obj/item/weapon/pickaxe/hand,/obj/item/weapon/pickaxe/hand,/obj/item/weapon/storage/bag/ore,/obj/item/weapon/storage/bag/ore,/obj/item/weapon/storage/belt/mining,/obj/item/weapon/storage/belt/mining,/obj/item/weapon/pickaxe/shovel,/obj/item/weapon/pickaxe/shovel,/obj/item/device/flashlight/lantern,/obj/item/device/flashlight/lantern,/turf/simulated/floor/plating{icon_state = "asteroidplating"},/area/shack)
"Yt" = (/obj/machinery/portable_atmospherics/canister/oxygen,/obj/machinery/atmospherics/pipe/simple/supply/hidden{dir = 6},/obj/effect/decal/cleanable/cobweb,/turf/simulated/floor/plating{icon_state = "asteroidplating"},/area/shack)
"Zu" = (/obj/machinery/atmospherics/pipe/simple/supply/hidden{dir = 4},/turf/simulated/floor/plating{icon_state = "asteroidfloor"},/area/shack)
"ZK" = (/obj/machinery/atmospherics/unary/vent_pump{dir = 8; on = 1},/turf/simulated/floor/wood{broken = 1; icon_state = "wood-broken4"},/area/shack)

(1,1,1) = {"
KrKrKrKrKrKrKrKrKrKrKrKr
KrzHzHzHzHzHzHzHzHzHzHKr
KrzHYtzrisGxaflFFzGwzHKr
KrzHkzLoTsmiBtlFgKmMzHKr
KrzHwklFlFlFlFlFsElFlFKr
KrzHkzYnQDwKmQlFEHlQlFKr
KrlFTwWDZuZunowmcuZKlFKr
KrlFrNuXkWpCXLlFkIvplFKr
KrlFFyFyHgRzuPlFlFOdlFKr
KrlFlFCplilFwqlFypBFBFKr
LRDsDsDsTaiuDsDsDsDsDsLR
LRLRLRLRLRLRLRLRLRLRLRLR
"}
