"a" = (/obj/machinery/mineral/stacking_machine{id_tag = "mining_stacker"; in_dir = 4; out_dir = 8},/turf/simulated/floor/plating{icon_state = "asteroidplating"},/area/mine/explored)
"b" = (/turf/simulated/wall/r_rock/porous,/area/vault)
"c" = (/obj/machinery/portable_atmospherics/canister/oxygen,/obj/machinery/atmospherics/pipe/simple/supply/hidden{dir = 6},/obj/effect/decal/cleanable/cobweb,/turf/simulated/floor/plating{icon_state = "asteroidplating"},/area/vault)
"d" = (/obj/structure/reagent_dispensers/fueltank,/obj/machinery/atmospherics/pipe/simple/supply/hidden{dir = 4},/turf/simulated/floor/plating{icon_state = "asteroidplating"},/area/vault)
"e" = (/turf/simulated/floor/plating{icon_state = "asteroidplating"},/area/mine/explored)
"f" = (/turf/unsimulated/floor/asteroid,/area/mine/explored)
"h" = (/obj/structure/dispenser/oxygen,/obj/machinery/atmospherics/pipe/manifold/supply/hidden{dir = 1},/turf/simulated/floor/plating{icon_state = "asteroidplating"},/area/vault)
"i" = (/turf/unsimulated/mineral/random,/area/mine/explored)
"j" = (/obj/machinery/atmospherics/pipe/simple/supply/hidden{dir = 4},/obj/effect/decal/cleanable/generic,/turf/simulated/floor/plating{icon_state = "asteroidplating"},/area/vault)
"k" = (/obj/structure/table/woodentable,/turf/simulated/floor/wood/floor_tile,/area/vault)
"l" = (/obj/structure/table/woodentable,/obj/item/weapon/storage/toolbox/mechanical,/obj/item/clothing/glasses/scanner/meson,/turf/simulated/floor/plating{icon_state = "asteroidplating"},/area/vault)
"m" = (/obj/machinery/atmospherics/pipe/simple/supply/hidden{dir = 4},/obj/effect/decal/cleanable/dirt,/turf/simulated/floor/plating{icon_state = "asteroidfloor"},/area/vault)
"n" = (/obj/machinery/atmospherics/pipe/manifold/supply/hidden{dir = 8},/turf/simulated/floor/plating{icon_state = "asteroidfloor"},/area/vault)
"o" = (/obj/machinery/atmospherics/pipe/simple/supply/hidden{dir = 4},/turf/simulated/floor/plating{icon_state = "asteroidfloor"},/area/vault)
"p" = (/turf/simulated/wall/mineral/wood,/area/vault)
"q" = (/obj/structure/table/woodentable,/obj/item/weapon/storage/box/donkpockets,/turf/simulated/floor/plating{icon_state = "asteroidplating"},/area/vault)
"r" = (/obj/structure/sink{dir = 4; pixel_x = 11},/turf/simulated/floor{icon_state = "showroomfloor"},/area/vault)
"s" = (/obj/structure/ore_box,/turf/simulated/floor/plating{icon_state = "asteroidplating"},/area/mine/explored)
"t" = (/obj/machinery/atmospherics/pipe/simple/supply/hidden{req_access_txt = 1},/obj/machinery/door/mineral/wood{name = "Wooden Door"},/turf/simulated/floor/wood/floor_tile,/area/vault)
"u" = (/obj/machinery/atmospherics/pipe/simple/supply/hidden{dir = 4},/obj/effect/decal/cleanable/generic,/obj/item/weapon/cell/potato,/turf/simulated/floor/plating{icon_state = "asteroidplating"},/area/vault)
"v" = (/obj/structure/table/woodentable,/obj/item/weapon/reagent_containers/food/drinks/beer,/turf/simulated/floor/plating{icon_state = "asteroidfloor"},/area/vault)
"w" = (/obj/structure/toilet{dir = 8},/obj/machinery/light/small{dir = 1},/obj/effect/decal/cleanable/dirt,/turf/simulated/floor{icon_state = "showroomfloor"},/area/vault)
"x" = (/obj/structure/rack,/obj/item/weapon/pickaxe,/obj/item/weapon/pickaxe/shovel,/obj/item/device/flashlight/lantern,/turf/simulated/floor/plating{icon_state = "asteroidplating"},/area/vault)
"y" = (/obj/structure/mirror{pixel_y = 32},/obj/machinery/atmospherics/unary/vent_pump{on = 1},/turf/simulated/floor{icon_state = "showroomfloor"},/area/vault)
"z" = (/obj/structure/bed/chair/wood/normal{dir = 4},/obj/effect/decal/cleanable/dirt,/obj/effect/landmark/start{name = "Space Hobo"},/turf/simulated/floor/plating{icon_state = "asteroidfloor"},/area/vault)
"A" = (/obj/structure/cable/yellow{d2 = 4; icon_state = "0-4"},/obj/machinery/power/apc{cell_type = 0; icon_state = "apc1"; opened = 1; pixel_y = -24},/turf/simulated/floor/plating{icon_state = "asteroidplating"},/area/vault)
"B" = (/obj/machinery/atmospherics/pipe/manifold/supply/hidden,/obj/effect/decal/cleanable/generic,/turf/simulated/floor/wood/floor_tile,/area/vault)
"C" = (/obj/structure/bed/chair/wood/normal{dir = 8},/obj/effect/decal/cleanable/dirt,/obj/effect/landmark/start{name = "Space Hobo"},/turf/simulated/floor/plating{icon_state = "asteroidfloor"},/area/vault)
"D" = (/obj/machinery/atmospherics/unary/vent_pump{dir = 1; on = 1},/obj/machinery/light/small{dir = 8},/turf/simulated/floor/plating{icon_state = "asteroidfloor"},/area/vault)
"E" = (/obj/structure/window/reinforced,/obj/structure/window/reinforced{dir = 8},/obj/structure/grille/broken,/turf/simulated/floor/plating{icon_state = "asteroidplating"},/area/vault)
"F" = (/obj/structure/grille,/obj/structure/window/reinforced,/obj/structure/window/reinforced{dir = 1},/obj/structure/window/reinforced{dir = 4},/obj/structure/window/reinforced{dir = 8},/turf/simulated/floor/plating{icon_state = "asteroidplating"},/area/vault)
"G" = (/obj/machinery/light/small{dir = 4},/turf/simulated/floor/plating{icon_state = "asteroidplating"},/area/vault)
"H" = (/obj/machinery/atmospherics/unary/vent_pump{dir = 1; on = 1},/turf/simulated/floor/plating{icon_state = "asteroidplating"},/area/vault)
"I" = (/obj/machinery/atmospherics/pipe/simple/supply/hidden{req_access_txt = 1},/turf/simulated/floor/wood{broken = 1; icon_state = "wood-broken"},/area/vault)
"J" = (/turf/simulated/floor/plating{icon_state = "asteroidfloor"},/area/vault)
"K" = (/obj/machinery/door/window{dir = 2},/obj/machinery/door/window{dir = 1},/turf/simulated/floor/plating{icon_state = "asteroidplating"},/area/vault)
"L" = (/obj/machinery/power/port_gen/pacman{anchored = 1},/obj/structure/cable/yellow{d2 = 8; icon_state = "0-8"},/turf/simulated/floor/plating{icon_state = "asteroidplating"},/area/vault)
"M" = (/obj/machinery/atmospherics/unary/vent_pump{dir = 8; on = 1},/turf/simulated/floor/wood{broken = 1; icon_state = "wood-broken4"},/area/vault)
"N" = (/obj/structure/table/woodentable,/obj/machinery/microwave{pixel_y = 6},/turf/simulated/floor/plating{icon_state = "asteroidplating"},/area/vault)
"O" = (/obj/machinery/atmospherics/pipe/simple/supply/hidden{req_access_txt = 1},/obj/effect/decal/cleanable/dirt,/turf/simulated/floor{icon_state = "showroomfloor"},/area/vault)
"P" = (/obj/effect/decal/cleanable/dirt,/turf/simulated/floor/plating{icon_state = "asteroidplating"},/area/vault)
"Q" = (/obj/machinery/atmospherics/unary/tank/air{dir = 8},/turf/simulated/floor/plating{icon_state = "asteroidplating"},/area/vault)
"R" = (/obj/structure/grille,/obj/structure/window/reinforced,/obj/structure/window/reinforced{dir = 1},/obj/structure/window/reinforced{dir = 4},/turf/simulated/floor/plating{icon_state = "asteroidplating"},/area/vault)
"S" = (/obj/machinery/atmospherics/pipe/simple/supply/hidden{req_access_txt = 1},/turf/simulated/floor/plating{icon_state = "asteroidplating"},/area/vault)
"T" = (/obj/machinery/mineral/processing_unit{id_tag = "mining_smelter"; in_dir = 4; on = 1; out_dir = 8},/turf/simulated/floor/plating{icon_state = "asteroidplating"},/area/mine/explored)
"U" = (/turf/simulated/floor/plating{icon_state = "asteroidplating"},/area/vault)
"V" = (/obj/machinery/atmospherics/pipe/simple/supply/hidden{req_access_txt = 1},/obj/machinery/atmospherics/pipe/simple/supply/hidden{req_access_txt = 1},/obj/machinery/door/mineral/wood{name = "Wooden Door"},/turf/simulated/floor/plating{icon_state = "asteroidplating"},/area/vault)
"W" = (/obj/structure/closet/cabinet,/obj/effect/decal/cleanable/cobweb2,/obj/item/weapon/reagent_containers/food/drinks/beer,/obj/item/weapon/reagent_containers/food/drinks/beer,/obj/item/weapon/reagent_containers/food/drinks/beer,/turf/simulated/floor/wood/floor_tile,/area/vault)
"X" = (/obj/structure/bed,/obj/machinery/light/small{dir = 4},/obj/effect/landmark/start{name = "Space Hobo"},/turf/simulated/floor/wood/floor_tile,/area/vault)
"Y" = (/obj/effect/decal/warning_stripes{dir = 8; icon_state = "loading_area"; tag = "icon-loading_area (WEST)"},/turf/simulated/floor/plating{icon_state = "asteroidplating"},/area/mine/explored)
"Z" = (/obj/machinery/atmospherics/pipe/simple/supply/hidden{dir = 4},/obj/machinery/door/mineral/wood{name = "Wooden Door"},/turf/simulated/floor/wood/floor_tile,/area/vault)

(1,1,1) = {"
iiiiiiiiiiii
ibbbbbbbbbbi
ibcdhuQpywbi
ibSPHALpOrbi
ibVppppptppi
ibSxlqNpIWpi
ipnmoojZBMpi
ipDzvCGpkXpi
ipJJJJUppFpi
ippERpKpssei
ieaYTYeeeeef
ffffffffffff
"}
