"a" = (/turf/unsimulated/wall,/area)
"c" = (/turf/space,/area)
"e" = (/obj/structure/window/reinforced,/turf/unsimulated/wall{icon_state = "iron12"},/area)
"f" = (/obj/structure/window/reinforced{dir = 4},/obj/structure/window/reinforced{dir = 8},/turf/unsimulated/wall{icon_state = "iron3"},/area)
"h" = (/obj/machinery/door/airlock/command,/turf/simulated/floor/holofloor{icon_state = "engine"; name = "Holodeck Projector Floor"},/area/holodeck/source_olympics_demo_a)
"l" = (/turf/simulated/floor/carpet,/area/holodeck/source_olympics_demo_a)
"m" = (/obj/structure/window/reinforced{dir = 1},/obj/structure/window/reinforced,/turf/unsimulated/wall{icon_state = "iron12"},/area)
"A" = (/turf/simulated/floor/mineral/clown,/area/holodeck/source_olympics_demo_a)
"E" = (/obj/structure/table/holotable/wood,/turf/simulated/floor/carpet,/area/holodeck/source_olympics_demo_a)
"F" = (/obj/machinery/door/window,/turf/simulated/floor/carpet,/area/holodeck/source_olympics_demo_a)
"G" = (/turf/simulated/wall,/area/holodeck/source_olympics_demo_a)
"H" = (/obj/effect/decal/warning_stripes/oldstyle,/turf/simulated/floor/holofloor{icon_state = "engine"; name = "Holodeck Projector Floor"},/area/holodeck/source_olympics_demo_a)
"J" = (/turf/simulated/floor/holofloor{icon_state = "engine"; name = "Holodeck Projector Floor"},/area/holodeck/source_olympics_demo_a)
"K" = (/obj/structure/bed/chair/comfy/brown{dir = 8},/turf/simulated/floor/carpet,/area/holodeck/source_olympics_demo_a)
"L" = (/obj/machinery/computer/card,/turf/simulated/floor/carpet,/area/holodeck/source_olympics_demo_a)
"M" = (/obj/item/weapon/card/id/captains_spare,/obj/structure/table/holotable/wood,/turf/simulated/floor/carpet,/area/holodeck/source_olympics_demo_a)
"Q" = (/turf/simulated/floor/mineral/uranium,/area/holodeck/source_olympics_demo_b)
"V" = (/obj/structure/bed/chair/comfy/brown{dir = 4},/turf/simulated/floor/carpet,/area/holodeck/source_olympics_demo_a)

(1,1,1) = {"
aeeeeeeeeeeeeeeeeeeeeeeeaeeeeeeeeeeeeeeeeeeeeeeeaeeeeeeeeeeeeeeeeeeeeeeeaeeeeeeeeeeeeeeeeeeeeeeeaeeeeeeeeeeeeeeeeeeeeeeeaeeeeeeeeeeeeeeeeeeeeeeeaeeeeeeeeeeeeeeeeeeeeeeeaeeeeeeeeeeeeeeeeeeeeeeeaeeeeeeeeeeeeeeeeeeeeeeeaeeeeeeeeeeeeeeeeeeeeeeeaeeeeeeeeeeeeeeeeeeeeeeeaeeeeeeeeeeeeeeeeeeeeeeeaeeeeeeeeeeeeeeeeeeeeeeeaeeeeeeeeeeeeeeeeeeeeeeeaeeeeeeeeeeeeeeeeeeeeeeea
fAAAAAAAAAGGGGGGGGGGGGGGfcccccccccccccccccccccccfcccccccccccccccccccccccfcccccccccccccccccccccccfcccccccccccccccccccccccfcccccccccccccccccccccccfcccccccccccccccccccccccfcccccccccccccccccccccccfcccccccccccccccccccccccfcccccccccccccccccccccccfcccccccccccccccccccccccfcccccccccccccccccccccccfcccccccccccccccccccccccfcccccccccccccccccccccccfcccccccccccccccccccccccf
fAAAAAAAAAGJJJJJJJJJJhJhfcccccccccccccccccccccccfcccccccccccccccccccccccfcccccccccccccccccccccccfcccccccccccccccccccccccfcccccccccccccccccccccccfcccccccccccccccccccccccfcccccccccccccccccccccccfcccccccccccccccccccccccfcccccccccccccccccccccccfcccccccccccccccccccccccfcccccccccccccccccccccccfcccccccccccccccccccccccfcccccccccccccccccccccccfcccccccccccccccccccccccf
fAAAAAAAAAGJJJJJJJJJJGGGfcccccccccccccccccccccccfcccccccccccccccccccccccfcccccccccccccccccccccccfcccccccccccccccccccccccfcccccccccccccccccccccccfcccccccccccccccccccccccfcccccccccccccccccccccccfcccccccccccccccccccccccfcccccccccccccccccccccccfcccccccccccccccccccccccfcccccccccccccccccccccccfcccccccccccccccccccccccfcccccccccccccccccccccccfcccccccccccccccccccccccf
fAAAAAAAAAGJJJJJJJJJJhJhfcccccccccccccccccccccccfcccccccccccccccccccccccfcccccccccccccccccccccccfcccccccccccccccccccccccfcccccccccccccccccccccccfcccccccccccccccccccccccfcccccccccccccccccccccccfcccccccccccccccccccccccfcccccccccccccccccccccccfcccccccccccccccccccccccfcccccccccccccccccccccccfcccccccccccccccccccccccfcccccccccccccccccccccccfcccccccccccccccccccccccf
fAAAAAAAAAGGGGGGhGGGGGGGfcccccccccccccccccccccccfcccccccccccccccccccccccfcccccccccccccccccccccccfcccccccccccccccccccccccfcccccccccccccccccccccccfcccccccccccccccccccccccfcccccccccccccccccccccccfcccccccccccccccccccccccfcccccccccccccccccccccccfcccccccccccccccccccccccfcccccccccccccccccccccccfcccccccccccccccccccccccfcccccccccccccccccccccccfcccccccccccccccccccccccf
fAAAAAAAAAGJJGllllllllllfcccccccccccccccccccccccfcccccccccccccccccccccccfcccccccccccccccccccccccfcccccccccccccccccccccccfcccccccccccccccccccccccfcccccccccccccccccccccccfcccccccccccccccccccccccfcccccccccccccccccccccccfcccccccccccccccccccccccfcccccccccccccccccccccccfcccccccccccccccccccccccfcccccccccccccccccccccccfcccccccccccccccccccccccfcccccccccccccccccccccccf
fAAAAAAAAAGHJhlllllVEKllfcccccccccccccccccccccccfcccccccccccccccccccccccfcccccccccccccccccccccccfcccccccccccccccccccccccfcccccccccccccccccccccccfcccccccccccccccccccccccfcccccccccccccccccccccccfcccccccccccccccccccccccfcccccccccccccccccccccccfcccccccccccccccccccccccfcccccccccccccccccccccccfcccccccccccccccccccccccfcccccccccccccccccccccccfcccccccccccccccccccccccf
fAAAAAAAAAGJJGlllllVEKllfcccccccccccccccccccccccfcccccccccccccccccccccccfcccccccccccccccccccccccfcccccccccccccccccccccccfcccccccccccccccccccccccfcccccccccccccccccccccccfcccccccccccccccccccccccfcccccccccccccccccccccccfcccccccccccccccccccccccfcccccccccccccccccccccccfcccccccccccccccccccccccfcccccccccccccccccccccccfcccccccccccccccccccccccfcccccccccccccccccccccccf
fAAAAAAAAAGGGGEEEEllllllfcccccccccccccccccccccccfcccccccccccccccccccccccfcccccccccccccccccccccccfcccccccccccccccccccccccfcccccccccccccccccccccccfcccccccccccccccccccccccfcccccccccccccccccccccccfcccccccccccccccccccccccfcccccccccccccccccccccccfcccccccccccccccccccccccfcccccccccccccccccccccccfcccccccccccccccccccccccfcccccccccccccccccccccccfcccccccccccccccccccccccf
fAAAAAAAAAAAAGlllLlllllEfcccccccccccccccccccccccfcccccccccccccccccccccccfcccccccccccccccccccccccfcccccccccccccccccccccccfcccccccccccccccccccccccfcccccccccccccccccccccccfcccccccccccccccccccccccfcccccccccccccccccccccccfcccccccccccccccccccccccfcccccccccccccccccccccccfcccccccccccccccccccccccfcccccccccccccccccccccccfcccccccccccccccccccccccfcccccccccccccccccccccccf
fAAAAAAAAAAAAGMllFlllllEfcccccccccccccccccccccccfcccccccccccccccccccccccfcccccccccccccccccccccccfcccccccccccccccccccccccfcccccccccccccccccccccccfcccccccccccccccccccccccfcccccccccccccccccccccccfcccccccccccccccccccccccfcccccccccccccccccccccccfcccccccccccccccccccccccfcccccccccccccccccccccccfcccccccccccccccccccccccfcccccccccccccccccccccccfcccccccccccccccccccccccf
fAAAAAAAAAAAAGGGGGGGGGGGfcccccccccccccccccccccccfcccccccccccccccccccccccfcccccccccccccccccccccccfcccccccccccccccccccccccfcccccccccccccccccccccccfcccccccccccccccccccccccfcccccccccccccccccccccccfcccccccccccccccccccccccfcccccccccccccccccccccccfcccccccccccccccccccccccfcccccccccccccccccccccccfcccccccccccccccccccccccfcccccccccccccccccccccccfcccccccccccccccccccccccf
fAAAAAAAAAAAAAAAAAAAAAAAfcccccccccccccccccccccccfcccccccccccccccccccccccfcccccccccccccccccccccccfcccccccccccccccccccccccfcccccccccccccccccccccccfcccccccccccccccccccccccfcccccccccccccccccccccccfcccccccccccccccccccccccfcccccccccccccccccccccccfcccccccccccccccccccccccfcccccccccccccccccccccccfcccccccccccccccccccccccfcccccccccccccccccccccccfcccccccccccccccccccccccf
fAAAAAAAAAAAAAAAAAAAAAAAfcccccccccccccccccccccccfcccccccccccccccccccccccfcccccccccccccccccccccccfcccccccccccccccccccccccfcccccccccccccccccccccccfcccccccccccccccccccccccfcccccccccccccccccccccccfcccccccccccccccccccccccfcccccccccccccccccccccccfcccccccccccccccccccccccfcccccccccccccccccccccccfcccccccccccccccccccccccfcccccccccccccccccccccccfcccccccccccccccccccccccf
fAAAAAAAAAAAAAAAAAAAAAAAfcccccccccccccccccccccccfcccccccccccccccccccccccfcccccccccccccccccccccccfcccccccccccccccccccccccfcccccccccccccccccccccccfcccccccccccccccccccccccfcccccccccccccccccccccccfcccccccccccccccccccccccfcccccccccccccccccccccccfcccccccccccccccccccccccfcccccccccccccccccccccccfcccccccccccccccccccccccfcccccccccccccccccccccccfcccccccccccccccccccccccf
fAAAAAAAAAAAAAAAAAAAAAAAfcccccccccccccccccccccccfcccccccccccccccccccccccfcccccccccccccccccccccccfcccccccccccccccccccccccfcccccccccccccccccccccccfcccccccccccccccccccccccfcccccccccccccccccccccccfcccccccccccccccccccccccfcccccccccccccccccccccccfcccccccccccccccccccccccfcccccccccccccccccccccccfcccccccccccccccccccccccfcccccccccccccccccccccccfcccccccccccccccccccccccf
fAAAAAAAAAAAAAAAAAAAAAAAfcccccccccccccccccccccccfcccccccccccccccccccccccfcccccccccccccccccccccccfcccccccccccccccccccccccfcccccccccccccccccccccccfcccccccccccccccccccccccfcccccccccccccccccccccccfcccccccccccccccccccccccfcccccccccccccccccccccccfcccccccccccccccccccccccfcccccccccccccccccccccccfcccccccccccccccccccccccfcccccccccccccccccccccccfcccccccccccccccccccccccf
fAAAAAAAAAAAAAAAAAAAAAAAfcccccccccccccccccccccccfcccccccccccccccccccccccfcccccccccccccccccccccccfcccccccccccccccccccccccfcccccccccccccccccccccccfcccccccccccccccccccccccfcccccccccccccccccccccccfcccccccccccccccccccccccfcccccccccccccccccccccccfcccccccccccccccccccccccfcccccccccccccccccccccccfcccccccccccccccccccccccfcccccccccccccccccccccccfcccccccccccccccccccccccf
fAAAAAAAAAAAAAAAAAAAAAAAfcccccccccccccccccccccccfcccccccccccccccccccccccfcccccccccccccccccccccccfcccccccccccccccccccccccfcccccccccccccccccccccccfcccccccccccccccccccccccfcccccccccccccccccccccccfcccccccccccccccccccccccfcccccccccccccccccccccccfcccccccccccccccccccccccfcccccccccccccccccccccccfcccccccccccccccccccccccfcccccccccccccccccccccccfcccccccccccccccccccccccf
fAAAAAAAAAAAAAAAAAAAAAAAfcccccccccccccccccccccccfcccccccccccccccccccccccfcccccccccccccccccccccccfcccccccccccccccccccccccfcccccccccccccccccccccccfcccccccccccccccccccccccfcccccccccccccccccccccccfcccccccccccccccccccccccfcccccccccccccccccccccccfcccccccccccccccccccccccfcccccccccccccccccccccccfcccccccccccccccccccccccfcccccccccccccccccccccccfcccccccccccccccccccccccf
fAAAAAAAAAAAAAAAAAAAAAAAfcccccccccccccccccccccccfcccccccccccccccccccccccfcccccccccccccccccccccccfcccccccccccccccccccccccfcccccccccccccccccccccccfcccccccccccccccccccccccfcccccccccccccccccccccccfcccccccccccccccccccccccfcccccccccccccccccccccccfcccccccccccccccccccccccfcccccccccccccccccccccccfcccccccccccccccccccccccfcccccccccccccccccccccccfcccccccccccccccccccccccf
ammmmmmmmmmmmmmmmmmmmmmmammmmmmmmmmmmmmmmmmmmmmmammmmmmmmmmmmmmmmmmmmmmmammmmmmmmmmmmmmmmmmmmmmmammmmmmmmmmmmmmmmmmmmmmmammmmmmmmmmmmmmmmmmmmmmmammmmmmmmmmmmmmmmmmmmmmmammmmmmmmmmmmmmmmmmmmmmmammmmmmmmmmmmmmmmmmmmmmmammmmmmmmmmmmmmmmmmmmmmmammmmmmmmmmmmmmmmmmmmmmmammmmmmmmmmmmmmmmmmmmmmmammmmmmmmmmmmmmmmmmmmmmmammmmmmmmmmmmmmmmmmmmmmmammmmmmmmmmmmmmmmmmmmmmma
fQQQQQQQQQQQQQQQQQQQQQQQfcccccccccccccccccccccccfcccccccccccccccccccccccfcccccccccccccccccccccccfcccccccccccccccccccccccfcccccccccccccccccccccccfcccccccccccccccccccccccfcccccccccccccccccccccccfcccccccccccccccccccccccfcccccccccccccccccccccccfcccccccccccccccccccccccfcccccccccccccccccccccccfcccccccccccccccccccccccfcccccccccccccccccccccccfcccccccccccccccccccccccf
fQQQQQQQQQQQQQQQQQQQQQQQfcccccccccccccccccccccccfcccccccccccccccccccccccfcccccccccccccccccccccccfcccccccccccccccccccccccfcccccccccccccccccccccccfcccccccccccccccccccccccfcccccccccccccccccccccccfcccccccccccccccccccccccfcccccccccccccccccccccccfcccccccccccccccccccccccfcccccccccccccccccccccccfcccccccccccccccccccccccfcccccccccccccccccccccccfcccccccccccccccccccccccf
fQQQQQQQQQQQQQQQQQQQQQQQfcccccccccccccccccccccccfcccccccccccccccccccccccfcccccccccccccccccccccccfcccccccccccccccccccccccfcccccccccccccccccccccccfcccccccccccccccccccccccfcccccccccccccccccccccccfcccccccccccccccccccccccfcccccccccccccccccccccccfcccccccccccccccccccccccfcccccccccccccccccccccccfcccccccccccccccccccccccfcccccccccccccccccccccccfcccccccccccccccccccccccf
fQQQQQQQQQQQQQQQQQQQQQQQfcccccccccccccccccccccccfcccccccccccccccccccccccfcccccccccccccccccccccccfcccccccccccccccccccccccfcccccccccccccccccccccccfcccccccccccccccccccccccfcccccccccccccccccccccccfcccccccccccccccccccccccfcccccccccccccccccccccccfcccccccccccccccccccccccfcccccccccccccccccccccccfcccccccccccccccccccccccfcccccccccccccccccccccccfcccccccccccccccccccccccf
fQQQQQQQQQQQQQQQQQQQQQQQfcccccccccccccccccccccccfcccccccccccccccccccccccfcccccccccccccccccccccccfcccccccccccccccccccccccfcccccccccccccccccccccccfcccccccccccccccccccccccfcccccccccccccccccccccccfcccccccccccccccccccccccfcccccccccccccccccccccccfcccccccccccccccccccccccfcccccccccccccccccccccccfcccccccccccccccccccccccfcccccccccccccccccccccccfcccccccccccccccccccccccf
fQQQQQQQQQQQQQQQQQQQQQQQfcccccccccccccccccccccccfcccccccccccccccccccccccfcccccccccccccccccccccccfcccccccccccccccccccccccfcccccccccccccccccccccccfcccccccccccccccccccccccfcccccccccccccccccccccccfcccccccccccccccccccccccfcccccccccccccccccccccccfcccccccccccccccccccccccfcccccccccccccccccccccccfcccccccccccccccccccccccfcccccccccccccccccccccccfcccccccccccccccccccccccf
fQQQQQQQQQQQQQQQQQQQQQQQfcccccccccccccccccccccccfcccccccccccccccccccccccfcccccccccccccccccccccccfcccccccccccccccccccccccfcccccccccccccccccccccccfcccccccccccccccccccccccfcccccccccccccccccccccccfcccccccccccccccccccccccfcccccccccccccccccccccccfcccccccccccccccccccccccfcccccccccccccccccccccccfcccccccccccccccccccccccfcccccccccccccccccccccccfcccccccccccccccccccccccf
fQQQQQQQQQQQQQQQQQQQQQQQfcccccccccccccccccccccccfcccccccccccccccccccccccfcccccccccccccccccccccccfcccccccccccccccccccccccfcccccccccccccccccccccccfcccccccccccccccccccccccfcccccccccccccccccccccccfcccccccccccccccccccccccfcccccccccccccccccccccccfcccccccccccccccccccccccfcccccccccccccccccccccccfcccccccccccccccccccccccfcccccccccccccccccccccccfcccccccccccccccccccccccf
fQQQQQQQQQQQQQQQQQQQQQQQfcccccccccccccccccccccccfcccccccccccccccccccccccfcccccccccccccccccccccccfcccccccccccccccccccccccfcccccccccccccccccccccccfcccccccccccccccccccccccfcccccccccccccccccccccccfcccccccccccccccccccccccfcccccccccccccccccccccccfcccccccccccccccccccccccfcccccccccccccccccccccccfcccccccccccccccccccccccfcccccccccccccccccccccccfcccccccccccccccccccccccf
fQQQQQQQQQQQQQQQQQQQQQQQfcccccccccccccccccccccccfcccccccccccccccccccccccfcccccccccccccccccccccccfcccccccccccccccccccccccfcccccccccccccccccccccccfcccccccccccccccccccccccfcccccccccccccccccccccccfcccccccccccccccccccccccfcccccccccccccccccccccccfcccccccccccccccccccccccfcccccccccccccccccccccccfcccccccccccccccccccccccfcccccccccccccccccccccccfcccccccccccccccccccccccf
fQQQQQQQQQQQQQQQQQQQQQQQfcccccccccccccccccccccccfcccccccccccccccccccccccfcccccccccccccccccccccccfcccccccccccccccccccccccfcccccccccccccccccccccccfcccccccccccccccccccccccfcccccccccccccccccccccccfcccccccccccccccccccccccfcccccccccccccccccccccccfcccccccccccccccccccccccfcccccccccccccccccccccccfcccccccccccccccccccccccfcccccccccccccccccccccccfcccccccccccccccccccccccf
fQQQQQQQQQQQQQQQQQQQQQQQfcccccccccccccccccccccccfcccccccccccccccccccccccfcccccccccccccccccccccccfcccccccccccccccccccccccfcccccccccccccccccccccccfcccccccccccccccccccccccfcccccccccccccccccccccccfcccccccccccccccccccccccfcccccccccccccccccccccccfcccccccccccccccccccccccfcccccccccccccccccccccccfcccccccccccccccccccccccfcccccccccccccccccccccccfcccccccccccccccccccccccf
fQQQQQQQQQQQQQQQQQQQQQQQfcccccccccccccccccccccccfcccccccccccccccccccccccfcccccccccccccccccccccccfcccccccccccccccccccccccfcccccccccccccccccccccccfcccccccccccccccccccccccfcccccccccccccccccccccccfcccccccccccccccccccccccfcccccccccccccccccccccccfcccccccccccccccccccccccfcccccccccccccccccccccccfcccccccccccccccccccccccfcccccccccccccccccccccccfcccccccccccccccccccccccf
fQQQQQQQQQQQQQQQQQQQQQQQfcccccccccccccccccccccccfcccccccccccccccccccccccfcccccccccccccccccccccccfcccccccccccccccccccccccfcccccccccccccccccccccccfcccccccccccccccccccccccfcccccccccccccccccccccccfcccccccccccccccccccccccfcccccccccccccccccccccccfcccccccccccccccccccccccfcccccccccccccccccccccccfcccccccccccccccccccccccfcccccccccccccccccccccccfcccccccccccccccccccccccf
fQQQQQQQQQQQQQQQQQQQQQQQfcccccccccccccccccccccccfcccccccccccccccccccccccfcccccccccccccccccccccccfcccccccccccccccccccccccfcccccccccccccccccccccccfcccccccccccccccccccccccfcccccccccccccccccccccccfcccccccccccccccccccccccfcccccccccccccccccccccccfcccccccccccccccccccccccfcccccccccccccccccccccccfcccccccccccccccccccccccfcccccccccccccccccccccccfcccccccccccccccccccccccf
fQQQQQQQQQQQQQQQQQQQQQQQfcccccccccccccccccccccccfcccccccccccccccccccccccfcccccccccccccccccccccccfcccccccccccccccccccccccfcccccccccccccccccccccccfcccccccccccccccccccccccfcccccccccccccccccccccccfcccccccccccccccccccccccfcccccccccccccccccccccccfcccccccccccccccccccccccfcccccccccccccccccccccccfcccccccccccccccccccccccfcccccccccccccccccccccccfcccccccccccccccccccccccf
fQQQQQQQQQQQQQQQQQQQQQQQfcccccccccccccccccccccccfcccccccccccccccccccccccfcccccccccccccccccccccccfcccccccccccccccccccccccfcccccccccccccccccccccccfcccccccccccccccccccccccfcccccccccccccccccccccccfcccccccccccccccccccccccfcccccccccccccccccccccccfcccccccccccccccccccccccfcccccccccccccccccccccccfcccccccccccccccccccccccfcccccccccccccccccccccccfcccccccccccccccccccccccf
fQQQQQQQQQQQQQQQQQQQQQQQfcccccccccccccccccccccccfcccccccccccccccccccccccfcccccccccccccccccccccccfcccccccccccccccccccccccfcccccccccccccccccccccccfcccccccccccccccccccccccfcccccccccccccccccccccccfcccccccccccccccccccccccfcccccccccccccccccccccccfcccccccccccccccccccccccfcccccccccccccccccccccccfcccccccccccccccccccccccfcccccccccccccccccccccccfcccccccccccccccccccccccf
fQQQQQQQQQQQQQQQQQQQQQQQfcccccccccccccccccccccccfcccccccccccccccccccccccfcccccccccccccccccccccccfcccccccccccccccccccccccfcccccccccccccccccccccccfcccccccccccccccccccccccfcccccccccccccccccccccccfcccccccccccccccccccccccfcccccccccccccccccccccccfcccccccccccccccccccccccfcccccccccccccccccccccccfcccccccccccccccccccccccfcccccccccccccccccccccccfcccccccccccccccccccccccf
fQQQQQQQQQQQQQQQQQQQQQQQfcccccccccccccccccccccccfcccccccccccccccccccccccfcccccccccccccccccccccccfcccccccccccccccccccccccfcccccccccccccccccccccccfcccccccccccccccccccccccfcccccccccccccccccccccccfcccccccccccccccccccccccfcccccccccccccccccccccccfcccccccccccccccccccccccfcccccccccccccccccccccccfcccccccccccccccccccccccfcccccccccccccccccccccccfcccccccccccccccccccccccf
fQQQQQQQQQQQQQQQQQQQQQQQfcccccccccccccccccccccccfcccccccccccccccccccccccfcccccccccccccccccccccccfcccccccccccccccccccccccfcccccccccccccccccccccccfcccccccccccccccccccccccfcccccccccccccccccccccccfcccccccccccccccccccccccfcccccccccccccccccccccccfcccccccccccccccccccccccfcccccccccccccccccccccccfcccccccccccccccccccccccfcccccccccccccccccccccccfcccccccccccccccccccccccf
ammmmmmmmmmmmmmmmmmmmmmmammmmmmmmmmmmmmmmmmmmmmmammmmmmmmmmmmmmmmmmmmmmmammmmmmmmmmmmmmmmmmmmmmmammmmmmmmmmmmmmmmmmmmmmmammmmmmmmmmmmmmmmmmmmmmmammmmmmmmmmmmmmmmmmmmmmmammmmmmmmmmmmmmmmmmmmmmmammmmmmmmmmmmmmmmmmmmmmmammmmmmmmmmmmmmmmmmmmmmmammmmmmmmmmmmmmmmmmmmmmmammmmmmmmmmmmmmmmmmmmmmmammmmmmmmmmmmmmmmmmmmmmmammmmmmmmmmmmmmmmmmmmmmmammmmmmmmmmmmmmmmmmmmmmma
"}
