"aa" = (/turf/unsimulated/wall{icon_state = "iron6"},/area)
"ab" = (/obj/structure/window/reinforced,/turf/unsimulated/wall{icon_state = "iron12"},/area)
"ac" = (/turf/unsimulated/wall{icon_state = "iron14"},/area)
"ad" = (/turf/unsimulated/wall{icon_state = "iron10"},/area)
"ae" = (/obj/structure/window/reinforced{dir = 4},/turf/unsimulated/wall{icon_state = "iron3"},/area)
"af" = (/turf/simulated/floor/holofloor{icon_state = "engine"; name = "Holodeck Projector Floor"},/area/holodeck/source_wildlife)
"ag" = (/obj/structure/window/reinforced{dir = 4},/obj/structure/window/reinforced{dir = 8},/turf/unsimulated/wall{icon_state = "iron3"},/area)
"ah" = (/turf/simulated/floor/holofloor{icon_state = "asteroid"},/area/holodeck/source_desert)
"ai" = (/turf/simulated/floor/holofloor{dir = 4; icon_state = "asteroid2"},/area/holodeck/source_desert)
"aj" = (/obj/structure/flora/ausbushes/fullgrass,/turf/simulated/floor/holofloor/grass,/area/holodeck/source_picnicarea)
"ak" = (/obj/structure/flora/ausbushes/grassybush,/turf/simulated/floor/holofloor/grass,/area/holodeck/source_picnicarea)
"al" = (/obj/structure/rack/holo,/obj/item/clothing/under/dress/dress_saloon,/obj/item/clothing/head/hairflower,/turf/simulated/floor/holofloor{icon_state = "cult"},/area/holodeck/source_theatre)
"am" = (/obj/structure/rack/holo,/obj/map/spawner/set_spawner/theater,/turf/simulated/floor/holofloor{icon_state = "cult"},/area/holodeck/source_theatre)
"an" = (/turf/simulated/floor/holofloor{icon_state = "engine"; name = "Holodeck Projector Floor"},/area/holodeck/source_plating)
"ao" = (/turf/simulated/floor/holofloor{icon_state = "engine"; name = "Burn-Mix Floor"; nitrogen = 0; oxygen = 2500; temperature = 370; toxins = 5},/area/holodeck/source_burntest)
"ap" = (/turf/simulated/floor/holofloor{dir = 9; icon_state = "red"},/area/holodeck/source_emptycourt)
"aq" = (/turf/simulated/floor/holofloor{dir = 1; icon_state = "red"},/area/holodeck/source_emptycourt)
"ar" = (/turf/simulated/floor/holofloor{dir = 5; icon_state = "red"},/area/holodeck/source_emptycourt)
"as" = (/obj/structure/window/reinforced{dir = 8},/turf/unsimulated/wall{icon_state = "iron3"},/area)
"at" = (/obj/effect/landmark{name = "Holocarp Spawn"},/turf/simulated/floor/holofloor{icon_state = "engine"; name = "Holodeck Projector Floor"},/area/holodeck/source_wildlife)
"au" = (/obj/structure/flora/ausbushes/fullgrass,/turf/simulated/floor/holofloor{icon_state = "asteroid"},/area/holodeck/source_desert)
"av" = (/turf/simulated/floor/holofloor{icon_state = "asteroid7"},/area/holodeck/source_desert)
"aw" = (/turf/simulated/floor/holofloor{dir = 4; icon_state = "asteroid8"},/area/holodeck/source_desert)
"ax" = (/obj/structure/flora/ausbushes/ywflowers,/turf/simulated/floor/holofloor/grass,/area/holodeck/source_picnicarea)
"ay" = (/obj/structure/flora/ausbushes/brflowers,/turf/simulated/floor/holofloor/grass,/area/holodeck/source_picnicarea)
"az" = (/turf/simulated/floor/holofloor{icon_state = "cult"},/area/holodeck/source_theatre)
"aA" = (/obj/effect/landmark{name = "Atmospheric Test Start"},/turf/simulated/floor/holofloor{icon_state = "engine"; name = "Burn-Mix Floor"; nitrogen = 0; oxygen = 2500; temperature = 370; toxins = 5},/area/holodeck/source_burntest)
"aB" = (/turf/simulated/floor/holofloor{dir = 8; icon_state = "red"},/area/holodeck/source_emptycourt)
"aC" = (/turf/simulated/floor/holofloor,/area/holodeck/source_emptycourt)
"aD" = (/turf/simulated/floor/holofloor{dir = 4; icon_state = "red"},/area/holodeck/source_emptycourt)
"aE" = (/turf/simulated/floor/holofloor{dir = 4; icon_state = "asteroid3"},/area/holodeck/source_desert)
"aF" = (/turf/simulated/floor/holofloor/grass,/obj/structure/flora/ausbushes/ppflowers,/turf/simulated/floor/holofloor{dir = 4; icon_state = "wood_siding2"},/area/holodeck/source_picnicarea)
"aG" = (/turf/simulated/floor/holofloor/grass,/obj/structure/flora/ausbushes/ywflowers,/turf/simulated/floor/holofloor{dir = 4; icon_state = "wood_siding2"},/area/holodeck/source_picnicarea)
"aH" = (/turf/simulated/floor/holofloor{dir = 4; icon_state = "asteroid1"},/area/holodeck/source_desert)
"aI" = (/turf/simulated/floor/holofloor{dir = 4; icon_state = "asteroid11"},/area/holodeck/source_desert)
"aJ" = (/obj/effect/decal/cleanable/dirt,/turf/simulated/floor/holofloor{icon_state = "asteroid"},/area/holodeck/source_picnicarea)
"aK" = (/turf/simulated/floor/holofloor{dir = 4; icon_state = "wood"},/turf/simulated/floor/holofloor{icon_state = "siding1"},/area/holodeck/source_theatre)
"aL" = (/turf/simulated/floor/holofloor{icon_state = "rampbottom"},/area/holodeck/source_theatre)
"aM" = (/turf/simulated/floor/holofloor/grass,/obj/structure/flora/ausbushes/sunnybush,/turf/simulated/floor/holofloor{icon_state = "wood_siding5"},/area/holodeck/source_picnicarea)
"aN" = (/obj/effect/decal/cleanable/dirt,/obj/item/weapon/stool/hologram,/turf/simulated/floor/holofloor{icon_state = "asteroid"},/area/holodeck/source_picnicarea)
"aO" = (/obj/structure/table/holotable/wood,/turf/simulated/floor/holofloor{icon_state = "asteroid"},/area/holodeck/source_picnicarea)
"aP" = (/turf/simulated/floor/holofloor/grass,/obj/structure/flora/ausbushes/sunnybush,/turf/simulated/floor/holofloor{icon_state = "wood_siding9"},/area/holodeck/source_picnicarea)
"aQ" = (/turf/simulated/floor/holofloor{dir = 4; icon_state = "wood"},/area/holodeck/source_theatre)
"aR" = (/obj/item/weapon/stool/hologram,/turf/simulated/floor/holofloor{dir = 4; icon_state = "carpet6-2"},/area/holodeck/source_theatre)
"aS" = (/obj/item/weapon/stool/hologram,/turf/simulated/floor/holofloor{dir = 4; icon_state = "carpet14-10"},/area/holodeck/source_theatre)
"aT" = (/obj/item/weapon/stool/hologram,/turf/simulated/floor/holofloor{dir = 4; icon_state = "carpet10-8"},/area/holodeck/source_theatre)
"aU" = (/turf/simulated/floor/holofloor{icon_state = "asteroid5"},/area/holodeck/source_desert)
"aV" = (/turf/simulated/floor/holofloor/grass,/obj/structure/flora/ausbushes/sunnybush,/turf/simulated/floor/holofloor{icon_state = "wood_siding6"},/area/holodeck/source_picnicarea)
"aW" = (/turf/simulated/floor/holofloor/grass,/obj/structure/flora/ausbushes/sunnybush,/turf/simulated/floor/holofloor{icon_state = "wood_siding10"},/area/holodeck/source_picnicarea)
"aX" = (/obj/item/weapon/stool/hologram,/turf/simulated/floor/holofloor{dir = 4; icon_state = "carpet7-3"},/area/holodeck/source_theatre)
"aY" = (/obj/item/weapon/stool/hologram,/turf/simulated/floor/holofloor{dir = 4; icon_state = "carpet15-15"},/area/holodeck/source_theatre)
"aZ" = (/obj/item/weapon/stool/hologram,/turf/simulated/floor/holofloor{dir = 4; icon_state = "carpet11-12"},/area/holodeck/source_theatre)
"ba" = (/turf/simulated/floor/holofloor{dir = 8; icon_state = "green"},/area/holodeck/source_emptycourt)
"bb" = (/turf/simulated/floor/holofloor{dir = 4; icon_state = "green"},/area/holodeck/source_emptycourt)
"bc" = (/turf/simulated/floor/holofloor{dir = 4; icon_state = "carpet2-0"},/area/holodeck/source_theatre)
"bd" = (/obj/structure/flora/ausbushes/sparsegrass,/turf/simulated/floor/holofloor{icon_state = "asteroid"},/area/holodeck/source_desert)
"be" = (/obj/structure/flora/ausbushes/genericbush,/turf/simulated/floor/holofloor{icon_state = "asteroid"},/area/holodeck/source_desert)
"bf" = (/turf/simulated/floor/holofloor/grass,/obj/structure/flora/ausbushes/ywflowers,/turf/simulated/floor/holofloor{icon_state = "wood_siding1"},/area/holodeck/source_picnicarea)
"bg" = (/turf/simulated/floor/holofloor/grass,/obj/structure/flora/ausbushes/brflowers,/turf/simulated/floor/holofloor{icon_state = "wood_siding1"},/area/holodeck/source_picnicarea)
"bh" = (/turf/simulated/floor/holofloor{dir = 4; icon_state = "carpet3-0"},/area/holodeck/source_theatre)
"bi" = (/obj/structure/flora/ausbushes/ppflowers,/turf/simulated/floor/holofloor/grass,/area/holodeck/source_picnicarea)
"bj" = (/obj/structure/flora/ausbushes/ppflowers,/turf/simulated/floor/holofloor{icon_state = "asteroid"},/area/holodeck/source_desert)
"bk" = (/obj/structure/flora/ausbushes/lavendergrass,/turf/simulated/floor/holofloor/grass,/area/holodeck/source_picnicarea)
"bl" = (/obj/structure/flora/ausbushes/lavendergrass,/obj/structure/flora/ausbushes/grassybush,/turf/simulated/floor/holofloor/grass,/area/holodeck/source_picnicarea)
"bm" = (/turf/simulated/floor/holofloor{dir = 4; icon_state = "carpet1-0"},/area/holodeck/source_theatre)
"bn" = (/turf/simulated/floor/holofloor{dir = 4; icon_state = "carpet5-1"},/area/holodeck/source_theatre)
"bo" = (/turf/simulated/floor/holofloor{dir = 4; icon_state = "carpet13-5"},/area/holodeck/source_theatre)
"bp" = (/turf/simulated/floor/holofloor{dir = 4; icon_state = "carpet9-4"},/area/holodeck/source_theatre)
"bq" = (/turf/simulated/floor/holofloor{dir = 10; icon_state = "green"},/area/holodeck/source_emptycourt)
"br" = (/turf/simulated/floor/holofloor{icon_state = "green"},/area/holodeck/source_emptycourt)
"bs" = (/turf/simulated/floor/holofloor{dir = 6; icon_state = "green"},/area/holodeck/source_emptycourt)
"bt" = (/turf/unsimulated/wall,/area)
"bu" = (/obj/structure/window/reinforced{dir = 1},/obj/structure/window/reinforced,/turf/unsimulated/wall{icon_state = "iron12"},/area)
"bv" = (/turf/unsimulated/wall{icon_state = "iron11"},/area)
"bw" = (/turf/simulated/floor/holofloor{dir = 9; icon_state = "red"},/area/holodeck/source_basketball)
"bx" = (/obj/structure/holohoop,/turf/simulated/floor/holofloor{dir = 1; icon_state = "red"},/area/holodeck/source_basketball)
"by" = (/turf/simulated/floor/holofloor{dir = 5; icon_state = "red"},/area/holodeck/source_basketball)
"bz" = (/turf/simulated/floor/holofloor{dir = 5; icon_state = "17"},/area/holodeck/source_space)
"bA" = (/turf/simulated/floor/holofloor{dir = 5; icon_state = "22"},/area/holodeck/source_space)
"bB" = (/turf/simulated/floor/holofloor{dir = 5; icon_state = "1"},/area/holodeck/source_space)
"bC" = (/turf/simulated/floor/holofloor{icon_state = "snow"},/area/holodeck/source_snowfield)
"bD" = (/turf/simulated/floor/holofloor{icon_state = "grimy"},/area/holodeck/source_meetinghall)
"bE" = (/turf/simulated/floor/beach/sand,/area/holodeck/source_beach)
"bF" = (/obj/structure/table/holotable,/obj/machinery/readybutton{pixel_y = -24},/turf/simulated/floor/holofloor{dir = 9; icon_state = "red"},/area/holodeck/source_thunderdomecourt)
"bG" = (/obj/structure/table/holotable,/obj/item/clothing/head/helmet/thunderdome,/obj/item/clothing/suit/armor/tdome/red,/obj/item/clothing/under/color/red,/obj/item/weapon/holo/esword/red,/turf/simulated/floor/holofloor{dir = 1; icon_state = "red"},/area/holodeck/source_thunderdomecourt)
"bH" = (/obj/structure/table/holotable,/turf/simulated/floor/holofloor{dir = 5; icon_state = "red"},/area/holodeck/source_thunderdomecourt)
"bI" = (/obj/structure/table/holotable,/obj/item/clothing/gloves/boxing/hologlove,/turf/simulated/floor/holofloor{dir = 9; icon_state = "red"},/area/holodeck/source_boxingcourt)
"bJ" = (/turf/simulated/floor/holofloor{dir = 1; icon_state = "red"},/area/holodeck/source_boxingcourt)
"bK" = (/obj/structure/table/holotable,/obj/item/clothing/gloves/boxing/hologlove,/turf/simulated/floor/holofloor{dir = 5; icon_state = "red"},/area/holodeck/source_boxingcourt)
"bL" = (/turf/simulated/floor/holofloor{dir = 8; icon_state = "red"},/area/holodeck/source_basketball)
"bM" = (/turf/simulated/floor/holofloor,/area/holodeck/source_basketball)
"bN" = (/turf/simulated/floor/holofloor{dir = 4; icon_state = "red"},/area/holodeck/source_basketball)
"bO" = (/obj/structure/flora/grass/green,/turf/simulated/floor/holofloor{icon_state = "snow"},/area/holodeck/source_snowfield)
"bP" = (/obj/structure/flora/grass/both,/turf/simulated/floor/holofloor{icon_state = "snow"},/area/holodeck/source_snowfield)
"bQ" = (/turf/simulated/floor/holofloor{dir = 4; icon_state = "carpet4-0"},/area/holodeck/source_meetinghall)
"bR" = (/obj/structure/bed/chair/holowood/wings,/turf/simulated/floor/holofloor{dir = 1; icon_state = "carpet12-0"},/area/holodeck/source_meetinghall)
"bS" = (/turf/simulated/floor/holofloor{dir = 4; icon_state = "carpet8-0"},/area/holodeck/source_meetinghall)
"bT" = (/obj/effect/overlay/palmtree_r,/turf/simulated/floor/beach/sand,/area/holodeck/source_beach)
"bU" = (/obj/effect/overlay/palmtree_l,/obj/effect/overlay/coconut,/turf/simulated/floor/beach/sand,/area/holodeck/source_beach)
"bV" = (/turf/simulated/floor/holofloor{dir = 8; icon_state = "red"},/area/holodeck/source_thunderdomecourt)
"bW" = (/turf/simulated/floor/holofloor,/area/holodeck/source_thunderdomecourt)
"bX" = (/turf/simulated/floor/holofloor{dir = 4; icon_state = "red"},/area/holodeck/source_thunderdomecourt)
"bY" = (/turf/simulated/floor/holofloor{dir = 8; icon_state = "red"},/area/holodeck/source_boxingcourt)
"bZ" = (/turf/simulated/floor/holofloor,/area/holodeck/source_boxingcourt)
"ca" = (/turf/simulated/floor/holofloor{dir = 4; icon_state = "red"},/area/holodeck/source_boxingcourt)
"cb" = (/turf/simulated/floor/holofloor{dir = 1; icon_state = "red"},/area/holodeck/source_basketball)
"cc" = (/obj/structure/flora/tree/pine/xmas/holo,/turf/simulated/floor/holofloor{icon_state = "snow"},/area/holodeck/source_snowfield)
"cd" = (/obj/structure/table/holotable/wood,/turf/simulated/floor/holofloor{icon_state = "grimy"},/area/holodeck/source_meetinghall)
"ce" = (/turf/simulated/floor/holofloor{dir = 10; icon_state = "red"},/area/holodeck/source_basketball)
"cf" = (/turf/simulated/floor/holofloor{icon_state = "red"},/area/holodeck/source_basketball)
"cg" = (/turf/simulated/floor/holofloor{dir = 6; icon_state = "red"},/area/holodeck/source_basketball)
"ch" = (/obj/structure/bed/chair/holowood/normal{dir = 1},/turf/simulated/floor/holofloor{dir = 4; icon_state = "carpet6-2"},/area/holodeck/source_meetinghall)
"ci" = (/obj/structure/bed/chair/holowood/normal{dir = 1},/turf/simulated/floor/holofloor{icon_state = "carpet14-10"},/area/holodeck/source_meetinghall)
"cj" = (/obj/structure/bed/chair/holowood/normal{dir = 1},/turf/simulated/floor/holofloor{dir = 4; icon_state = "carpet10-8"},/area/holodeck/source_meetinghall)
"ck" = (/obj/item/clothing/under/rainbow,/obj/item/clothing/glasses/sunglasses,/turf/simulated/floor/beach/sand,/area/holodeck/source_beach)
"cl" = (/obj/structure/window/reinforced/holo,/turf/simulated/floor/holofloor{dir = 8; icon_state = "red"},/area/holodeck/source_thunderdomecourt)
"cm" = (/obj/structure/window/reinforced/holo,/turf/simulated/floor/holofloor,/area/holodeck/source_thunderdomecourt)
"cn" = (/obj/structure/window/reinforced/holo,/turf/simulated/floor/holofloor{dir = 4; icon_state = "red"},/area/holodeck/source_thunderdomecourt)
"co" = (/turf/simulated/floor/holofloor{dir = 9; icon_state = "green"},/area/holodeck/source_basketball)
"cp" = (/turf/simulated/floor/holofloor{dir = 1; icon_state = "green"},/area/holodeck/source_basketball)
"cq" = (/turf/simulated/floor/holofloor{dir = 5; icon_state = "green"},/area/holodeck/source_basketball)
"cr" = (/obj/structure/flora/tree/dead/holo,/turf/simulated/floor/holofloor{icon_state = "snow"},/area/holodeck/source_snowfield)
"cs" = (/obj/structure/flora/grass/brown,/turf/simulated/floor/holofloor{icon_state = "snow"},/area/holodeck/source_snowfield)
"ct" = (/obj/structure/bed/chair/holowood/normal{dir = 1},/turf/simulated/floor/holofloor{icon_state = "carpet7-3"},/area/holodeck/source_meetinghall)
"cu" = (/obj/structure/bed/chair/holowood/normal{dir = 1},/turf/simulated/floor/holofloor{icon_state = "carpet15-15"},/area/holodeck/source_meetinghall)
"cv" = (/obj/structure/bed/chair/holowood/normal{dir = 1},/turf/simulated/floor/holofloor{icon_state = "carpet11-12"},/area/holodeck/source_meetinghall)
"cw" = (/obj/item/weapon/beach_ball,/turf/simulated/floor/beach/sand,/area/holodeck/source_beach)
"cx" = (/obj/structure/window/reinforced/holo{dir = 1},/turf/simulated/floor/holofloor{dir = 8; icon_state = "green"},/area/holodeck/source_thunderdomecourt)
"cy" = (/obj/structure/window/reinforced/holo{dir = 1},/turf/simulated/floor/holofloor,/area/holodeck/source_thunderdomecourt)
"cz" = (/obj/structure/window/reinforced/holo{dir = 1},/turf/simulated/floor/holofloor{dir = 4; icon_state = "green"},/area/holodeck/source_thunderdomecourt)
"cA" = (/turf/simulated/floor/holofloor{dir = 8; icon_state = "green"},/area/holodeck/source_boxingcourt)
"cB" = (/turf/simulated/floor/holofloor{dir = 4; icon_state = "green"},/area/holodeck/source_boxingcourt)
"cC" = (/turf/simulated/floor/holofloor{dir = 8; icon_state = "green"},/area/holodeck/source_basketball)
"cD" = (/obj/item/weapon/beach_ball/holoball,/turf/simulated/floor/holofloor,/area/holodeck/source_basketball)
"cE" = (/turf/simulated/floor/holofloor{dir = 4; icon_state = "green"},/area/holodeck/source_basketball)
"cF" = (/turf/simulated/floor/holofloor{dir = 8; icon_state = "green"},/area/holodeck/source_thunderdomecourt)
"cG" = (/turf/simulated/floor/holofloor{dir = 4; icon_state = "green"},/area/holodeck/source_thunderdomecourt)
"cH" = (/turf/simulated/floor/holofloor{icon_state = "green"},/area/holodeck/source_basketball)
"cI" = (/turf/simulated/floor/holofloor{icon_state = "sand"; name = "Soft sand"},/area/holodeck/source_beach)
"cJ" = (/obj/structure/bed/chair/holowood/normal{dir = 1},/turf/simulated/floor/holofloor{dir = 4; icon_state = "carpet5-1"},/area/holodeck/source_meetinghall)
"cK" = (/obj/structure/bed/chair/holowood/normal{dir = 1},/turf/simulated/floor/holofloor{dir = 4; icon_state = "carpet13-5"},/area/holodeck/source_meetinghall)
"cL" = (/obj/structure/bed/chair/holowood/normal{dir = 1},/turf/simulated/floor/holofloor{icon_state = "carpet9-4"},/area/holodeck/source_meetinghall)
"cM" = (/turf/simulated/floor/beach/coastline,/area/holodeck/source_beach)
"cN" = (/turf/simulated/floor/holofloor{dir = 10; icon_state = "green"},/area/holodeck/source_basketball)
"cO" = (/obj/structure/holohoop{dir = 1},/turf/simulated/floor/holofloor{icon_state = "green"},/area/holodeck/source_basketball)
"cP" = (/turf/simulated/floor/holofloor{dir = 6; icon_state = "green"},/area/holodeck/source_basketball)
"cQ" = (/turf/simulated/floor/beach/water,/area/holodeck/source_beach)
"cR" = (/obj/structure/table/holotable,/turf/simulated/floor/holofloor{dir = 10; icon_state = "green"},/area/holodeck/source_thunderdomecourt)
"cS" = (/obj/structure/table/holotable,/obj/item/clothing/head/helmet/thunderdome,/obj/item/clothing/suit/armor/tdome/green,/obj/item/clothing/under/color/green,/obj/item/weapon/holo/esword/green,/turf/simulated/floor/holofloor{icon_state = "green"},/area/holodeck/source_thunderdomecourt)
"cT" = (/obj/structure/table/holotable,/obj/machinery/readybutton{pixel_y = 24},/turf/simulated/floor/holofloor{dir = 6; icon_state = "green"},/area/holodeck/source_thunderdomecourt)
"cU" = (/obj/structure/table/holotable,/obj/item/clothing/gloves/boxing/hologlove{icon_state = "boxinggreen"; item_state = "boxinggreen"},/turf/simulated/floor/holofloor{dir = 10; icon_state = "green"},/area/holodeck/source_boxingcourt)
"cV" = (/turf/simulated/floor/holofloor{icon_state = "green"},/area/holodeck/source_boxingcourt)
"cW" = (/obj/structure/table/holotable,/obj/item/clothing/gloves/boxing/hologlove{icon_state = "boxinggreen"; item_state = "boxinggreen"},/turf/simulated/floor/holofloor{dir = 6; icon_state = "green"},/area/holodeck/source_boxingcourt)
"cX" = (/turf/unsimulated/wall{icon_state = "iron5"},/area)
"cY" = (/obj/structure/window/reinforced{dir = 1},/turf/unsimulated/wall{icon_state = "iron12"},/area)
"cZ" = (/turf/unsimulated/wall{icon_state = "iron13"},/area)
"da" = (/turf/unsimulated/wall{icon_state = "iron9"},/area)

(1,1,1) = {"
aaabababababacabababababacabababababacabababababacabababababacabababababacabababababad
aeafafafafafagahahaiahahagajakajakajagalamamamamaganananananagaoaoaoaoaoagapaqaqaqaras
aeafatafatafagahauahavawagaxayaxayaxagazazazazazaganananananagaoaAaoaAaoagaBaCaCaCaDas
aeafafafafafagahaEahahahagaFaGaFaGaFagazazazazazaganananananagaoaoaoaoaoagaBaCaCaCaDas
aeafafafafafagahaHauaIahagaJaJaJaJaJagaKaKaKaKaLaganananananagaoaoaoaoaoagaBaCaCaCaDas
aeafafatafafagavahahahahagaMaNaOaNaPagaQaRaSaTaQaganananananagaoaoaoaoaoagaBaCaCaCaDas
aeafafatafafagahavahahaUagaVaNaOaNaWagaQaXaYaZaQaganananananagaoaoaoaoaoagbaaCaCaCbbas
aeafafafafafagahahavahahagaJaJaJaJaJagbcaXaYaZbcaganananananagaoaoaoaoaoagbaaCaCaCbbas
aeafafafafafagahbdahavbeagbfbgbfbgbfagbhaXaYaZbhaganananananagaoaoaoaoaoagbaaCaCaCbbas
aeafatafatafagahaHahahavagbiaxbiaxbiagbhaXaYaZbhaganananananagaoaAaoaAaoagbaaCaCaCbbas
aeafafafafafagbjahavahbjagbkakbkblbkagbmbnbobpbmaganananananagaoaoaoaoaoagbqbrbrbrbsas
btbubububububtbubububububtbubububububtbubububububtbubububububtbubububububtbubububububv
aebwbwbxbybyagbzbAbAbBbAagbCbCbCbCbCagbDbDbDbDbDagbEbEbEbEbEagbFbGbGbGbHagbIbJbJbJbKas
aebLbLbMbNbNagbAbBbAbzbzagbObCbCbCbPagbDbQbRbSbDagbEbTbEbUbEagbVbWbWbWbXagbYbZbZbZcaas
aebLcbcbcbbNagbBbAbBbAbBagbCbCccbCbCagbDcdcdcdbDagbEbEbEbEbEagbVbWbWbWbXagbYbZbZbZcaas
aebLbMbMbMbNagbAbzbzbAbBagbObCbCbCbCagbDbDbDbDbDagbEbEbEbEbEagbVbWbWbWbXagbYbZbZbZcaas
aececfcfcfcgagbBbAbAbBbzagbCbCbCbCbCagbDchcicjbDagbEckbEbEbEagclcmcmcmcnagbYbZbZbZcaas
aecocpcpcpcqagbBbBbzbBbBagbCcrbCcsbCagbDctcucvbDagbEbEbEcwbEagcxcycycyczagcAbZbZbZcBas
aecCbMcDbMcEagbzbBbBbBbBagbCbCbCbCbCagbDctcucvbDagbEbEbEbEbEagcFbWbWbWcGagcAbZbZbZcBas
aecCcHcHcHcEagbBbAbBbBbzagbCcsbCbCbCagbDctcucvbDagcIcIcIcIcIagcFbWbWbWcGagcAbZbZbZcBas
aecCcCbMcEcEagbAbAbAbzbBagbCcsbCcrbCagbDcJcKcLbDagcMcMcMcMcMagcFbWbWbWcGagcAbZbZbZcBas
aecNcNcOcPcPagbBbBbBbAbzagbCbCbCbCbOagbDbDbDbDbDagcQcQcQcQcQagcRcScScScTagcUcVcVcVcWas
cXcYcYcYcYcYcZcYcYcYcYcYcZcYcYcYcYcYcZcYcYcYcYcYcZcYcYcYcYcYcZcYcYcYcYcYcZcYcYcYcYcYda
"}
