//MAP CONVERTED BY dmm2tgm.py THIS HEADER COMMENT PREVENTS RECONVERSION, DO NOT REMOVE
"ac" = (
/obj/machinery/power/treadmill{
	dir = 4
	},
/turf/simulated/floor/holofloor{
	icon_state = "green"
	},
/area/holodeck/source_gym)
"au" = (
/turf/simulated/floor/holofloor{
	dir = 1;
	icon_state = "red"
	},
/area/holodeck/source_boxingcourt)
"bz" = (
/obj/structure/weightlifter/holo,
/turf/simulated/floor/holofloor{
	dir = 1;
	icon_state = "green"
	},
/area/holodeck/source_gym)
"bG" = (
/turf/unsimulated/wall,
/area)
"cE" = (
/obj/structure/window/reinforced{
	dir = 8
	},
/obj/structure/window/reinforced{
	dir = 4
	},
/turf/unsimulated/wall{
	icon_state = "iron3"
	},
/area)
"cS" = (
/turf/simulated/floor/holofloor{
	icon_state = "engine";
	name = "Holodeck Projector Floor"
	},
/area/holodeck/source_wildlife)
"cW" = (
/turf/simulated/floor/holofloor{
	icon_state = "green"
	},
/area/holodeck/source_thunderdomecourt)
"do" = (
/obj/machinery/conveyor/auto{
	dir = 1
	},
/obj/machinery/conveyor/auto{
	dir = 1
	},
/turf/simulated/floor/holofloor{
	icon_state = "engine";
	name = "Holodeck Projector Floor"
	},
/area/holodeck/source_wildride)
"dv" = (
/turf/simulated/floor/holofloor{
	dir = 6;
	icon_state = "green"
	},
/area/holodeck/source_boxingcourt)
"dC" = (
/obj/structure/holohoop,
/turf/simulated/floor/holofloor{
	dir = 1;
	icon_state = "red"
	},
/area/holodeck/source_basketball)
"eh" = (
/turf/simulated/floor/holofloor{
	icon_state = "engine";
	name = "Holodeck Projector Floor"
	},
/area/holodeck/source_plating)
"ej" = (
/obj/structure/flora/ausbushes/grassybush,
/turf/simulated/floor/holofloor/grass,
/area/holodeck/source_picnicarea)
"ez" = (
/turf/simulated/floor/holofloor{
	dir = 9;
	icon_state = "red"
	},
/area/holodeck/source_emptycourt)
"fA" = (
/obj/machinery/conveyor/auto{
	dir = 10
	},
/obj/machinery/conveyor/auto{
	dir = 10
	},
/turf/simulated/floor/holofloor{
	icon_state = "engine";
	name = "Holodeck Projector Floor"
	},
/area/holodeck/source_wildride)
"hk" = (
/obj/machinery/conveyor/auto{
	dir = 1
	},
/obj/machinery/conveyor/auto,
/obj/machinery/conveyor/auto,
/turf/simulated/floor/holofloor{
	icon_state = "engine";
	name = "Holodeck Projector Floor"
	},
/area/holodeck/source_wildride)
"hn" = (
/obj/structure/table/holotable/wood,
/obj/item/weapon/kitchen/utensil/fork{
	pixel_x = 16
	},
/obj/item/weapon/kitchen/utensil/fork{
	pixel_x = 14
	},
/obj/item/weapon/kitchen/utensil/fork{
	pixel_x = 12
	},
/obj/item/weapon/kitchen/utensil/fork{
	pixel_x = 10
	},
/obj/item/weapon/kitchen/utensil/knife{
	pixel_x = -16
	},
/obj/item/weapon/kitchen/utensil/knife{
	pixel_x = -14
	},
/obj/item/weapon/kitchen/utensil/knife{
	pixel_x = -12
	},
/obj/item/weapon/kitchen/utensil/knife{
	pixel_x = -10
	},
/obj/item/trash/plate/clean{
	pixel_y = -12
	},
/obj/item/trash/plate/clean{
	pixel_y = 12
	},
/obj/item/trash/plate/clean{
	pixel_y = -6
	},
/obj/item/trash/plate/clean{
	pixel_y = 6
	},
/obj/item/candle,
/turf/simulated/floor/holofloor{
	dir = 4;
	icon_state = "wood"
	},
/area/holodeck/source_dining)
"hK" = (
/obj/machinery/conveyor/auto{
	dir = 5
	},
/obj/machinery/conveyor/auto{
	dir = 5
	},
/turf/simulated/floor/holofloor{
	icon_state = "engine";
	name = "Holodeck Projector Floor"
	},
/area/holodeck/source_wildride)
"hV" = (
/obj/structure/table/holotable/wood,
/obj/item/device/flashlight/lamp/green{
	pixel_x = 1;
	pixel_y = 5
	},
/turf/simulated/floor/holofloor{
	dir = 4;
	icon_state = "carpet14-10"
	},
/area/holodeck/source_library)
"ii" = (
/obj/structure/window/reinforced,
/turf/unsimulated/wall{
	icon_state = "iron12"
	},
/area)
"iO" = (
/turf/simulated/floor/holofloor,
/area/holodeck/source_basketball)
"iX" = (
/obj/structure/flora/ausbushes/fullgrass,
/turf/simulated/floor/holofloor{
	icon_state = "asteroid"
	},
/area/holodeck/source_desert)
"jp" = (
/obj/structure/flora/grass/green,
/turf/simulated/floor/holofloor{
	icon_state = "snow"
	},
/area/holodeck/source_snowfield)
"jK" = (
/obj/structure/flora/tree/pine/xmas/holo,
/turf/simulated/floor/holofloor{
	icon_state = "snow"
	},
/area/holodeck/source_snowfield)
"jU" = (
/turf/simulated/floor/holofloor{
	dir = 5;
	icon_state = "red"
	},
/area/holodeck/source_emptycourt)
"kD" = (
/obj/structure/bed/chair/holowood/wings{
	dir = 8
	},
/turf/simulated/floor/holofloor{
	dir = 4;
	icon_state = "carpet8-0"
	},
/area/holodeck/source_meetinghall)
"li" = (
/obj/structure/flora/ausbushes/ppflowers,
/turf/simulated/floor/holofloor/grass,
/area/holodeck/source_picnicarea)
"lG" = (
/turf/simulated/floor/holofloor{
	icon_state = "asteroid5"
	},
/area/holodeck/source_desert)
"lW" = (
/turf/simulated/floor/holofloor{
	icon_state = "grimy"
	},
/area/holodeck/source_meetinghall)
"nF" = (
/obj/structure/punching_bag/clown,
/turf/simulated/floor/holofloor{
	icon_state = "green"
	},
/area/holodeck/source_gym)
"po" = (
/turf/simulated/floor/holofloor,
/area/holodeck/source_thunderdomecourt)
"pG" = (
/obj/item/weapon/beach_ball,
/obj/item/weapon/pickaxe/shovel/spade,
/turf/simulated/floor/beach/sand,
/area/holodeck/source_beach)
"pT" = (
/obj/machinery/conveyor/auto{
	dir = 4
	},
/obj/machinery/conveyor/auto{
	dir = 4
	},
/turf/simulated/floor/holofloor{
	icon_state = "engine";
	name = "Holodeck Projector Floor"
	},
/area/holodeck/source_wildride)
"pY" = (
/obj/structure/fence{
	dir = 4
	},
/obj/structure/fence,
/turf/simulated/floor/holofloor{
	icon_state = "asteroid"
	},
/area/holodeck/source_zoo)
"qP" = (
/obj/item/clothing/under/shorts/green,
/obj/item/clothing/gloves/boxing/green,
/turf/simulated/floor/holofloor{
	dir = 10;
	icon_state = "green"
	},
/area/holodeck/source_boxingcourt)
"rd" = (
/obj/item/target/syndicate,
/turf/simulated/floor/holofloor{
	icon_state = "engine";
	name = "Holodeck Projector Floor"
	},
/area/holodeck/source_firingrange)
"rs" = (
/turf/simulated/floor/holofloor{
	dir = 9;
	icon_state = "red"
	},
/area/holodeck/source_basketball)
"rJ" = (
/obj/structure/curtain/black/holo,
/turf/simulated/floor/holofloor{
	icon_state = "cult"
	},
/area/holodeck/source_theatre)
"rT" = (
/turf/simulated/floor/holofloor{
	dir = 6;
	icon_state = "green"
	},
/area/holodeck/source_basketball)
"sU" = (
/obj/structure/table/holotable,
/obj/item/clothing/under/color/red,
/obj/item/clothing/suit/armor/tdome/red,
/obj/item/clothing/head/helmet/thunderdome,
/obj/item/weapon/holo/esword/red,
/obj/machinery/readybutton,
/turf/simulated/floor/holofloor{
	dir = 1;
	icon_state = "red"
	},
/area/holodeck/source_thunderdomecourt)
"tl" = (
/turf/simulated/floor/holofloor{
	dir = 4;
	icon_state = "wood"
	},
/area/holodeck/source_library)
"tY" = (
/obj/structure/flora/grass/both,
/turf/simulated/floor/holofloor{
	icon_state = "snow"
	},
/area/holodeck/source_snowfield)
"vf" = (
/turf/simulated/floor/holofloor{
	dir = 1;
	icon_state = "red"
	},
/area/holodeck/source_thunderdomecourt)
"vZ" = (
/obj/machinery/conveyor/auto{
	dir = 4
	},
/obj/machinery/conveyor/auto{
	dir = 8
	},
/turf/simulated/floor/holofloor{
	icon_state = "engine";
	name = "Holodeck Projector Floor"
	},
/area/holodeck/source_wildride)
"xj" = (
/obj/structure/bed/chair/holowood/normal{
	dir = 1
	},
/turf/simulated/floor/holofloor{
	dir = 4;
	icon_state = "wood"
	},
/area/holodeck/source_dining)
"xk" = (
/obj/structure/rack/holo,
/obj/item/clothing/suit/bomb_suit,
/obj/item/clothing/suit/bomb_suit,
/obj/item/clothing/head/bomb_hood,
/obj/item/clothing/head/bomb_hood,
/turf/simulated/floor/holofloor{
	icon_state = "engine";
	name = "Holodeck Projector Floor"
	},
/area/holodeck/source_panic)
"xw" = (
/turf/simulated/floor/holofloor/grass,
/area/holodeck/source_zoo)
"xP" = (
/obj/structure/bed/chair/holowood/wings,
/turf/simulated/floor/holofloor{
	dir = 4;
	icon_state = "wood"
	},
/area/holodeck/source_dining)
"xS" = (
/turf/simulated/floor/holofloor{
	dir = 4;
	icon_state = "carpet13-5"
	},
/area/holodeck/source_library)
"ys" = (
/turf/simulated/floor/holofloor{
	dir = 4;
	icon_state = "red"
	},
/area/holodeck/source_boxingcourt)
"yx" = (
/turf/simulated/floor/holofloor{
	dir = 4;
	icon_state = "wood"
	},
/area/holodeck/source_dining)
"yI" = (
/obj/item/weapon/beach_ball/holoball,
/turf/simulated/floor/holofloor,
/area/holodeck/source_basketball)
"yM" = (
/turf/simulated/floor/holofloor{
	dir = 8;
	icon_state = "ramptop"
	},
/area/holodeck/source_panic)
"zv" = (
/turf/simulated/floor/holofloor{
	dir = 8;
	icon_state = "green"
	},
/area/holodeck/source_boxingcourt)
"AY" = (
/obj/machinery/conveyor/auto{
	dir = 6
	},
/turf/simulated/floor/holofloor{
	icon_state = "engine";
	name = "Holodeck Projector Floor"
	},
/area/holodeck/source_wildride)
"BC" = (
/obj/structure/bed/chair/holowood/normal{
	dir = 4
	},
/turf/simulated/floor/holofloor{
	dir = 4;
	icon_state = "wood"
	},
/area/holodeck/source_dining)
"BF" = (
/turf/simulated/floor/holofloor{
	icon_state = "cult"
	},
/area/holodeck/source_theatre)
"CF" = (
/obj/structure/flora/rock/pile/snow,
/turf/simulated/floor/holofloor{
	icon_state = "snow"
	},
/area/holodeck/source_snowfield)
"CG" = (
/turf/simulated/floor/holofloor,
/area/holodeck/source_emptycourt)
"CT" = (
/obj/item/toy/gasha/carptoy,
/turf/simulated/floor/beach/coastline,
/area/holodeck/source_beach)
"Da" = (
/obj/structure/snow_flora,
/turf/simulated/floor/holofloor{
	icon_state = "snow"
	},
/area/holodeck/source_snowfield)
"Db" = (
/obj/structure/bed/chair/holowood/normal{
	dir = 8
	},
/turf/simulated/floor/holofloor{
	dir = 4;
	icon_state = "carpet10-8"
	},
/area/holodeck/source_library)
"Dh" = (
/turf/unsimulated/wall{
	icon_state = "iron14"
	},
/area)
"Do" = (
/obj/structure/holohoop{
	dir = 1
	},
/turf/simulated/floor/holofloor{
	icon_state = "green"
	},
/area/holodeck/source_basketball)
"DU" = (
/turf/simulated/floor/beach/coastline,
/area/holodeck/source_beach)
"EN" = (
/obj/item/weapon/stool/hologram,
/turf/simulated/floor/holofloor{
	icon_state = "asteroid"
	},
/area/holodeck/source_picnicarea)
"ER" = (
/turf/simulated/floor/holofloor{
	dir = 5;
	icon_state = "red"
	},
/area/holodeck/source_firingrange)
"Fv" = (
/turf/simulated/floor/holofloor{
	icon_state = "engine";
	name = "Holodeck Projector Floor"
	},
/area)
"FV" = (
/obj/structure/flora/ausbushes/brflowers,
/turf/simulated/floor/holofloor/grass,
/area/holodeck/source_picnicarea)
"Gb" = (
/obj/structure/rack/holo,
/obj/item/clothing/mask/gas/monkeymask,
/obj/item/clothing/suit/monkeysuit,
/obj/item/clothing/head/cowboy,
/obj/item/clothing/under/gokugi,
/obj/item/clothing/head/collectable/wizard,
/obj/item/clothing/suit/wizrobe/fake,
/obj/item/clothing/mask/gas/owl_mask,
/obj/item/clothing/under/owl,
/obj/item/clothing/under/darkholme,
/obj/item/clothing/head/collectable/pirate,
/obj/item/clothing/under/pirate,
/obj/item/clothing/under/wedding/bride_white,
/obj/item/clothing/shoes/rottenshoes,
/obj/item/clothing/under/rottensuit,
/obj/item/clothing/under/schoolgirl,
/obj/item/clothing/head/collectable/xenom,
/obj/item/clothing/suit/xenos,
/turf/simulated/floor/holofloor{
	icon_state = "cult"
	},
/area/holodeck/source_theatre)
"Gc" = (
/obj/structure/skele_stand/mrbones{
	anchored = 1
	},
/turf/simulated/floor/holofloor{
	icon_state = "engine";
	name = "Holodeck Projector Floor"
	},
/area/holodeck/source_wildride)
"Gf" = (
/turf/simulated/floor/holofloor{
	dir = 4;
	icon_state = "asteroid3"
	},
/area/holodeck/source_desert)
"Gi" = (
/obj/structure/bed/chair/holowood/normal{
	dir = 8
	},
/turf/simulated/floor/holofloor{
	dir = 4;
	icon_state = "wood"
	},
/area/holodeck/source_dining)
"Gr" = (
/obj/structure/foamedmetal,
/turf/simulated/floor/holofloor{
	icon_state = "engine";
	name = "Holodeck Projector Floor"
	},
/area/holodeck/source_panic)
"GQ" = (
/turf/simulated/floor/holofloor/space,
/area/holodeck/source_space)
"GU" = (
/mob/living/simple_animal/hologram/tajaran_dancer,
/turf/simulated/floor/holofloor/grass,
/area/holodeck/source_zoo)
"Hk" = (
/turf/simulated/floor/holofloor{
	icon_state = "engine";
	name = "Holodeck Projector Floor"
	},
/area/holodeck/source_panic)
"HN" = (
/obj/effect/landmark{
	name = "Holocarp Spawn"
	},
/turf/simulated/floor/holofloor{
	icon_state = "engine";
	name = "Holodeck Projector Floor"
	},
/area/holodeck/source_wildlife)
"HW" = (
/turf/simulated/floor/holofloor{
	icon_state = "asteroid"
	},
/area/holodeck/source_desert)
"Iy" = (
/obj/structure/flora/ausbushes/ywflowers,
/turf/simulated/floor/holofloor/grass,
/area/holodeck/source_picnicarea)
"II" = (
/turf/simulated/floor/holofloor{
	dir = 6;
	icon_state = "red"
	},
/area/holodeck/source_firingrange)
"Kr" = (
/turf/simulated/floor/holofloor{
	dir = 1;
	icon_state = "red"
	},
/area/holodeck/source_emptycourt)
"KB" = (
/obj/structure/flora/ausbushes/fullgrass,
/turf/simulated/floor/holofloor/grass,
/area/holodeck/source_picnicarea)
"KS" = (
/obj/effect/landmark{
	name = "Atmospheric Test Start"
	},
/turf/simulated/floor/holofloor{
	icon_state = "engine";
	name = "Burn-Mix Floor";
	nitrogen = 0;
	oxygen = 2500;
	temperature = 370;
	toxins = 5
	},
/area/holodeck/source_burntest)
"Lb" = (
/obj/effect/overlay/coconut,
/turf/simulated/floor/beach/sand,
/area/holodeck/source_beach)
"Ll" = (
/obj/structure/table/holotable,
/obj/item/weapon/gun/energy/laser/practice,
/obj/item/clothing/ears/earmuffs,
/turf/simulated/floor/holofloor,
/area/holodeck/source_firingrange)
"Lt" = (
/turf/simulated/floor/holofloor{
	dir = 10;
	icon_state = "red"
	},
/area/holodeck/source_firingrange)
"LN" = (
/obj/structure/target_stake,
/obj/item/target/alien,
/turf/simulated/floor/holofloor{
	icon_state = "engine";
	name = "Holodeck Projector Floor"
	},
/area/holodeck/source_firingrange)
"Mh" = (
/turf/simulated/floor/holofloor{
	dir = 9;
	icon_state = "red"
	},
/area/holodeck/source_firingrange)
"Mr" = (
/obj/structure/window/reinforced{
	dir = 1
	},
/obj/structure/window/reinforced,
/turf/unsimulated/wall{
	icon_state = "iron12"
	},
/area)
"Mu" = (
/turf/simulated/floor/holofloor{
	dir = 4;
	icon_state = "carpet5-1"
	},
/area/holodeck/source_library)
"ML" = (
/turf/simulated/floor/holofloor{
	dir = 6;
	icon_state = "green"
	},
/area/holodeck/source_emptycourt)
"Np" = (
/obj/structure/bed/chair/holowood/normal{
	dir = 4
	},
/turf/simulated/floor/holofloor{
	dir = 4;
	icon_state = "carpet6-2"
	},
/area/holodeck/source_library)
"Ny" = (
/turf/simulated/floor/holofloor,
/area/holodeck/source_gym)
"NM" = (
/obj/structure/table/holotable/wood,
/obj/item/clothing/under/swimsuit/blue{
	pixel_x = 4;
	pixel_y = 4
	},
/obj/item/clothing/under/swimsuit/purple,
/obj/item/clothing/under/swimsuit/green{
	pixel_x = -6;
	pixel_y = 2
	},
/obj/item/clothing/under/shorts/red{
	pixel_x = 5;
	pixel_y = 8
	},
/obj/item/clothing/under/shorts/green{
	pixel_x = -3;
	pixel_y = 3
	},
/obj/item/clothing/under/shorts/blue{
	pixel_x = 2;
	pixel_y = -2
	},
/turf/simulated/floor/beach/sand,
/area/holodeck/source_beach)
"NO" = (
/turf/simulated/floor/holofloor{
	icon_state = "green"
	},
/area/holodeck/source_gym)
"NZ" = (
/turf/simulated/floor/holofloor{
	dir = 5;
	icon_state = "red"
	},
/area/holodeck/source_basketball)
"Oa" = (
/turf/simulated/floor/holofloor{
	icon_state = "snow"
	},
/area/holodeck/source_snowfield)
"Od" = (
/turf/unsimulated/wall{
	icon_state = "iron12"
	},
/area)
"OQ" = (
/obj/structure/sink/puddle,
/obj/structure/flora/ausbushes/reedbush{
	pixel_y = 6
	},
/turf/simulated/floor/holofloor{
	icon_state = "asteroid"
	},
/area/holodeck/source_desert)
"OX" = (
/turf/simulated/floor/holofloor{
	icon_state = "engine";
	name = "Burn-Mix Floor";
	nitrogen = 0;
	oxygen = 2500;
	temperature = 370;
	toxins = 5
	},
/area/holodeck/source_burntest)
"Pg" = (
/turf/simulated/floor/holofloor{
	icon_state = "green"
	},
/area/holodeck/source_boxingcourt)
"PK" = (
/obj/structure/curtain/open/privacy,
/turf/simulated/floor/beach/sand,
/area/holodeck/source_beach)
"QK" = (
/obj/item/clothing/under/shorts/red,
/obj/item/clothing/gloves/boxing,
/turf/simulated/floor/holofloor{
	dir = 5;
	icon_state = "red"
	},
/area/holodeck/source_boxingcourt)
"QV" = (
/obj/item/clothing/glasses/sunglasses/holo,
/turf/simulated/floor/beach/sand,
/area/holodeck/source_beach)
"RE" = (
/obj/structure/punching_bag,
/turf/simulated/floor/holofloor{
	dir = 1;
	icon_state = "green"
	},
/area/holodeck/source_gym)
"RG" = (
/obj/structure/fence/door,
/turf/simulated/floor/holofloor{
	icon_state = "asteroid"
	},
/area/holodeck/source_zoo)
"Sd" = (
/turf/simulated/floor/holofloor{
	icon_state = "green"
	},
/area/holodeck/source_emptycourt)
"Se" = (
/obj/structure/table/holotable/wood,
/obj/item/weapon/gavelblock,
/obj/item/weapon/gavelhammer,
/turf/simulated/floor/holofloor{
	dir = 4;
	icon_state = "carpet4-0"
	},
/area/holodeck/source_meetinghall)
"St" = (
/obj/structure/table/holotable,
/obj/machinery/readybutton,
/obj/item/clothing/under/color/green,
/obj/item/clothing/suit/armor/tdome/green,
/obj/item/clothing/head/helmet/thunderdome,
/obj/item/weapon/holo/esword/green,
/turf/simulated/floor/holofloor{
	icon_state = "green"
	},
/area/holodeck/source_thunderdomecourt)
"SK" = (
/obj/item/target,
/turf/simulated/floor/holofloor{
	icon_state = "engine";
	name = "Holodeck Projector Floor"
	},
/area/holodeck/source_firingrange)
"SV" = (
/turf/simulated/floor/holofloor{
	dir = 10;
	icon_state = "green"
	},
/area/holodeck/source_basketball)
"Tt" = (
/obj/structure/rack/holo,
/obj/item/clothing/suit/bio_suit,
/obj/item/clothing/suit/bio_suit,
/obj/item/clothing/head/bio_hood,
/obj/item/clothing/head/bio_hood,
/turf/simulated/floor/holofloor{
	icon_state = "engine";
	name = "Holodeck Projector Floor"
	},
/area/holodeck/source_panic)
"Ur" = (
/turf/simulated/floor/holofloor,
/area/holodeck/source_firingrange)
"UF" = (
/turf/simulated/floor/holofloor{
	dir = 4;
	icon_state = "carpet9-4"
	},
/area/holodeck/source_library)
"Va" = (
/obj/structure/rack/holo,
/obj/item/clothing/suit/radiation,
/obj/item/clothing/suit/radiation,
/obj/item/clothing/head/radiation,
/obj/item/clothing/head/radiation,
/turf/simulated/floor/holofloor{
	icon_state = "engine";
	name = "Holodeck Projector Floor"
	},
/area/holodeck/source_panic)
"Vb" = (
/obj/structure/fence,
/turf/simulated/floor/holofloor{
	icon_state = "asteroid"
	},
/area/holodeck/source_zoo)
"Vf" = (
/obj/structure/stacklifter/holo,
/turf/simulated/floor/holofloor{
	dir = 1;
	icon_state = "green"
	},
/area/holodeck/source_gym)
"VP" = (
/turf/simulated/floor/holofloor{
	dir = 9;
	icon_state = "red"
	},
/area/holodeck/source_boxingcourt)
"VQ" = (
/obj/machinery/conveyor/auto{
	dir = 9
	},
/obj/machinery/conveyor/auto{
	dir = 9
	},
/turf/simulated/floor/holofloor{
	icon_state = "engine";
	name = "Holodeck Projector Floor"
	},
/area/holodeck/source_wildride)
"VU" = (
/obj/structure/table/holotable/wood,
/turf/simulated/floor/holofloor{
	icon_state = "asteroid"
	},
/area/holodeck/source_picnicarea)
"Wg" = (
/turf/simulated/floor/holofloor,
/area/holodeck/source_boxingcourt)
"Wn" = (
/obj/item/clothing/under/rainbow,
/turf/simulated/floor/beach/sand,
/area/holodeck/source_beach)
"Wt" = (
/turf/simulated/floor/holofloor{
	dir = 10;
	icon_state = "green"
	},
/area/holodeck/source_emptycourt)
"Xg" = (
/obj/structure/bed/chair/holowood/normal{
	dir = 1
	},
/turf/simulated/floor/holofloor{
	icon_state = "grimy"
	},
/area/holodeck/source_meetinghall)
"Xt" = (
/obj/structure/flora/ausbushes/ywflowers,
/turf/simulated/floor/holofloor/grass,
/area/holodeck/source_zoo)
"XB" = (
/turf/simulated/floor/holofloor{
	dir = 8;
	icon_state = "green"
	},
/area/holodeck/source_emptycourt)
"XD" = (
/turf/simulated/floor/holofloor{
	dir = 4;
	icon_state = "wood"
	},
/area/holodeck/source_theatre)
"XE" = (
/obj/structure/bookcase/holodeck,
/turf/simulated/floor/holofloor{
	dir = 4;
	icon_state = "wood"
	},
/area/holodeck/source_library)
"Ya" = (
/obj/structure/flora/ausbushes/ppflowers,
/turf/simulated/floor/holofloor{
	icon_state = "asteroid"
	},
/area/holodeck/source_desert)
"Zo" = (
/turf/simulated/floor/holofloor{
	dir = 4;
	icon_state = "red"
	},
/area/holodeck/source_emptycourt)
"ZH" = (
/obj/structure/flora/ausbushes/lavendergrass,
/turf/simulated/floor/holofloor/grass,
/area/holodeck/source_picnicarea)

(1,1,1) = {"
Dh
cE
cE
cE
bG
cE
cE
cE
bG
"}
(2,1,1) = {"
ii
HN
cS
HN
Mr
rs
iO
SV
Od
"}
(3,1,1) = {"
ii
cS
cS
cS
Mr
dC
yI
Do
Od
"}
(4,1,1) = {"
ii
HN
cS
HN
Mr
NZ
iO
rT
Od
"}
(5,1,1) = {"
Dh
cE
cE
cE
bG
cE
cE
cE
bG
"}
(6,1,1) = {"
ii
iX
HW
lG
Mr
GQ
GQ
GQ
Od
"}
(7,1,1) = {"
ii
HW
OQ
HW
Mr
GQ
GQ
GQ
Od
"}
(8,1,1) = {"
ii
Gf
Gf
Ya
Mr
GQ
GQ
GQ
Od
"}
(9,1,1) = {"
Dh
cE
cE
cE
bG
cE
cE
cE
bG
"}
(10,1,1) = {"
ii
ZH
EN
Iy
Mr
jp
Oa
jp
Od
"}
(11,1,1) = {"
ii
KB
VU
FV
Mr
Oa
jK
CF
Od
"}
(12,1,1) = {"
ii
ej
EN
li
Mr
tY
Oa
Da
Od
"}
(13,1,1) = {"
Dh
cE
cE
cE
bG
cE
cE
cE
bG
"}
(14,1,1) = {"
ii
BF
BF
XD
Mr
lW
lW
Xg
Od
"}
(15,1,1) = {"
ii
rJ
BF
XD
Mr
Se
lW
Xg
Od
"}
(16,1,1) = {"
ii
Gb
rJ
XD
Mr
kD
lW
Xg
Od
"}
(17,1,1) = {"
Dh
cE
cE
cE
bG
cE
cE
cE
bG
"}
(18,1,1) = {"
ii
eh
eh
eh
Mr
NM
Wn
DU
Od
"}
(19,1,1) = {"
ii
eh
eh
eh
Mr
PK
QV
CT
Od
"}
(20,1,1) = {"
ii
eh
eh
eh
Mr
pG
Lb
DU
Od
"}
(21,1,1) = {"
Dh
cE
cE
cE
bG
cE
cE
cE
bG
"}
(22,1,1) = {"
ii
KS
OX
KS
Mr
sU
po
cW
Od
"}
(23,1,1) = {"
ii
OX
KS
OX
Mr
vf
po
cW
Od
"}
(24,1,1) = {"
ii
KS
OX
KS
Mr
vf
po
St
Od
"}
(25,1,1) = {"
Dh
cE
cE
cE
bG
cE
cE
cE
bG
"}
(26,1,1) = {"
ii
ez
XB
Wt
Mr
VP
zv
qP
Od
"}
(27,1,1) = {"
ii
Kr
CG
Sd
Mr
au
Wg
Pg
Od
"}
(28,1,1) = {"
ii
jU
Zo
ML
Mr
QK
ys
dv
Od
"}
(29,1,1) = {"
Dh
cE
cE
cE
bG
cE
cE
cE
bG
"}
(30,1,1) = {"
ii
SK
Mh
Lt
Mr
AY
do
hK
Od
"}
(31,1,1) = {"
ii
LN
Ll
Ur
Mr
pT
Gc
vZ
Od
"}
(32,1,1) = {"
ii
rd
ER
II
Mr
fA
hk
VQ
Od
"}
(33,1,1) = {"
Dh
cE
cE
cE
bG
cE
cE
cE
bG
"}
(34,1,1) = {"
ii
Np
Mu
XE
Mr
Fv
Fv
Fv
Od
"}
(35,1,1) = {"
ii
hV
xS
tl
Mr
Fv
Fv
Fv
Od
"}
(36,1,1) = {"
ii
Db
UF
XE
Mr
Fv
Fv
Fv
Od
"}
(37,1,1) = {"
Dh
cE
cE
cE
bG
cE
cE
cE
bG
"}
(38,1,1) = {"
ii
yx
BC
yx
Mr
Fv
Fv
Fv
Od
"}
(39,1,1) = {"
ii
xP
hn
xj
Mr
Fv
Fv
Fv
Od
"}
(40,1,1) = {"
ii
yx
Gi
yx
Mr
Fv
Fv
Fv
Od
"}
(41,1,1) = {"
Dh
cE
cE
cE
bG
cE
cE
cE
bG
"}
(42,1,1) = {"
ii
Xt
xw
xw
Mr
Fv
Fv
Fv
Od
"}
(43,1,1) = {"
ii
xw
pY
Vb
Mr
Fv
Fv
Fv
Od
"}
(44,1,1) = {"
ii
xw
RG
GU
Mr
Fv
Fv
Fv
Od
"}
(45,1,1) = {"
Dh
cE
cE
cE
bG
cE
cE
cE
bG
"}
(46,1,1) = {"
ii
Vf
Ny
nF
Mr
Fv
Fv
Fv
Od
"}
(47,1,1) = {"
ii
bz
Ny
NO
Mr
Fv
Fv
Fv
Od
"}
(48,1,1) = {"
ii
RE
Ny
ac
Mr
Fv
Fv
Fv
Od
"}
(49,1,1) = {"
Dh
cE
cE
cE
bG
cE
cE
cE
bG
"}
(50,1,1) = {"
ii
Gr
yM
Gr
Mr
Fv
Fv
Fv
Od
"}
(51,1,1) = {"
ii
Va
Hk
Tt
Mr
Fv
Fv
Fv
Od
"}
(52,1,1) = {"
ii
Gr
xk
Gr
Mr
Fv
Fv
Fv
Od
"}
(53,1,1) = {"
Dh
cE
cE
cE
bG
cE
cE
cE
bG
"}
(54,1,1) = {"
ii
Fv
Fv
Fv
Mr
Fv
Fv
Fv
Od
"}
(55,1,1) = {"
ii
Fv
Fv
Fv
Mr
Fv
Fv
Fv
Od
"}
(56,1,1) = {"
ii
Fv
Fv
Fv
Mr
Fv
Fv
Fv
Od
"}
(57,1,1) = {"
Dh
cE
cE
cE
bG
cE
cE
cE
bG
"}
(58,1,1) = {"
ii
Fv
Fv
Fv
Mr
Fv
Fv
Fv
Od
"}
(59,1,1) = {"
ii
Fv
Fv
Fv
Mr
Fv
Fv
Fv
Od
"}
(60,1,1) = {"
ii
Fv
Fv
Fv
Mr
Fv
Fv
Fv
Od
"}
(61,1,1) = {"
Dh
cE
cE
cE
bG
cE
cE
cE
bG
"}
(62,1,1) = {"
ii
Fv
Fv
Fv
Mr
Fv
Fv
Fv
Od
"}
(63,1,1) = {"
ii
Fv
Fv
Fv
Mr
Fv
Fv
Fv
Od
"}
(64,1,1) = {"
ii
Fv
Fv
Fv
Mr
Fv
Fv
Fv
Od
"}
(65,1,1) = {"
Dh
cE
cE
cE
bG
cE
cE
cE
bG
"}
