//MAP CONVERTED BY dmm2tgm.py THIS HEADER COMMENT PREVENTS RECONVERSION, DO NOT REMOVE
"a" = (
/turf/unsimulated/floor/asteroid,
/area)
"f" = (
/turf/unsimulated/mineral,
/area)
"H" = (
/turf/space,
/area)
"Z" = (
/obj/effect/landmark/keycard/easy,
/turf/unsimulated/floor/asteroid,
/area)

(1,1,1) = {"
a
a
H
H
H
H
H
a
a
a
H
H
H
a
a
"}
(2,1,1) = {"
a
H
H
H
a
a
a
a
a
a
a
H
H
a
a
"}
(3,1,1) = {"
H
H
a
a
a
a
a
a
a
a
a
a
H
H
H
"}
(4,1,1) = {"
H
a
a
a
a
a
a
a
a
a
a
a
a
a
H
"}
(5,1,1) = {"
H
a
a
a
a
a
a
a
f
a
a
a
a
a
H
"}
(6,1,1) = {"
a
a
a
a
a
f
f
f
f
a
a
a
a
a
f
"}
(7,1,1) = {"
f
f
a
a
a
f
f
f
a
a
a
a
f
f
f
"}
(8,1,1) = {"
f
f
f
a
a
a
a
Z
a
a
a
f
f
f
f
"}
(9,1,1) = {"
f
f
f
a
a
a
a
f
a
a
a
f
f
f
f
"}
(10,1,1) = {"
a
f
f
a
a
f
f
f
f
a
a
a
f
a
H
"}
(11,1,1) = {"
a
a
a
a
f
f
f
f
f
a
a
a
a
a
H
"}
(12,1,1) = {"
a
a
a
a
a
f
f
f
f
f
a
a
a
a
H
"}
(13,1,1) = {"
H
H
a
a
a
a
a
a
a
a
a
a
a
H
H
"}
(14,1,1) = {"
a
H
H
H
a
a
a
a
a
a
a
a
H
H
a
"}
(15,1,1) = {"
a
a
a
H
H
H
a
a
a
a
a
H
H
H
a
"}
