//MAP CONVERTED BY dmm2tgm.py THIS HEADER COMMENT PREVENTS RECONVERSION, DO NOT REMOVE
"a" = (
/turf/unsimulated/floor/asteroid,
/area)
"f" = (
/turf/unsimulated/mineral,
/area)
"H" = (
/turf/space,
/area)
"Z" = (
/obj/effect/landmark/keycard,
/turf/unsimulated/floor/asteroid,
/area)

(1,1,1) = {"
a
a
H
a
a
H
a
"}
(2,1,1) = {"
H
H
H
f
f
H
H
"}
(3,1,1) = {"
a
a
f
f
a
a
H
"}
(4,1,1) = {"
a
a
a
Z
a
a
a
"}
(5,1,1) = {"
H
a
f
f
a
H
H
"}
(6,1,1) = {"
H
H
a
f
f
H
a
"}
(7,1,1) = {"
a
H
H
a
H
H
a
"}
