//MAP CONVERTED BY dmm2tgm.py THIS HEADER COMMENT PREVENTS RECONVERSION, DO NOT REMOVE
"a" = (
/turf/unsimulated/beach/water,
/area/beach)
"c" = (
/obj/structure/table,
/obj/item/weapon/reagent_containers/food/drinks/soda_cans/cola,
/obj/item/weapon/reagent_containers/food/drinks/soda_cans/cola,
/obj/item/weapon/reagent_containers/food/drinks/soda_cans/cola,
/obj/item/weapon/reagent_containers/food/drinks/soda_cans/cola,
/obj/item/weapon/reagent_containers/food/drinks/soda_cans/cola,
/obj/item/weapon/reagent_containers/food/drinks/soda_cans/cola,
/turf/unsimulated/beach/sand,
/area/beach)
"d" = (
/obj/machinery/media/jukebox/superjuke,
/turf/unsimulated/beach/sand,
/area/beach)
"g" = (
/obj/item/weapon/beach_ball,
/turf/unsimulated/beach/sand,
/area/beach)
"h" = (
/mob/living/simple_animal/crab/Coffee,
/turf/unsimulated/beach/sand,
/area/beach)
"s" = (
/obj/structure/table,
/obj/item/weapon/reagent_containers/food/snacks/chips,
/turf/unsimulated/beach/sand,
/area/beach)
"u" = (
/turf/unsimulated/floor{
	icon_state = "sandwater";
	density = 1
	},
/area/beach)
"w" = (
/obj/item/clothing/head/collectable/paper,
/turf/unsimulated/beach/sand,
/area/beach)
"x" = (
/turf/unsimulated/beach/water{
	density = 1
	},
/area/beach)
"y" = (
/obj/structure/closet,
/turf/unsimulated/beach/sand,
/area/beach)
"A" = (
/turf/unsimulated/beach/coastline{
	density = 1
	},
/area/beach)
"B" = (
/obj/structure/table,
/obj/item/weapon/reagent_containers/food/drinks/beer,
/obj/item/weapon/reagent_containers/food/drinks/beer,
/obj/item/weapon/reagent_containers/food/drinks/beer,
/obj/item/weapon/reagent_containers/food/drinks/beer,
/obj/item/weapon/reagent_containers/food/drinks/beer,
/obj/item/weapon/reagent_containers/food/drinks/beer,
/obj/item/weapon/reagent_containers/food/drinks/beer,
/turf/unsimulated/beach/sand,
/area/beach)
"C" = (
/obj/effect/overlay/coconut,
/turf/unsimulated/beach/sand,
/area/beach)
"D" = (
/obj/structure/bed/chair,
/obj/effect/landmark{
	name = "endgame_exit"
	},
/turf/unsimulated/beach/sand,
/area/beach)
"F" = (
/obj/effect/overlay/palmtree_l,
/turf/unsimulated/beach/sand,
/area/beach)
"G" = (
/turf/space,
/area)
"I" = (
/turf/unsimulated/floor{
	icon_state = "sandwater"
	},
/area/beach)
"J" = (
/turf/unsimulated/beach/sand{
	density = 1
	},
/area/beach)
"P" = (
/obj/structure/table,
/obj/item/clothing/under/rainbow,
/obj/item/clothing/glasses/sunglasses,
/obj/item/clothing/head/collectable/petehat{
	pixel_y = 5
	},
/turf/unsimulated/beach/sand,
/area/beach)
"Q" = (
/turf/unsimulated/beach/coastline,
/area/beach)
"R" = (
/turf/unsimulated/beach/sand,
/area/beach)
"S" = (
/obj/effect/overlay/palmtree_r,
/turf/unsimulated/beach/sand,
/area/beach)
"T" = (
/obj/effect/overlay/palmtree_r,
/obj/effect/overlay/coconut,
/turf/unsimulated/beach/sand,
/area/beach)
"V" = (
/obj/effect/landmark{
	name = "endgame_exit"
	},
/turf/unsimulated/beach/sand,
/area/beach)

(1,1,1) = {"
G
G
G
G
G
G
G
G
G
G
G
G
G
G
G
G
G
G
G
G
G
G
G
G
G
G
G
G
G
G
G
G
G
G
G
G
G
G
G
G
G
G
G
G
G
G
G
G
G
G
G
G
G
G
G
"}
(2,1,1) = {"
G
G
G
G
G
G
G
G
G
G
G
G
G
G
G
G
G
G
G
G
G
G
G
G
G
G
G
G
G
G
G
G
G
G
G
G
G
G
G
G
G
G
G
G
G
G
G
G
G
G
G
G
G
G
G
"}
(3,1,1) = {"
G
G
G
G
G
G
G
G
G
G
G
G
G
G
G
G
G
G
G
G
G
G
G
G
G
G
G
G
G
G
G
G
G
G
G
G
G
G
G
G
G
G
G
G
G
G
G
G
G
G
G
G
G
G
G
"}
(4,1,1) = {"
G
G
G
G
G
G
G
G
G
G
G
G
G
G
G
G
G
G
G
G
G
G
G
G
G
G
G
G
G
G
G
G
G
G
G
G
G
G
G
G
G
G
G
G
G
G
G
G
G
G
G
G
G
G
G
"}
(5,1,1) = {"
G
G
G
G
G
G
G
G
G
G
G
G
G
G
G
G
G
G
G
G
G
G
G
G
G
G
G
G
G
G
G
G
G
G
G
G
G
G
G
G
G
G
G
G
G
G
G
G
G
G
G
G
G
G
G
"}
(6,1,1) = {"
G
G
G
G
G
G
G
G
G
G
G
G
G
G
G
G
G
G
G
G
G
G
G
G
G
G
G
G
G
G
G
G
G
G
G
G
G
G
G
G
G
G
G
G
G
G
G
G
G
G
G
G
G
G
G
"}
(7,1,1) = {"
G
G
G
G
G
G
G
G
G
G
G
G
G
G
G
G
G
G
G
G
G
G
G
G
G
G
G
G
G
G
G
G
G
G
G
G
G
G
G
G
G
G
G
G
G
G
G
G
G
G
G
G
G
G
G
"}
(8,1,1) = {"
G
G
G
G
G
G
G
G
G
G
G
G
G
G
G
G
G
G
G
G
G
G
G
G
G
G
G
G
G
G
G
G
G
G
G
G
G
G
G
G
G
G
G
G
G
G
G
G
G
G
G
G
G
G
G
"}
(9,1,1) = {"
G
G
G
G
G
G
G
G
G
G
G
G
G
G
G
G
G
G
G
G
G
G
G
G
G
G
G
G
G
G
G
G
G
G
G
G
G
G
G
G
G
G
G
G
G
G
G
G
G
G
G
G
G
G
G
"}
(10,1,1) = {"
G
G
G
G
G
G
G
G
G
G
G
G
G
G
G
G
G
G
G
G
G
G
G
G
G
G
G
G
G
G
G
G
G
G
G
G
G
G
G
G
G
G
G
G
G
G
G
G
G
G
G
G
G
G
G
"}
(11,1,1) = {"
G
G
G
G
G
G
G
G
G
G
G
G
G
G
G
G
G
G
G
G
G
G
G
G
G
G
G
G
G
G
G
G
G
G
G
G
G
G
G
G
G
G
G
G
G
G
G
G
G
G
G
G
G
G
G
"}
(12,1,1) = {"
G
G
G
G
G
G
G
G
G
G
G
G
G
G
G
G
G
G
G
G
G
G
G
G
G
G
G
G
G
G
G
G
G
G
G
G
G
G
G
G
G
G
G
G
G
G
G
G
G
G
G
G
G
G
G
"}
(13,1,1) = {"
G
G
G
G
G
G
G
G
G
G
G
G
J
J
J
J
J
J
J
J
J
J
J
J
J
J
u
A
x
x
x
x
x
x
x
x
x
x
x
x
x
x
x
G
G
G
G
G
G
G
G
G
G
G
G
"}
(14,1,1) = {"
G
G
G
G
G
G
G
G
G
G
G
G
J
R
F
R
R
R
R
R
R
R
R
R
R
R
I
Q
a
a
a
a
a
a
a
a
a
a
a
a
a
a
x
G
G
G
G
G
G
G
G
G
G
G
G
"}
(15,1,1) = {"
G
G
G
G
G
G
G
G
G
G
G
G
J
R
R
R
R
R
R
R
R
R
R
R
R
R
I
Q
a
a
a
a
a
a
a
a
a
a
a
a
a
a
x
G
G
G
G
G
G
G
G
G
G
G
G
"}
(16,1,1) = {"
G
G
G
G
G
G
G
G
G
G
G
G
J
R
R
R
R
R
R
R
R
R
C
S
R
R
I
Q
a
a
a
a
a
a
a
a
a
a
a
a
a
a
x
G
G
G
G
G
G
G
G
G
G
G
G
"}
(17,1,1) = {"
G
G
G
G
G
G
G
G
G
G
G
G
J
R
R
R
R
R
R
R
R
R
R
C
R
w
I
Q
a
a
a
a
a
a
a
a
a
a
a
a
a
a
x
G
G
G
G
G
G
G
G
G
G
G
G
"}
(18,1,1) = {"
G
G
G
G
G
G
G
G
G
G
G
G
J
R
R
R
R
S
R
V
V
R
R
R
R
R
I
Q
a
a
a
a
a
a
a
a
a
a
a
a
a
a
x
G
G
G
G
G
G
G
G
G
G
G
G
"}
(19,1,1) = {"
G
G
G
G
G
G
G
G
G
G
G
G
J
R
R
R
R
C
V
B
s
V
R
R
R
R
I
Q
a
a
a
a
a
a
a
a
a
a
a
a
a
a
x
G
G
G
G
G
G
G
G
G
G
G
G
"}
(20,1,1) = {"
G
G
G
G
G
G
G
G
G
G
G
G
J
y
R
R
R
R
V
P
c
V
R
R
R
R
I
Q
a
a
a
a
a
a
a
a
a
a
a
a
a
a
x
G
G
G
G
G
G
G
G
G
G
G
G
"}
(21,1,1) = {"
G
G
G
G
G
G
G
G
G
G
G
G
J
y
R
R
R
R
R
V
V
R
R
R
D
R
I
Q
a
a
a
a
a
a
a
a
a
a
a
a
a
a
x
G
G
G
G
G
G
G
G
G
G
G
G
"}
(22,1,1) = {"
G
G
G
G
G
G
G
G
G
G
G
G
J
y
R
R
R
R
R
R
R
R
R
R
R
R
I
Q
a
a
a
a
a
a
a
a
a
a
a
a
a
a
x
G
G
G
G
G
G
G
G
G
G
G
G
"}
(23,1,1) = {"
G
G
G
G
G
G
G
G
G
G
G
G
J
R
R
R
R
R
R
R
R
R
R
R
D
R
I
Q
a
a
a
a
a
a
a
a
a
a
a
a
a
a
x
G
G
G
G
G
G
G
G
G
G
G
G
"}
(24,1,1) = {"
G
G
G
G
G
G
G
G
G
G
G
G
J
R
R
R
R
R
R
R
S
R
R
R
R
R
I
Q
a
a
a
a
a
a
a
a
a
a
a
a
a
a
x
G
G
G
G
G
G
G
G
G
G
G
G
"}
(25,1,1) = {"
G
G
G
G
G
G
G
G
G
G
G
G
J
y
R
R
R
R
R
d
R
R
R
R
D
R
I
Q
a
a
a
a
a
a
a
a
a
a
a
a
a
a
x
G
G
G
G
G
G
G
G
G
G
G
G
"}
(26,1,1) = {"
G
G
G
G
G
G
G
G
G
G
G
G
J
y
R
R
R
R
R
R
g
R
R
R
R
R
I
Q
a
a
a
a
a
a
a
a
a
a
a
a
a
a
x
G
G
G
G
G
G
G
G
G
G
G
G
"}
(27,1,1) = {"
G
G
G
G
G
G
G
G
G
G
G
G
J
y
R
C
F
R
R
R
R
R
R
R
h
R
I
Q
a
a
a
a
a
a
a
a
a
a
a
a
a
a
x
G
G
G
G
G
G
G
G
G
G
G
G
"}
(28,1,1) = {"
G
G
G
G
G
G
G
G
G
G
G
G
J
R
R
R
R
R
R
R
R
R
R
R
R
R
I
Q
a
a
a
a
a
a
a
a
a
a
a
a
a
a
x
G
G
G
G
G
G
G
G
G
G
G
G
"}
(29,1,1) = {"
G
G
G
G
G
G
G
G
G
G
G
G
J
R
R
R
R
R
R
R
R
R
R
R
R
R
I
Q
a
a
a
a
a
a
a
a
a
a
a
a
a
a
x
G
G
G
G
G
G
G
G
G
G
G
G
"}
(30,1,1) = {"
G
G
G
G
G
G
G
G
G
G
G
G
J
R
R
R
R
R
R
R
R
R
F
C
R
R
I
Q
a
a
a
a
a
a
a
a
a
a
a
a
a
a
x
G
G
G
G
G
G
G
G
G
G
G
G
"}
(31,1,1) = {"
G
G
G
G
G
G
G
G
G
G
G
G
J
R
R
R
R
R
R
R
R
R
R
R
R
R
I
Q
a
a
a
a
a
a
a
a
a
a
a
a
a
a
x
G
G
G
G
G
G
G
G
G
G
G
G
"}
(32,1,1) = {"
G
G
G
G
G
G
G
G
G
G
G
G
J
R
T
R
R
R
R
R
R
R
R
R
R
R
I
Q
a
a
a
a
a
a
a
a
a
a
a
a
a
a
x
G
G
G
G
G
G
G
G
G
G
G
G
"}
(33,1,1) = {"
G
G
G
G
G
G
G
G
G
G
G
G
J
J
J
J
J
J
J
J
J
J
J
J
J
J
u
A
x
x
x
x
x
x
x
x
x
x
x
x
x
x
x
G
G
G
G
G
G
G
G
G
G
G
G
"}
(34,1,1) = {"
G
G
G
G
G
G
G
G
G
G
G
G
G
G
G
G
G
G
G
G
G
G
G
G
G
G
G
G
G
G
G
G
G
G
G
G
G
G
G
G
G
G
G
G
G
G
G
G
G
G
G
G
G
G
G
"}
(35,1,1) = {"
G
G
G
G
G
G
G
G
G
G
G
G
G
G
G
G
G
G
G
G
G
G
G
G
G
G
G
G
G
G
G
G
G
G
G
G
G
G
G
G
G
G
G
G
G
G
G
G
G
G
G
G
G
G
G
"}
(36,1,1) = {"
G
G
G
G
G
G
G
G
G
G
G
G
G
G
G
G
G
G
G
G
G
G
G
G
G
G
G
G
G
G
G
G
G
G
G
G
G
G
G
G
G
G
G
G
G
G
G
G
G
G
G
G
G
G
G
"}
(37,1,1) = {"
G
G
G
G
G
G
G
G
G
G
G
G
G
G
G
G
G
G
G
G
G
G
G
G
G
G
G
G
G
G
G
G
G
G
G
G
G
G
G
G
G
G
G
G
G
G
G
G
G
G
G
G
G
G
G
"}
(38,1,1) = {"
G
G
G
G
G
G
G
G
G
G
G
G
G
G
G
G
G
G
G
G
G
G
G
G
G
G
G
G
G
G
G
G
G
G
G
G
G
G
G
G
G
G
G
G
G
G
G
G
G
G
G
G
G
G
G
"}
(39,1,1) = {"
G
G
G
G
G
G
G
G
G
G
G
G
G
G
G
G
G
G
G
G
G
G
G
G
G
G
G
G
G
G
G
G
G
G
G
G
G
G
G
G
G
G
G
G
G
G
G
G
G
G
G
G
G
G
G
"}
(40,1,1) = {"
G
G
G
G
G
G
G
G
G
G
G
G
G
G
G
G
G
G
G
G
G
G
G
G
G
G
G
G
G
G
G
G
G
G
G
G
G
G
G
G
G
G
G
G
G
G
G
G
G
G
G
G
G
G
G
"}
(41,1,1) = {"
G
G
G
G
G
G
G
G
G
G
G
G
G
G
G
G
G
G
G
G
G
G
G
G
G
G
G
G
G
G
G
G
G
G
G
G
G
G
G
G
G
G
G
G
G
G
G
G
G
G
G
G
G
G
G
"}
(42,1,1) = {"
G
G
G
G
G
G
G
G
G
G
G
G
G
G
G
G
G
G
G
G
G
G
G
G
G
G
G
G
G
G
G
G
G
G
G
G
G
G
G
G
G
G
G
G
G
G
G
G
G
G
G
G
G
G
G
"}
(43,1,1) = {"
G
G
G
G
G
G
G
G
G
G
G
G
G
G
G
G
G
G
G
G
G
G
G
G
G
G
G
G
G
G
G
G
G
G
G
G
G
G
G
G
G
G
G
G
G
G
G
G
G
G
G
G
G
G
G
"}
(44,1,1) = {"
G
G
G
G
G
G
G
G
G
G
G
G
G
G
G
G
G
G
G
G
G
G
G
G
G
G
G
G
G
G
G
G
G
G
G
G
G
G
G
G
G
G
G
G
G
G
G
G
G
G
G
G
G
G
G
"}
(45,1,1) = {"
G
G
G
G
G
G
G
G
G
G
G
G
G
G
G
G
G
G
G
G
G
G
G
G
G
G
G
G
G
G
G
G
G
G
G
G
G
G
G
G
G
G
G
G
G
G
G
G
G
G
G
G
G
G
G
"}
