//MAP CONVERTED BY dmm2tgm.py THIS HEADER COMMENT PREVENTS RECONVERSION, DO NOT REMOVE
"a" = (
/turf/simulated/floor/grass,
/area/beach)
"b" = (
/turf/simulated/floor/grass{
	density = 1
	},
/area/beach)
"c" = (
/turf/unsimulated/beach/water{
	density = 1
	},
/area/beach)
"e" = (
/obj/structure/flora/rock,
/turf/unsimulated/beach/water/deep,
/area/beach)
"f" = (
/turf/unsimulated/beach/water,
/area/beach)
"g" = (
/turf/unsimulated/beach/sand{
	density = 1
	},
/area/beach)
"j" = (
/obj/structure/toilet{
	dir = 4
	},
/turf/simulated/floor/wood{
	icon_state = "wood-broken3";
	tag = "icon-wood-broken3"
	},
/area/beach)
"k" = (
/turf/simulated/floor/wood{
	icon_state = "wood-broken6"
	},
/area/beach)
"l" = (
/obj/structure/flora/rock/pile,
/turf/unsimulated/beach/sand,
/area/beach)
"m" = (
/obj/effect/overlay/coconut,
/turf/unsimulated/beach/sand,
/area/beach)
"n" = (
/turf/simulated/wall/mineral/wood/log,
/area/beach)
"o" = (
/obj/structure/flora/ausbushes/fullgrass,
/turf/unsimulated/beach/sand,
/area/beach)
"p" = (
/obj/structure/flora/ausbushes/fullgrass,
/obj/structure/flora/ausbushes/sparsegrass,
/turf/unsimulated/beach/sand,
/area/beach)
"s" = (
/obj/effect/overlay/palmtree_r,
/turf/unsimulated/beach/sand,
/area/beach)
"t" = (
/turf/simulated/floor/wood{
	icon_state = "wood-broken2"
	},
/area/beach)
"v" = (
/obj/effect/landmark{
	name = "endgame_exit"
	},
/turf/unsimulated/beach/sand,
/area/beach)
"w" = (
/turf/space,
/area)
"x" = (
/obj/structure/flora/rock,
/turf/unsimulated/beach/coastline{
	density = 1
	},
/area/beach)
"y" = (
/obj/structure/flora/rock,
/turf/unsimulated/beach/shallows,
/area/beach)
"z" = (
/obj/structure/flora/ausbushes/sparsegrass,
/turf/unsimulated/beach/sand,
/area/beach)
"A" = (
/obj/structure/flora/rock,
/turf/unsimulated/beach/sand,
/area/beach)
"B" = (
/obj/machinery/door/mineral/wood/log,
/turf/simulated/floor/wood,
/area/beach)
"C" = (
/obj/structure/flora/ausbushes,
/turf/unsimulated/beach/sand,
/area/beach)
"D" = (
/obj/item/weapon/storage/fancy/beer_box,
/turf/simulated/floor/wood,
/area/beach)
"G" = (
/obj/structure/flora/rock,
/turf/unsimulated/beach/water,
/area/beach)
"H" = (
/obj/item/clothing/under/shorts/red,
/turf/simulated/floor/wood,
/area/beach)
"I" = (
/turf/unsimulated/beach/water/deep,
/area/beach)
"K" = (
/obj/effect/overlay/palmtree_l,
/turf/unsimulated/beach/sand,
/area/beach)
"L" = (
/mob/living/simple_animal/crab{
	desc = "ARE YOU READY FOR THAT SLEEPOVER? FUCK YEAH YOU ARE!";
	icon_living = "Nicholson";
	icon_state = "Nicholson";
	name = "Crab Nicholson"
	},
/turf/simulated/floor/wood{
	icon_state = "wood-broken5"
	},
/area/beach)
"M" = (
/turf/simulated/floor/wood{
	icon_state = "wood-broken5"
	},
/area/beach)
"N" = (
/obj/structure/flora/rock,
/turf/simulated/floor/grass,
/area/beach)
"O" = (
/turf/unsimulated/beach/shallows,
/area/beach)
"P" = (
/turf/simulated/floor/wood{
	icon_state = "wood-broken"
	},
/area/beach)
"Q" = (
/obj/structure/reagent_dispensers/cauldron/barrel/wood,
/turf/unsimulated/beach/sand,
/area/beach)
"R" = (
/obj/machinery/shower{
	dir = 8;
	pixel_y = -6
	},
/turf/unsimulated/beach/sand,
/area/beach)
"S" = (
/mob/living/simple_animal/crab/Coffee,
/obj/structure/lattice/wood,
/turf/unsimulated/beach/sand,
/area/beach)
"T" = (
/obj/structure/flora/ausbushes/grassybush,
/turf/unsimulated/beach/sand,
/area/beach)
"U" = (
/obj/structure/bed/racecar/classic,
/obj/item/weapon/bedsheet/red,
/turf/simulated/floor/wood,
/area/beach)
"V" = (
/turf/unsimulated/beach/coastline{
	density = 1
	},
/area/beach)
"W" = (
/obj/structure/flora/ausbushes/fernybush,
/turf/unsimulated/beach/sand,
/area/beach)
"X" = (
/turf/unsimulated/beach/sand,
/area/beach)
"Y" = (
/turf/simulated/floor/wood,
/area/beach)

(1,1,1) = {"
w
w
w
w
w
w
w
w
w
w
w
w
w
w
w
w
w
w
w
w
w
w
w
w
w
w
w
w
w
w
w
w
w
w
w
w
w
w
w
w
w
w
w
w
w
w
w
w
w
w
w
"}
(2,1,1) = {"
w
w
w
w
w
w
w
w
w
w
w
w
w
w
w
w
w
w
w
w
w
w
w
w
w
w
w
w
w
w
w
w
w
w
w
w
w
w
w
w
w
w
w
w
w
w
w
w
w
w
w
"}
(3,1,1) = {"
w
w
w
w
w
w
w
w
w
w
w
w
w
w
w
w
w
w
w
w
w
w
w
w
w
w
w
w
w
w
w
w
w
w
w
w
w
w
w
w
w
w
w
w
w
w
w
w
w
w
w
"}
(4,1,1) = {"
w
w
w
w
w
w
w
w
w
w
w
w
w
w
w
w
w
w
w
w
w
w
w
w
w
w
w
w
w
w
w
w
w
w
w
w
w
w
w
w
w
w
w
w
w
w
w
w
w
w
w
"}
(5,1,1) = {"
w
w
w
w
w
w
w
w
w
w
w
w
w
w
w
w
w
w
w
w
w
w
w
w
w
w
w
w
w
w
w
w
w
w
w
w
w
w
w
w
w
w
w
w
w
w
w
w
w
w
w
"}
(6,1,1) = {"
w
w
w
w
w
w
w
w
w
w
w
w
w
w
w
w
w
w
w
w
w
w
w
w
w
w
w
w
w
w
w
w
w
w
w
w
w
w
w
w
w
w
w
w
w
w
w
w
w
w
w
"}
(7,1,1) = {"
w
w
w
w
w
w
w
w
w
w
w
w
w
w
w
w
w
w
w
w
w
w
w
w
w
w
w
w
w
w
w
w
w
w
w
w
w
w
w
w
w
w
w
w
w
w
w
w
w
w
w
"}
(8,1,1) = {"
w
w
w
w
w
w
w
w
w
w
w
w
w
w
w
w
w
w
w
w
w
w
w
w
w
w
w
w
w
w
w
w
w
w
w
w
w
w
w
w
w
w
w
w
w
w
w
w
w
w
w
"}
(9,1,1) = {"
w
w
w
w
w
w
w
w
w
w
w
w
w
w
w
w
w
w
w
w
w
w
w
w
w
w
w
w
w
w
w
w
w
w
w
w
w
w
w
w
w
w
w
w
w
w
w
w
w
w
w
"}
(10,1,1) = {"
w
w
w
w
w
w
w
w
w
w
w
w
w
w
w
w
w
w
w
w
w
w
w
w
w
w
w
w
w
w
w
w
w
w
w
w
w
w
w
w
w
w
w
w
w
w
w
w
w
w
w
"}
(11,1,1) = {"
w
w
w
w
w
w
w
w
w
w
w
w
w
w
w
w
w
w
w
w
w
w
w
w
w
w
w
w
w
w
w
w
w
w
w
w
w
w
w
w
w
w
w
w
w
w
w
w
w
w
w
"}
(12,1,1) = {"
w
w
w
w
w
w
w
w
w
w
w
w
w
w
w
w
w
w
w
w
w
w
w
w
w
w
w
w
w
w
w
w
w
w
w
w
w
w
w
w
w
w
w
w
w
w
w
w
w
w
w
"}
(13,1,1) = {"
w
w
w
w
w
w
w
w
w
w
w
w
g
g
g
g
g
g
g
g
g
g
g
g
g
g
g
a
V
c
c
c
c
c
c
c
c
c
c
w
w
w
w
w
w
w
w
w
w
w
w
"}
(14,1,1) = {"
w
w
w
w
w
w
w
w
w
w
w
w
g
X
T
X
T
X
X
X
X
X
X
X
X
X
X
a
V
O
f
f
f
I
I
I
I
I
c
w
w
w
w
w
w
w
w
w
w
w
w
"}
(15,1,1) = {"
w
w
w
w
w
w
w
w
w
w
w
w
g
K
X
T
o
T
X
X
X
X
X
X
X
X
X
a
V
O
f
f
f
I
I
I
I
I
c
w
w
w
w
w
w
w
w
w
w
w
w
"}
(16,1,1) = {"
w
w
w
w
w
w
w
w
w
w
w
w
g
X
X
X
X
X
X
X
X
X
X
X
X
X
X
a
V
O
f
f
f
I
I
I
I
I
c
w
w
w
w
w
w
w
w
w
w
w
w
"}
(17,1,1) = {"
w
w
w
w
w
w
w
w
w
w
w
w
g
X
X
s
X
K
X
X
X
X
X
X
X
X
a
V
O
O
f
f
f
I
I
I
I
I
c
w
w
w
w
w
w
w
w
w
w
w
w
"}
(18,1,1) = {"
w
w
w
w
w
w
w
w
w
w
w
w
g
X
X
X
X
X
X
X
X
X
X
X
X
X
a
V
O
y
G
f
f
I
I
I
I
I
c
w
w
w
w
w
w
w
w
w
w
w
w
"}
(19,1,1) = {"
w
w
w
w
w
w
w
w
w
w
w
w
g
X
K
X
X
X
s
X
X
X
X
X
X
X
a
V
O
O
f
f
f
I
I
I
I
I
c
w
w
w
w
w
w
w
w
w
w
w
w
"}
(20,1,1) = {"
w
w
w
w
w
w
w
w
w
w
w
w
g
X
X
X
m
X
X
X
X
X
X
X
X
X
a
V
O
O
f
f
f
I
I
I
I
I
c
w
w
w
w
w
w
w
w
w
w
w
w
"}
(21,1,1) = {"
w
w
w
w
w
w
w
w
w
w
w
w
g
X
A
X
X
X
X
X
X
X
X
X
X
a
V
O
O
O
f
f
f
I
I
I
I
I
c
w
w
w
w
w
w
w
w
w
w
w
w
"}
(22,1,1) = {"
w
w
w
w
w
w
w
w
w
w
w
w
g
X
X
s
X
X
X
X
X
X
X
X
X
a
x
O
O
O
f
f
f
I
I
I
I
I
c
w
w
w
w
w
w
w
w
w
w
w
w
"}
(23,1,1) = {"
w
w
w
w
w
w
w
w
w
w
w
w
g
X
X
X
X
X
K
X
X
X
X
X
X
a
V
O
O
O
f
f
f
I
I
I
I
I
c
w
w
w
w
w
w
w
w
w
w
w
w
"}
(24,1,1) = {"
w
w
w
w
w
w
w
w
w
w
w
w
g
K
X
X
X
X
X
X
v
v
v
X
X
a
V
O
O
O
f
f
f
I
I
I
I
I
c
w
w
w
w
w
w
w
w
w
w
w
w
"}
(25,1,1) = {"
w
w
w
w
w
w
w
w
w
w
w
w
g
X
X
T
X
X
X
X
v
v
v
X
X
a
V
O
O
O
f
f
f
I
I
I
I
I
c
w
w
w
w
w
w
w
w
w
w
w
w
"}
(26,1,1) = {"
w
w
w
w
w
w
w
w
w
w
w
w
g
X
X
X
W
X
m
X
v
v
v
X
X
a
V
O
O
O
f
f
f
I
I
I
I
I
c
w
w
w
w
w
w
w
w
w
w
w
w
"}
(27,1,1) = {"
w
w
w
w
w
w
w
w
w
w
w
w
g
X
X
X
K
X
X
X
X
X
X
X
X
a
V
O
O
O
f
f
f
I
I
I
I
I
c
w
w
w
w
w
w
w
w
w
w
w
w
"}
(28,1,1) = {"
w
w
w
w
w
w
w
w
w
w
w
w
g
s
X
X
X
X
X
X
X
X
X
X
X
a
V
O
O
O
f
f
f
I
I
I
I
I
c
w
w
w
w
w
w
w
w
w
w
w
w
"}
(29,1,1) = {"
w
w
w
w
w
w
w
w
w
w
w
w
g
K
X
X
X
X
z
X
X
X
X
X
X
a
V
O
O
O
f
f
f
I
I
I
I
I
c
w
w
w
w
w
w
w
w
w
w
w
w
"}
(30,1,1) = {"
w
w
w
w
w
w
w
w
w
w
w
w
g
K
X
X
X
X
X
X
X
X
X
X
X
a
V
O
O
O
f
f
f
I
I
I
I
I
c
w
w
w
w
w
w
w
w
w
w
w
w
"}
(31,1,1) = {"
w
w
w
w
w
w
w
w
w
w
w
w
g
K
X
X
X
X
X
X
X
m
X
X
X
a
V
O
O
O
f
f
f
I
I
I
I
I
c
w
w
w
w
w
w
w
w
w
w
w
w
"}
(32,1,1) = {"
w
w
w
w
w
w
w
w
w
w
w
w
g
K
X
X
X
X
K
X
X
X
X
X
X
a
V
O
O
O
f
f
f
I
I
I
I
I
c
w
w
w
w
w
w
w
w
w
w
w
w
"}
(33,1,1) = {"
w
w
w
w
w
w
w
w
w
w
w
w
g
K
X
X
X
X
X
X
X
X
X
X
X
a
V
O
O
O
f
f
f
I
I
I
I
I
c
w
w
w
w
w
w
w
w
w
w
w
w
"}
(34,1,1) = {"
w
w
w
w
w
w
w
w
w
w
w
w
g
s
X
C
X
l
R
X
Q
X
X
X
X
a
V
O
O
O
f
f
f
I
I
I
I
I
c
w
w
w
w
w
w
w
w
w
w
w
w
"}
(35,1,1) = {"
w
w
w
w
w
w
w
w
w
w
w
w
g
X
z
n
n
n
n
n
n
t
S
X
X
a
V
O
O
O
f
f
f
I
I
I
I
I
c
w
w
w
w
w
w
w
w
w
w
w
w
"}
(36,1,1) = {"
w
w
w
w
w
w
w
w
w
w
w
w
g
X
p
n
j
Y
Y
D
n
M
X
X
X
a
V
O
O
O
f
f
f
I
I
I
I
I
c
w
w
w
w
w
w
w
w
w
w
w
w
"}
(37,1,1) = {"
w
w
w
w
w
w
w
w
w
w
w
w
g
X
p
n
Y
Y
Y
Y
B
Y
X
X
X
a
V
O
O
O
f
f
f
I
I
I
I
I
c
w
w
w
w
w
w
w
w
w
w
w
w
"}
(38,1,1) = {"
w
w
w
w
w
w
w
w
w
w
w
w
g
X
z
n
Y
Y
L
Y
n
Y
X
X
X
a
V
O
O
O
f
f
f
I
I
I
I
I
c
w
w
w
w
w
w
w
w
w
w
w
w
"}
(39,1,1) = {"
w
w
w
w
w
w
w
w
w
w
w
w
g
X
p
n
k
U
H
Y
n
P
X
X
X
a
V
O
O
O
f
f
f
I
I
I
I
I
c
w
w
w
w
w
w
w
w
w
w
w
w
"}
(40,1,1) = {"
w
w
w
w
w
w
w
w
w
w
w
w
g
X
o
n
n
n
n
n
n
Y
X
X
X
a
V
O
O
O
f
f
f
I
I
I
I
I
c
w
w
w
w
w
w
w
w
w
w
w
w
"}
(41,1,1) = {"
w
w
w
w
w
w
w
w
w
w
w
w
g
X
X
X
X
X
X
X
X
X
X
X
X
a
V
O
O
O
f
f
f
I
I
I
I
I
c
w
w
w
w
w
w
w
w
w
w
w
w
"}
(42,1,1) = {"
w
w
w
w
w
w
w
w
w
w
w
w
g
s
X
X
X
X
X
X
X
X
X
X
X
a
V
O
O
O
f
f
f
I
I
I
I
I
c
w
w
w
w
w
w
w
w
w
w
w
w
"}
(43,1,1) = {"
w
w
w
w
w
w
w
w
w
w
w
w
g
s
X
X
X
X
X
X
X
X
X
X
X
a
V
O
O
O
f
f
f
I
I
I
I
I
c
w
w
w
w
w
w
w
w
w
w
w
w
"}
(44,1,1) = {"
w
w
w
w
w
w
w
w
w
w
w
w
g
s
X
X
X
X
X
X
X
X
X
X
X
a
V
O
O
O
f
f
f
I
e
I
I
I
c
w
w
w
w
w
w
w
w
w
w
w
w
"}
(45,1,1) = {"
w
w
w
w
w
w
w
w
w
w
w
w
g
s
X
X
X
m
X
X
X
X
X
X
X
a
V
O
O
O
f
f
f
I
I
I
I
I
c
w
w
w
w
w
w
w
w
w
w
w
w
"}
(46,1,1) = {"
w
w
w
w
w
w
w
w
w
w
w
w
g
X
X
X
X
X
X
X
X
X
X
X
X
a
V
O
O
O
f
f
f
I
I
I
I
I
c
w
w
w
w
w
w
w
w
w
w
w
w
"}
(47,1,1) = {"
w
w
w
w
w
w
w
w
w
w
w
w
g
X
X
X
X
K
X
X
X
s
X
X
X
a
V
O
O
O
f
f
f
I
I
I
I
I
c
w
w
w
w
w
w
w
w
w
w
w
w
"}
(48,1,1) = {"
w
w
w
w
w
w
w
w
w
w
w
w
g
X
X
X
X
X
X
m
X
X
X
X
X
a
V
O
O
O
f
f
f
I
I
I
I
I
c
w
w
w
w
w
w
w
w
w
w
w
w
"}
(49,1,1) = {"
w
w
w
w
w
w
w
w
w
w
w
w
g
X
X
W
X
X
X
X
X
X
X
X
A
a
V
O
O
O
f
f
f
I
I
I
I
I
c
w
w
w
w
w
w
w
w
w
w
w
w
"}
(50,1,1) = {"
w
w
w
w
w
w
w
w
w
w
w
w
g
X
X
T
X
W
X
X
X
X
X
X
X
A
N
x
y
y
f
f
f
I
I
I
I
I
c
w
w
w
w
w
w
w
w
w
w
w
w
"}
(51,1,1) = {"
w
w
w
w
w
w
w
w
w
w
w
w
g
X
X
X
X
X
X
X
X
X
X
X
X
A
N
V
O
O
f
f
f
I
I
I
I
I
c
w
w
w
w
w
w
w
w
w
w
w
w
"}
(52,1,1) = {"
w
w
w
w
w
w
w
w
w
w
w
w
g
X
T
X
T
X
X
X
K
X
X
X
X
X
a
V
O
O
f
f
f
I
I
I
I
I
c
w
w
w
w
w
w
w
w
w
w
w
w
"}
(53,1,1) = {"
w
w
w
w
w
w
w
w
w
w
w
w
g
X
K
T
X
X
X
X
X
X
X
X
X
X
X
a
V
O
f
f
f
I
I
I
I
I
c
w
w
w
w
w
w
w
w
w
w
w
w
"}
(54,1,1) = {"
w
w
w
w
w
w
w
w
w
w
w
w
g
X
X
X
T
s
X
X
X
X
X
X
X
X
X
a
V
O
f
f
f
I
I
I
I
I
c
w
w
w
w
w
w
w
w
w
w
w
w
"}
(55,1,1) = {"
w
w
w
w
w
w
w
w
w
w
w
w
g
X
X
X
X
X
X
X
X
X
X
X
X
X
X
a
V
O
f
f
f
I
I
I
I
I
c
w
w
w
w
w
w
w
w
w
w
w
w
"}
(56,1,1) = {"
w
w
w
w
w
w
w
w
w
w
w
w
g
X
X
X
X
X
X
X
X
X
X
X
X
X
X
a
V
O
f
f
f
I
I
I
I
I
c
w
w
w
w
w
w
w
w
w
w
w
w
"}
(57,1,1) = {"
w
w
w
w
w
w
w
w
w
w
w
w
g
X
X
X
X
X
X
X
X
X
X
X
X
X
X
a
V
O
f
f
f
I
I
I
I
I
c
w
w
w
w
w
w
w
w
w
w
w
w
"}
(58,1,1) = {"
w
w
w
w
w
w
w
w
w
w
w
w
g
g
g
g
g
g
g
g
g
g
g
g
g
g
g
b
V
c
c
c
c
c
c
c
c
c
c
w
w
w
w
w
w
w
w
w
w
w
w
"}
(59,1,1) = {"
w
w
w
w
w
w
w
w
w
w
w
w
w
w
w
w
w
w
w
w
w
w
w
w
w
w
w
w
w
w
w
w
w
w
w
w
w
w
w
w
w
w
w
w
w
w
w
w
w
w
w
"}
(60,1,1) = {"
w
w
w
w
w
w
w
w
w
w
w
w
w
w
w
w
w
w
w
w
w
w
w
w
w
w
w
w
w
w
w
w
w
w
w
w
w
w
w
w
w
w
w
w
w
w
w
w
w
w
w
"}
(61,1,1) = {"
w
w
w
w
w
w
w
w
w
w
w
w
w
w
w
w
w
w
w
w
w
w
w
w
w
w
w
w
w
w
w
w
w
w
w
w
w
w
w
w
w
w
w
w
w
w
w
w
w
w
w
"}
(62,1,1) = {"
w
w
w
w
w
w
w
w
w
w
w
w
w
w
w
w
w
w
w
w
w
w
w
w
w
w
w
w
w
w
w
w
w
w
w
w
w
w
w
w
w
w
w
w
w
w
w
w
w
w
w
"}
(63,1,1) = {"
w
w
w
w
w
w
w
w
w
w
w
w
w
w
w
w
w
w
w
w
w
w
w
w
w
w
w
w
w
w
w
w
w
w
w
w
w
w
w
w
w
w
w
w
w
w
w
w
w
w
w
"}
(64,1,1) = {"
w
w
w
w
w
w
w
w
w
w
w
w
w
w
w
w
w
w
w
w
w
w
w
w
w
w
w
w
w
w
w
w
w
w
w
w
w
w
w
w
w
w
w
w
w
w
w
w
w
w
w
"}
(65,1,1) = {"
w
w
w
w
w
w
w
w
w
w
w
w
w
w
w
w
w
w
w
w
w
w
w
w
w
w
w
w
w
w
w
w
w
w
w
w
w
w
w
w
w
w
w
w
w
w
w
w
w
w
w
"}
(66,1,1) = {"
w
w
w
w
w
w
w
w
w
w
w
w
w
w
w
w
w
w
w
w
w
w
w
w
w
w
w
w
w
w
w
w
w
w
w
w
w
w
w
w
w
w
w
w
w
w
w
w
w
w
w
"}
(67,1,1) = {"
w
w
w
w
w
w
w
w
w
w
w
w
w
w
w
w
w
w
w
w
w
w
w
w
w
w
w
w
w
w
w
w
w
w
w
w
w
w
w
w
w
w
w
w
w
w
w
w
w
w
w
"}
(68,1,1) = {"
w
w
w
w
w
w
w
w
w
w
w
w
w
w
w
w
w
w
w
w
w
w
w
w
w
w
w
w
w
w
w
w
w
w
w
w
w
w
w
w
w
w
w
w
w
w
w
w
w
w
w
"}
(69,1,1) = {"
w
w
w
w
w
w
w
w
w
w
w
w
w
w
w
w
w
w
w
w
w
w
w
w
w
w
w
w
w
w
w
w
w
w
w
w
w
w
w
w
w
w
w
w
w
w
w
w
w
w
w
"}
(70,1,1) = {"
w
w
w
w
w
w
w
w
w
w
w
w
w
w
w
w
w
w
w
w
w
w
w
w
w
w
w
w
w
w
w
w
w
w
w
w
w
w
w
w
w
w
w
w
w
w
w
w
w
w
w
"}
