//MAP CONVERTED BY dmm2tgm.py THIS HEADER COMMENT PREVENTS RECONVERSION, DO NOT REMOVE
"a" = (
/obj/structure/shuttle/engine/propulsion{
	color = "#4D3714"
	},
/obj/structure/shuttle/diag_wall/smooth{
	dir = 8;
	icon = 'icons/turf/voxprobe.dmi';
	icon_state = "voxcorner4"
	},
/turf/space,
/area/shuttle/tradeprobe)
"e" = (
/obj/machinery/vending/sale/trader/probe,
/turf/simulated/floor/shuttle/vox,
/area/shuttle/tradeprobe)
"u" = (
/turf/simulated/wall/shuttle/unsmoothed/vox,
/area/shuttle/tradeprobe)
"v" = (
/obj/structure/shuttle/engine/propulsion{
	color = "#4D3714";
	dir = 1
	},
/obj/structure/shuttle/diag_wall/smooth{
	dir = 8;
	icon = 'icons/turf/voxprobe.dmi';
	icon_state = "voxcorner2"
	},
/turf/space,
/area/shuttle/tradeprobe)
"F" = (
/obj/structure/window/full/reinforced/plasma/vox,
/turf/simulated/floor/light{
	icon_state = "light_base"
	},
/area/shuttle/tradeprobe)
"N" = (
/obj/structure/window/full/reinforced/plasma/vox{
	dir = 4
	},
/turf/simulated/floor/light{
	icon_state = "light_base"
	},
/area/shuttle/tradeprobe)
"O" = (
/obj/structure/shuttle/engine/propulsion{
	color = "#4D3714";
	dir = 1
	},
/obj/structure/shuttle/diag_wall/smooth{
	color = null;
	dir = 8;
	icon = 'icons/turf/voxprobe.dmi';
	icon_state = "voxcorner1"
	},
/turf/space,
/area/shuttle/tradeprobe)
"R" = (
/turf/simulated/floor/shuttle/vox,
/area/shuttle/tradeprobe)
"S" = (
/obj/structure/window/full/reinforced/plasma/vox{
	dir = 8
	},
/turf/simulated/floor/light{
	icon_state = "light_base"
	},
/area/shuttle/tradeprobe)
"U" = (
/obj/structure/shuttle/engine/propulsion{
	color = "#4D3714"
	},
/obj/structure/shuttle/diag_wall/smooth{
	dir = 8;
	icon = 'icons/turf/voxprobe.dmi';
	icon_state = "voxcorner3"
	},
/turf/space,
/area/shuttle/tradeprobe)
"X" = (
/obj/structure/airshield/voxprobe,
/obj/docking_port/shuttle,
/turf/simulated/floor/light{
	icon_state = "light_base"
	},
/area/shuttle/tradeprobe)

(1,1,1) = {"
O
u
N
u
a
"}
(2,1,1) = {"
u
R
R
R
u
"}
(3,1,1) = {"
X
R
e
R
F
"}
(4,1,1) = {"
u
R
R
R
u
"}
(5,1,1) = {"
v
u
S
u
U
"}
