//MAP CONVERTED BY dmm2tgm.py THIS HEADER COMMENT PREVENTS RECONVERSION, DO NOT REMOVE
"a" = (
/turf/space/void,
/area)
"b" = (
/obj/machinery/door/mineral/wood{
	name = "Wooden Door"
	},
/turf/unsimulated/floor{
	icon_state = "cult";
	tag = "icon-cult"
	},
/area/wizard_station)
"d" = (
/obj/machinery/vending/magivend,
/turf/unsimulated/floor{
	icon_state = "cult";
	tag = "icon-cult"
	},
/area/wizard_station)
"e" = (
/obj/effect/decal/cleanable/blood,
/turf/unsimulated/floor{
	icon_state = "cult";
	tag = "icon-cult"
	},
/area/wizard_station)
"f" = (
/obj/structure/bed,
/obj/item/weapon/bedsheet/black,
/turf/unsimulated/floor{
	icon_state = "cult";
	tag = "icon-cult"
	},
/area/wizard_station)
"g" = (
/turf/unsimulated/floor{
	icon_state = "cult";
	tag = "icon-cult"
	},
/area/wizard_station)
"h" = (
/obj/structure/bed/chair/wood/normal{
	dir = 4
	},
/turf/unsimulated/floor{
	icon_state = "cult";
	tag = "icon-cult"
	},
/area/wizard_station)
"i" = (
/turf/unsimulated/floor{
	icon_state = "cultdamage3";
	tag = "icon-cultdamage3"
	},
/area/wizard_station)
"k" = (
/obj/structure/cult/pylon,
/turf/unsimulated/floor{
	icon_state = "cult";
	tag = "icon-cult"
	},
/area/wizard_station)
"l" = (
/obj/structure/grille/cult,
/turf/unsimulated/floor{
	icon_state = "cult";
	tag = "icon-cult"
	},
/area/wizard_station)
"m" = (
/obj/effect/decal/cleanable/wizrune,
/turf/unsimulated/floor{
	icon_state = "cult";
	tag = "icon-cult"
	},
/area/wizard_station)
"n" = (
/obj/structure/wizard/scrying,
/turf/unsimulated/floor{
	icon_state = "cult";
	tag = "icon-cult"
	},
/area/wizard_station)
"o" = (
/obj/structure/table/woodentable,
/obj/item/weapon/storage/pill_bottle/dice,
/turf/unsimulated/floor{
	icon_state = "cult";
	tag = "icon-cult"
	},
/area/wizard_station)
"q" = (
/obj/effect/forcefield,
/turf/unsimulated/floor{
	icon_state = "cult";
	tag = "icon-cult"
	},
/area)
"s" = (
/obj/effect/landmark/start{
	name = "wizard"
	},
/turf/unsimulated/floor{
	icon_state = "cult";
	tag = "icon-cult"
	},
/area/wizard_station)
"u" = (
/obj/effect/landmark/start{
	name = "wizard"
	},
/obj/structure/mirror/magic{
	pixel_y = 28
	},
/turf/unsimulated/floor{
	icon_state = "cult";
	tag = "icon-cult"
	},
/area/wizard_station)
"v" = (
/obj/structure/closet/cabinet,
/obj/item/weapon/storage/wallet,
/turf/unsimulated/floor{
	icon_state = "cult";
	tag = "icon-cult"
	},
/area/wizard_station)
"y" = (
/obj/structure/table/woodentable,
/turf/unsimulated/floor{
	icon_state = "cult";
	tag = "icon-cult"
	},
/area/wizard_station)
"C" = (
/obj/structure/cult_legacy/tome,
/turf/unsimulated/floor{
	icon_state = "cult";
	tag = "icon-cult"
	},
/area/wizard_station)
"E" = (
/obj/effect/decal/remains/human,
/turf/unsimulated/floor{
	icon_state = "cult";
	tag = "icon-cult"
	},
/area/wizard_station)
"H" = (
/obj/structure/closet/cabinet,
/turf/unsimulated/floor{
	icon_state = "cult";
	tag = "icon-cult"
	},
/area/wizard_station)
"J" = (
/turf/unsimulated/floor{
	icon_state = "cultdamage7";
	tag = "icon-cultdamage7"
	},
/area/wizard_station)
"K" = (
/obj/effect/step_trigger/teleporter/random{
	affect_ghosts = 1;
	name = "escapeshuttle_leave";
	teleport_x = 25;
	teleport_x_offset = 245;
	teleport_y = 25;
	teleport_y_offset = 245;
	teleport_z = 6;
	teleport_z_offset = 6
	},
/turf/space/void,
/area)
"L" = (
/obj/structure/table/woodentable,
/obj/item/weapon/storage/bag/wiz_cards/full,
/turf/unsimulated/floor{
	icon_state = "cult";
	tag = "icon-cult"
	},
/area/wizard_station)
"M" = (
/obj/structure/mannequin/cult,
/turf/unsimulated/floor{
	icon_state = "cult";
	tag = "icon-cult"
	},
/area/wizard_station)
"O" = (
/obj/structure/bookcase{
	name = "Forbidden Knowledge"
	},
/turf/unsimulated/floor{
	icon_state = "cult";
	tag = "icon-cult"
	},
/area/wizard_station)
"P" = (
/obj/structure/bed/chair/wood/normal{
	dir = 8
	},
/turf/unsimulated/floor{
	icon_state = "cult";
	tag = "icon-cult"
	},
/area/wizard_station)
"R" = (
/obj/structure/wizard/altar,
/obj/item/weapon/kitchen/utensil/knife/large/ritual,
/turf/unsimulated/floor{
	icon_state = "cult";
	tag = "icon-cult"
	},
/area/wizard_station)
"U" = (
/turf/unsimulated/floor{
	icon_state = "cultdamage";
	tag = "icon-cultdamage"
	},
/area/wizard_station)
"V" = (
/obj/effect/forcefield{
	alpha = 0;
	name = "invisible force wall"
	},
/turf/space/void,
/area)
"W" = (
/mob/living/simple_animal/hostile/creature{
	name = "Experiment 35b"
	},
/turf/unsimulated/floor{
	icon_state = "cult";
	tag = "icon-cult"
	},
/area/wizard_station)
"X" = (
/turf/unsimulated/wall/cult,
/area/wizard_station)
"Z" = (
/obj/structure/table/woodentable,
/obj/item/toy/cards,
/turf/unsimulated/floor{
	icon_state = "cult";
	tag = "icon-cult"
	},
/area/wizard_station)

(1,1,1) = {"
a
a
a
a
a
a
a
a
a
a
a
a
a
a
a
a
a
a
a
a
a
a
a
a
a
a
a
a
a
a
a
a
a
a
a
a
a
a
a
a
a
a
a
a
a
a
a
a
a
"}
(2,1,1) = {"
a
a
a
a
a
a
a
a
a
a
a
a
a
a
a
a
a
a
a
a
a
a
a
a
a
a
a
a
a
a
a
a
a
a
a
a
a
a
a
a
a
a
a
a
a
a
a
a
a
"}
(3,1,1) = {"
a
a
a
a
a
a
a
a
a
a
a
a
a
a
a
a
a
a
a
a
a
a
a
a
a
a
a
a
a
a
a
a
a
a
a
a
a
a
a
a
a
a
a
a
a
a
a
a
a
"}
(4,1,1) = {"
a
a
a
a
a
a
a
a
a
a
a
a
a
a
a
a
a
a
a
a
a
a
a
a
a
a
a
a
a
a
a
a
a
a
a
a
a
a
a
a
a
a
a
a
a
a
a
a
a
"}
(5,1,1) = {"
a
a
a
a
a
a
a
a
a
a
a
a
a
a
a
a
a
a
a
a
a
a
a
a
a
a
a
a
a
a
a
a
a
a
a
a
a
a
a
a
a
a
a
a
a
a
a
a
a
"}
(6,1,1) = {"
a
a
a
a
a
a
a
a
a
a
a
a
a
a
a
a
a
a
a
a
a
a
a
a
a
a
a
a
a
a
a
a
a
a
a
a
a
a
a
a
a
a
a
a
a
a
a
a
a
"}
(7,1,1) = {"
a
a
a
a
a
a
a
a
a
a
a
a
a
a
a
a
a
a
a
a
a
a
a
a
a
a
a
a
a
a
a
a
a
a
a
a
a
a
a
a
a
a
a
a
a
a
a
a
a
"}
(8,1,1) = {"
a
a
a
a
a
a
a
a
K
K
K
K
K
K
K
K
K
K
K
K
K
K
K
K
K
K
K
K
K
K
K
K
K
K
K
K
K
K
K
K
K
K
a
a
a
a
a
a
a
"}
(9,1,1) = {"
a
a
a
a
a
a
a
a
K
a
a
a
a
a
a
a
a
a
a
a
a
V
V
V
V
V
V
V
a
a
a
a
a
a
a
a
a
a
a
a
a
K
a
a
a
a
a
a
a
"}
(10,1,1) = {"
a
a
a
a
a
a
a
a
K
a
a
a
a
a
a
a
a
a
a
a
a
V
X
X
X
X
X
V
a
a
a
a
a
a
a
a
a
a
a
a
a
K
a
a
a
a
a
a
a
"}
(11,1,1) = {"
a
a
a
a
a
a
a
a
K
a
a
a
a
a
a
a
a
a
a
a
a
V
X
f
s
d
X
V
a
a
a
a
a
a
a
a
a
a
a
a
a
K
a
a
a
a
a
a
a
"}
(12,1,1) = {"
a
a
a
a
a
a
a
a
K
a
a
a
a
a
a
a
a
a
a
a
a
V
X
u
s
s
X
V
a
a
a
a
a
a
a
a
a
a
a
a
a
K
a
a
a
a
a
a
a
"}
(13,1,1) = {"
a
a
a
a
a
a
a
a
K
a
a
a
a
a
a
a
a
a
a
a
a
V
X
v
g
y
X
V
a
a
a
a
a
a
a
a
a
a
a
a
a
K
a
a
a
a
a
a
a
"}
(14,1,1) = {"
a
a
a
a
a
a
a
a
K
a
a
a
a
a
a
a
a
a
a
a
a
V
X
X
b
X
X
V
a
a
a
a
a
a
a
a
a
a
a
a
a
K
a
a
a
a
a
a
a
"}
(15,1,1) = {"
a
a
a
a
a
a
a
a
K
a
a
a
a
a
a
a
a
a
a
V
V
V
g
g
g
g
g
V
V
V
a
a
a
a
a
a
a
a
a
a
a
K
a
a
a
a
a
a
a
"}
(16,1,1) = {"
a
a
a
a
a
a
a
a
K
a
a
a
a
a
a
a
a
a
V
V
k
g
g
g
g
g
g
g
k
V
V
a
a
a
a
a
a
a
a
a
a
K
a
a
a
a
a
a
a
"}
(17,1,1) = {"
a
a
a
a
a
a
a
a
K
a
a
a
a
a
a
a
a
V
V
g
g
g
g
g
g
g
g
g
g
g
V
V
a
a
a
a
a
a
a
a
a
K
a
a
a
a
a
a
a
"}
(18,1,1) = {"
a
a
a
a
a
a
a
a
K
a
a
a
a
a
a
a
V
V
g
g
g
g
g
V
m
V
g
g
g
g
g
V
V
a
a
a
a
a
a
a
a
K
a
a
a
a
a
a
a
"}
(19,1,1) = {"
a
a
a
a
a
a
a
a
K
V
V
V
V
V
V
V
V
k
g
g
g
g
g
V
V
V
g
g
g
g
g
k
V
V
V
V
V
V
V
V
V
K
a
a
a
a
a
a
a
"}
(20,1,1) = {"
a
a
a
a
a
a
a
a
K
a
l
l
l
l
l
l
l
g
g
g
g
g
V
V
V
V
V
g
g
g
g
g
V
X
X
X
X
X
X
X
V
K
a
a
a
a
a
a
a
"}
(21,1,1) = {"
a
a
a
a
a
a
a
a
K
a
l
g
g
g
g
g
l
g
g
g
g
V
q
q
q
q
q
V
g
g
g
g
g
X
H
g
g
g
g
l
V
K
a
a
a
a
a
a
a
"}
(22,1,1) = {"
a
a
a
a
a
a
a
a
K
a
l
g
h
h
h
g
l
g
g
V
V
V
q
E
U
e
q
V
V
V
g
g
g
X
C
g
g
g
g
l
V
K
a
a
a
a
a
a
a
"}
(23,1,1) = {"
a
a
a
a
a
a
a
a
K
a
l
g
o
Z
L
g
b
g
g
m
V
V
q
J
W
i
q
V
V
m
g
g
g
b
g
g
R
g
M
l
V
K
a
a
a
a
a
a
a
"}
(24,1,1) = {"
a
a
a
a
a
a
a
a
K
a
l
g
P
P
P
g
l
g
g
V
V
V
q
g
g
g
q
V
V
V
g
g
g
X
y
g
g
g
g
l
V
K
a
a
a
a
a
a
a
"}
(25,1,1) = {"
a
a
a
a
a
a
a
a
K
a
l
g
g
g
g
g
l
g
g
g
g
V
q
q
q
q
q
V
g
g
g
g
g
X
O
g
g
g
g
l
V
K
a
a
a
a
a
a
a
"}
(26,1,1) = {"
a
a
a
a
a
a
a
a
K
a
l
l
l
l
l
l
l
g
g
g
g
g
V
V
V
V
V
g
g
g
g
g
V
X
X
X
X
X
X
X
V
K
a
a
a
a
a
a
a
"}
(27,1,1) = {"
a
a
a
a
a
a
a
a
K
V
V
V
V
V
V
V
V
k
g
g
g
g
g
V
V
V
g
g
g
g
g
k
V
V
V
V
V
V
V
V
V
K
a
a
a
a
a
a
a
"}
(28,1,1) = {"
a
a
a
a
a
a
a
a
K
a
a
a
a
a
a
a
V
V
g
g
g
g
g
V
m
V
g
g
g
g
g
V
V
a
a
a
a
a
a
a
a
K
a
a
a
a
a
a
a
"}
(29,1,1) = {"
a
a
a
a
a
a
a
a
K
a
a
a
a
a
a
a
a
V
V
g
g
g
g
g
g
g
g
g
g
g
V
V
a
a
a
a
a
a
a
a
a
K
a
a
a
a
a
a
a
"}
(30,1,1) = {"
a
a
a
a
a
a
a
a
K
a
a
a
a
a
a
a
a
a
V
V
k
g
g
g
g
g
g
g
k
V
V
a
a
a
a
a
a
a
a
a
a
K
a
a
a
a
a
a
a
"}
(31,1,1) = {"
a
a
a
a
a
a
a
a
K
a
a
a
a
a
a
a
a
a
a
V
V
V
g
g
g
g
g
V
V
V
a
a
a
a
a
a
a
a
a
a
a
K
a
a
a
a
a
a
a
"}
(32,1,1) = {"
a
a
a
a
a
a
a
a
K
a
a
a
a
a
a
a
a
a
a
a
a
V
V
V
g
V
V
V
a
a
a
a
a
a
a
a
a
a
a
a
a
K
a
a
a
a
a
a
a
"}
(33,1,1) = {"
a
a
a
a
a
a
a
a
K
a
a
a
a
a
a
a
a
a
a
a
a
a
V
g
g
g
V
a
a
a
a
a
a
a
a
a
a
a
a
a
a
K
a
a
a
a
a
a
a
"}
(34,1,1) = {"
a
a
a
a
a
a
a
a
K
a
a
a
a
a
a
a
a
a
a
a
a
a
V
g
n
g
V
a
a
a
a
a
a
a
a
a
a
a
a
a
a
K
a
a
a
a
a
a
a
"}
(35,1,1) = {"
a
a
a
a
a
a
a
a
K
a
a
a
a
a
a
a
a
a
a
a
a
a
V
g
g
g
V
a
a
a
a
a
a
a
a
a
a
a
a
a
a
K
a
a
a
a
a
a
a
"}
(36,1,1) = {"
a
a
a
a
a
a
a
a
K
a
a
a
a
a
a
a
a
a
a
a
a
a
V
V
V
V
V
a
a
a
a
a
a
a
a
a
a
a
a
a
a
K
a
a
a
a
a
a
a
"}
(37,1,1) = {"
a
a
a
a
a
a
a
a
K
K
K
K
K
K
K
K
K
K
K
K
K
K
K
K
K
K
K
K
K
K
K
K
K
K
K
K
K
K
K
K
K
K
a
a
a
a
a
a
a
"}
(38,1,1) = {"
a
a
a
a
a
a
a
a
a
a
a
a
a
a
a
a
a
a
a
a
a
a
a
a
a
a
a
a
a
a
a
a
a
a
a
a
a
a
a
a
a
a
a
a
a
a
a
a
a
"}
(39,1,1) = {"
a
a
a
a
a
a
a
a
a
a
a
a
a
a
a
a
a
a
a
a
a
a
a
a
a
a
a
a
a
a
a
a
a
a
a
a
a
a
a
a
a
a
a
a
a
a
a
a
a
"}
(40,1,1) = {"
a
a
a
a
a
a
a
a
a
a
a
a
a
a
a
a
a
a
a
a
a
a
a
a
a
a
a
a
a
a
a
a
a
a
a
a
a
a
a
a
a
a
a
a
a
a
a
a
a
"}
(41,1,1) = {"
a
a
a
a
a
a
a
a
a
a
a
a
a
a
a
a
a
a
a
a
a
a
a
a
a
a
a
a
a
a
a
a
a
a
a
a
a
a
a
a
a
a
a
a
a
a
a
a
a
"}
(42,1,1) = {"
a
a
a
a
a
a
a
a
a
a
a
a
a
a
a
a
a
a
a
a
a
a
a
a
a
a
a
a
a
a
a
a
a
a
a
a
a
a
a
a
a
a
a
a
a
a
a
a
a
"}
(43,1,1) = {"
a
a
a
a
a
a
a
a
a
a
a
a
a
a
a
a
a
a
a
a
a
a
a
a
a
a
a
a
a
a
a
a
a
a
a
a
a
a
a
a
a
a
a
a
a
a
a
a
a
"}
(44,1,1) = {"
a
a
a
a
a
a
a
a
a
a
a
a
a
a
a
a
a
a
a
a
a
a
a
a
a
a
a
a
a
a
a
a
a
a
a
a
a
a
a
a
a
a
a
a
a
a
a
a
a
"}
