//MAP CONVERTED BY dmm2tgm.py THIS HEADER COMMENT PREVENTS RECONVERSION, DO NOT REMOVE
"a" = (
/turf/unsimulated/wall/other,
/area/vault/sokoban/level)
"b" = (
/turf/unsimulated/wall/bomberman{
	color = "#CCFFFF"
	},
/area/vault/sokoban/level)
"c" = (
/obj/structure/ladder/sokoban/entrance,
/turf/simulated/floor{
	icon_state = "whitebluefull"
	},
/area/vault/sokoban/level)
"d" = (
/turf/simulated/floor{
	icon_state = "whitebluefull"
	},
/area/vault/sokoban/level)
"e" = (
/obj/structure/sokoban_teleporter,
/turf/simulated/floor{
	icon_state = "whitebluefull"
	},
/area/vault/sokoban/level)
"f" = (
/obj/structure/closet/crate/sokoban,
/turf/simulated/floor{
	icon_state = "whitebluefull"
	},
/area/vault/sokoban/level)
"g" = (
/obj/item/clothing/suit/armor/laserproof/advanced,
/turf/simulated/floor,
/area/vault/sokoban/level)
"h" = (
/obj/machinery/door/airlock/freezer,
/turf/simulated/floor,
/area/vault/sokoban/level)
"i" = (
/mob/living/simple_animal/hostile/hivebot,
/turf/simulated/floor{
	icon_state = "whitebluefull"
	},
/area/vault/sokoban/level)
"j" = (
/obj/machinery/door/airlock/freezer,
/turf/simulated/floor{
	icon_state = "whitebluefull"
	},
/area/vault/sokoban/level)

(1,1,1) = {"
a
a
a
a
a
a
a
a
a
a
a
a
a
a
a
a
a
a
a
a
"}
(2,1,1) = {"
a
b
b
b
b
b
b
b
b
b
b
b
b
b
b
b
b
b
b
a
"}
(3,1,1) = {"
a
b
c
d
b
b
b
b
d
d
b
b
b
b
b
d
d
d
b
a
"}
(4,1,1) = {"
a
b
d
d
b
d
d
b
d
d
b
d
d
d
b
d
d
d
b
a
"}
(5,1,1) = {"
a
b
d
d
b
d
f
b
d
d
b
d
d
f
b
f
d
d
b
a
"}
(6,1,1) = {"
a
b
d
d
b
d
d
b
f
f
b
f
d
d
b
d
d
b
b
a
"}
(7,1,1) = {"
a
b
d
d
b
d
f
b
d
d
d
d
d
f
b
d
d
b
b
a
"}
(8,1,1) = {"
a
b
d
d
b
d
d
b
f
d
b
f
d
d
b
d
d
b
b
a
"}
(9,1,1) = {"
a
b
d
d
d
d
f
b
d
d
b
d
f
d
d
d
d
b
b
a
"}
(10,1,1) = {"
a
b
e
b
b
d
d
d
d
d
b
f
d
d
b
d
d
b
b
a
"}
(11,1,1) = {"
a
b
e
b
b
d
f
b
f
d
b
d
d
f
b
b
b
b
b
a
"}
(12,1,1) = {"
a
b
e
b
b
d
d
b
d
d
b
d
d
d
b
b
b
b
b
a
"}
(13,1,1) = {"
a
b
e
b
b
d
f
b
f
d
b
d
d
b
b
b
b
b
b
a
"}
(14,1,1) = {"
a
b
e
b
b
d
d
b
d
d
b
b
b
b
b
b
b
b
b
a
"}
(15,1,1) = {"
a
b
e
b
b
b
b
b
b
b
b
b
a
a
a
a
a
a
a
a
"}
(16,1,1) = {"
a
b
e
b
b
b
b
b
b
b
b
a
a
a
g
a
a
a
a
a
"}
(17,1,1) = {"
a
b
e
b
b
b
b
b
b
b
a
a
a
a
h
a
a
a
a
a
"}
(18,1,1) = {"
a
b
e
b
b
b
b
b
b
a
a
i
d
i
d
i
d
i
a
a
"}
(19,1,1) = {"
a
b
e
b
b
b
b
b
a
a
a
d
d
d
d
d
d
d
a
a
"}
(20,1,1) = {"
a
b
e
b
b
b
b
a
a
a
a
i
d
i
d
i
d
i
a
a
"}
(21,1,1) = {"
a
b
e
b
b
b
a
a
a
a
a
d
d
d
d
d
d
d
a
a
"}
(22,1,1) = {"
a
b
e
b
b
a
a
a
a
a
a
i
d
i
d
i
d
i
a
a
"}
(23,1,1) = {"
a
b
e
b
a
a
a
a
a
a
a
d
d
d
d
d
d
d
a
a
"}
(24,1,1) = {"
a
b
e
a
a
a
a
a
a
a
a
i
d
i
d
i
d
i
a
a
"}
(25,1,1) = {"
a
a
e
a
a
a
a
a
a
a
a
a
a
a
j
a
a
a
a
a
"}
(26,1,1) = {"
a
a
d
d
d
d
d
d
d
d
d
d
d
d
d
a
a
a
a
a
"}
(27,1,1) = {"
a
a
a
a
a
a
a
a
a
a
a
a
a
a
a
a
a
a
a
a
"}
