//MAP CONVERTED BY dmm2tgm.py THIS HEADER COMMENT PREVENTS RECONVERSION, DO NOT REMOVE
"a" = (
/obj/item/clothing/suit/armor/laserproof/advanced,
/turf/simulated/floor,
/area/vault/sokoban/level)
"b" = (
/turf/unsimulated/wall/bomberman{
	color = "#CCFFFF"
	},
/area/vault/sokoban/level)
"c" = (
/turf/simulated/floor{
	icon_state = "whitebluefull"
	},
/area/vault/sokoban/level)
"d" = (
/obj/structure/sokoban_teleporter,
/turf/simulated/floor{
	icon_state = "whitebluefull"
	},
/area/vault/sokoban/level)
"e" = (
/obj/structure/closet/crate/sokoban,
/turf/simulated/floor{
	icon_state = "whitebluefull"
	},
/area/vault/sokoban/level)
"f" = (
/obj/structure/ladder/sokoban/entrance,
/turf/simulated/floor{
	icon_state = "whitebluefull"
	},
/area/vault/sokoban/level)
"g" = (
/turf/unsimulated/wall/other,
/area/vault/sokoban/level)
"h" = (
/obj/machinery/door/airlock/freezer,
/turf/simulated/floor,
/area/vault/sokoban/level)
"i" = (
/obj/machinery/door/airlock/freezer,
/turf/simulated/floor{
	icon_state = "whitebluefull"
	},
/area/vault/sokoban/level)
"j" = (
/mob/living/simple_animal/hostile/hivebot,
/turf/simulated/floor{
	icon_state = "whitebluefull"
	},
/area/vault/sokoban/level)

(1,1,1) = {"
g
g
g
g
g
g
g
g
g
g
g
g
g
g
g
g
g
g
g
"}
(2,1,1) = {"
g
b
b
b
b
b
b
b
b
b
b
b
b
b
b
b
b
b
g
"}
(3,1,1) = {"
g
b
b
b
b
c
c
c
b
b
b
b
b
b
b
b
b
b
g
"}
(4,1,1) = {"
g
b
b
b
b
c
c
e
c
e
c
c
c
b
b
b
b
b
g
"}
(5,1,1) = {"
g
b
c
c
b
b
c
e
c
c
e
e
c
b
b
b
b
b
g
"}
(6,1,1) = {"
g
b
c
c
c
e
c
c
e
c
e
c
c
b
b
b
b
b
g
"}
(7,1,1) = {"
g
b
d
b
b
b
c
c
e
e
c
e
c
c
b
b
b
b
g
"}
(8,1,1) = {"
g
b
d
b
b
b
b
b
b
c
b
b
c
e
b
c
f
b
g
"}
(9,1,1) = {"
g
b
d
b
b
b
b
c
c
c
c
b
c
c
c
e
c
b
g
"}
(10,1,1) = {"
g
b
d
b
b
b
b
c
c
c
c
b
c
c
b
c
b
b
g
"}
(11,1,1) = {"
g
b
d
b
b
b
b
b
c
b
b
b
b
b
b
c
c
b
g
"}
(12,1,1) = {"
g
b
d
b
b
b
c
c
e
e
c
c
c
c
c
c
c
b
g
"}
(13,1,1) = {"
g
b
d
b
b
c
e
c
e
c
c
e
c
b
b
b
b
b
g
"}
(14,1,1) = {"
g
b
d
b
b
c
c
e
c
c
e
c
b
b
b
b
b
b
g
"}
(15,1,1) = {"
g
b
d
b
b
c
c
c
b
b
b
b
b
b
b
b
b
b
g
"}
(16,1,1) = {"
g
b
d
b
b
b
b
b
b
b
b
b
b
b
b
b
b
b
g
"}
(17,1,1) = {"
g
b
d
b
b
b
b
b
b
g
g
g
g
g
g
g
g
g
g
"}
(18,1,1) = {"
g
b
d
b
b
b
b
b
g
g
g
g
g
a
g
g
g
g
g
"}
(19,1,1) = {"
g
b
d
b
b
b
b
g
g
g
g
g
g
h
g
g
g
g
g
"}
(20,1,1) = {"
g
b
d
b
b
b
g
g
g
g
j
c
j
c
j
c
j
g
g
"}
(21,1,1) = {"
g
b
d
b
b
g
g
g
g
g
j
c
j
c
j
c
j
g
g
"}
(22,1,1) = {"
g
b
d
b
g
g
g
g
g
g
j
c
j
c
j
c
j
g
g
"}
(23,1,1) = {"
g
g
d
g
g
g
g
g
g
g
c
c
c
c
c
c
c
g
g
"}
(24,1,1) = {"
g
g
d
g
g
g
g
g
g
g
j
c
j
c
j
c
j
g
g
"}
(25,1,1) = {"
g
g
c
g
g
g
g
g
g
g
g
g
g
i
g
g
g
g
g
"}
(26,1,1) = {"
g
g
c
c
c
c
c
c
c
c
c
c
c
c
g
g
g
g
g
"}
(27,1,1) = {"
g
g
g
g
g
g
g
g
g
g
g
g
g
g
g
g
g
g
g
"}
