//MAP CONVERTED BY dmm2tgm.py THIS HEADER COMMENT PREVENTS RECONVERSION, DO NOT REMOVE
"a" = (
/turf/unsimulated/mineral/random,
/area/mine/unexplored)
"q" = (
/turf/unsimulated/mineral/random/high_chance_clown,
/area/mine/unexplored)
"s" = (
/obj/structure/lattice,
/turf/space,
/area)
"t" = (
/obj/effect/landmark/spacepod/random,
/turf/space,
/area)
"v" = (
/turf/unsimulated/mineral/random/high_chance,
/area/mine/unexplored)
"L" = (
/turf/space,
/area)
"N" = (
/turf/unsimulated/mineral/random,
/area/mine/explored)
"V" = (
/turf/unsimulated/floor/asteroid,
/area/mine/explored)

(1,1,1) = {"
L
L
L
L
L
L
L
L
L
L
L
L
L
L
L
L
L
L
L
L
L
L
L
L
L
L
L
L
L
L
L
L
L
L
L
L
L
L
L
L
L
L
L
L
L
L
L
L
L
L
L
L
L
L
L
L
L
L
L
L
L
L
L
L
L
L
L
L
L
L
L
L
L
L
L
a
a
a
a
a
a
a
N
N
V
V
V
V
V
V
L
L
L
L
V
V
N
a
a
a
a
a
L
s
L
L
L
L
L
L
L
L
L
L
L
L
L
L
L
L
L
"}
(2,1,1) = {"
L
L
L
L
L
L
L
L
L
L
L
L
L
L
L
L
L
L
L
L
L
L
L
L
L
L
L
L
L
L
L
L
L
L
L
L
L
L
L
L
L
L
L
L
L
L
L
L
L
L
L
L
L
L
L
L
L
L
L
L
L
L
L
L
L
L
L
L
L
L
L
L
a
a
a
a
a
a
a
a
a
a
a
N
V
V
V
V
V
V
V
V
V
V
V
V
V
N
a
a
a
a
a
a
a
L
L
L
L
L
L
L
L
L
L
L
L
L
L
L
L
"}
(3,1,1) = {"
L
L
L
L
L
L
L
L
L
L
L
L
L
L
L
L
L
L
L
L
L
L
L
L
L
L
L
L
L
L
L
L
L
L
L
L
L
L
L
L
L
L
L
L
L
L
L
L
L
L
L
L
L
L
L
L
L
L
L
L
L
L
L
L
L
L
L
L
L
L
L
a
a
a
a
a
a
a
a
a
a
a
a
N
V
V
V
V
V
V
V
V
V
V
V
V
V
N
a
a
a
a
a
a
a
a
a
L
L
L
L
L
L
L
L
L
L
L
L
L
L
"}
(4,1,1) = {"
L
L
L
L
L
L
L
L
L
L
L
L
L
L
L
L
L
L
L
L
L
L
L
L
L
L
L
L
L
L
L
L
L
L
L
L
L
L
L
L
L
L
L
L
L
L
L
L
L
L
L
L
L
L
L
L
L
L
L
L
L
L
L
L
L
L
L
L
L
L
a
a
a
a
a
a
a
a
a
a
a
a
a
N
V
V
V
V
a
a
a
a
a
V
V
V
V
V
N
a
a
a
a
a
a
a
a
a
L
L
L
L
L
L
L
L
L
L
L
L
L
"}
(5,1,1) = {"
L
L
L
L
L
L
L
L
L
L
L
L
L
L
L
L
L
L
L
L
L
L
L
L
L
L
L
L
L
L
L
L
L
L
L
L
L
L
L
L
L
L
L
L
L
L
L
L
L
L
L
L
L
L
L
L
L
L
L
L
L
L
L
L
L
L
L
L
L
a
a
a
a
a
a
a
a
a
a
a
a
a
a
N
V
V
V
V
a
a
a
a
a
a
V
V
V
V
V
N
a
a
a
a
a
a
a
a
a
L
L
L
L
L
L
L
L
L
L
L
L
"}
(6,1,1) = {"
L
L
L
L
L
L
L
L
L
L
L
L
L
L
L
L
L
L
L
L
L
L
L
L
L
L
L
L
L
L
L
L
L
L
L
L
L
L
L
L
L
L
L
L
L
L
L
L
L
L
L
L
L
L
L
L
L
L
L
L
L
L
L
L
L
L
L
a
a
a
a
a
a
a
a
a
a
a
a
a
a
a
N
V
V
V
V
a
a
a
a
a
a
a
a
V
V
V
V
N
a
a
a
a
a
a
a
a
a
a
L
L
L
L
L
L
L
L
L
L
L
"}
(7,1,1) = {"
L
L
L
L
L
L
L
L
L
L
L
L
L
L
L
L
L
L
L
L
L
L
L
L
L
L
L
L
L
L
L
L
L
L
L
L
L
L
L
L
L
L
L
L
L
L
L
L
L
L
L
L
L
L
L
L
L
L
L
L
L
L
L
L
L
L
a
a
a
a
a
a
a
a
a
a
a
a
a
a
a
a
N
V
V
V
N
a
a
a
a
a
a
a
a
a
N
V
V
V
N
a
a
a
a
a
a
a
a
a
a
L
L
L
L
L
L
L
L
L
L
"}
(8,1,1) = {"
L
L
L
L
L
L
L
L
L
L
L
L
L
L
L
L
L
L
L
L
L
L
L
L
L
L
L
L
L
L
L
L
L
L
L
L
L
L
L
L
L
L
L
L
L
L
L
L
L
L
L
L
L
L
L
L
L
L
L
L
L
L
L
a
a
a
a
a
a
a
a
a
a
a
a
a
a
a
a
a
a
N
V
V
V
N
a
a
a
a
a
a
a
a
a
a
a
N
V
V
V
N
a
a
a
a
a
a
a
a
a
a
L
L
L
L
L
L
L
L
L
"}
(9,1,1) = {"
L
L
L
L
L
L
L
L
L
L
L
L
L
L
L
L
L
L
L
L
L
L
L
L
L
L
L
L
L
L
L
L
L
L
L
L
L
L
L
L
L
L
L
L
L
L
L
L
L
L
L
L
L
L
L
L
L
L
L
L
L
a
a
a
a
a
a
a
a
a
a
a
a
a
a
a
a
a
a
a
a
N
V
V
N
a
a
a
a
a
a
a
a
a
a
a
a
N
V
V
V
N
a
a
a
a
a
a
a
a
a
a
a
L
L
L
L
L
L
L
L
"}
(10,1,1) = {"
L
L
L
L
L
L
L
L
L
L
L
L
L
L
L
L
L
L
L
L
L
L
L
L
L
L
L
L
L
L
L
L
L
L
L
L
L
L
L
L
L
L
L
L
L
L
L
L
L
L
L
L
L
L
L
L
L
L
L
L
a
a
a
a
a
a
a
a
a
a
a
a
a
a
a
a
a
a
a
a
N
V
V
V
N
a
a
a
a
a
a
a
a
a
a
a
a
a
N
V
V
V
N
N
a
a
a
a
a
a
a
a
a
a
L
L
L
L
L
L
L
"}
(11,1,1) = {"
L
L
L
L
L
L
L
L
L
L
L
L
L
L
L
L
L
L
L
L
L
L
L
L
L
L
L
L
L
L
L
L
L
L
L
L
L
L
L
L
L
L
L
L
L
L
L
L
L
L
L
L
L
L
L
L
L
L
L
L
a
a
a
a
a
a
a
a
a
a
a
a
a
a
a
a
a
a
N
N
V
V
V
V
N
a
a
a
a
a
a
a
a
a
a
a
a
a
a
N
V
V
V
V
N
N
a
a
a
a
a
a
a
a
L
L
L
L
L
L
L
"}
(12,1,1) = {"
L
L
L
L
L
L
L
L
L
L
L
L
L
L
L
L
L
L
L
L
L
L
L
L
L
L
L
L
L
L
L
L
L
L
L
L
L
L
L
L
L
L
L
L
L
L
L
L
L
L
L
L
L
L
L
L
L
L
L
L
a
a
a
a
a
a
a
a
a
a
a
a
a
a
a
a
N
N
V
V
V
V
N
N
a
a
a
a
a
a
a
a
a
a
a
a
a
a
a
a
N
N
V
V
V
V
N
a
a
a
a
a
a
a
a
L
L
L
L
L
L
"}
(13,1,1) = {"
L
L
L
L
L
L
L
L
L
L
L
L
L
L
L
L
L
L
L
L
L
L
L
L
L
L
L
L
L
L
L
L
L
L
L
L
L
L
L
L
L
L
L
L
L
L
L
L
L
L
L
L
L
L
L
L
L
L
L
L
L
a
a
a
a
a
a
a
a
a
a
a
a
a
a
N
V
V
V
V
V
N
a
a
a
a
a
a
a
a
a
a
a
a
a
a
a
a
a
a
a
a
N
N
V
V
V
N
a
a
a
a
a
a
a
a
L
L
L
L
L
"}
(14,1,1) = {"
L
L
L
L
L
L
L
L
L
L
L
L
L
L
L
L
L
L
L
L
L
L
L
L
L
L
L
L
L
L
L
L
L
L
L
L
L
L
L
L
L
L
L
L
L
L
L
L
L
L
L
L
L
L
L
L
L
L
L
L
a
a
a
a
a
a
a
a
a
a
a
a
a
a
N
V
V
V
V
V
N
a
a
a
a
a
a
a
a
a
a
a
a
a
a
a
a
a
a
a
a
a
a
a
N
N
V
V
N
a
a
a
a
a
a
a
L
L
L
L
L
"}
(15,1,1) = {"
L
L
L
L
L
L
L
L
L
L
L
L
L
L
L
L
L
L
L
L
L
L
L
L
L
L
L
L
L
L
L
L
L
L
L
L
L
L
L
L
L
L
L
L
L
L
L
L
L
L
L
L
L
L
L
L
L
L
L
a
a
a
a
a
a
a
a
a
a
a
a
a
a
N
V
V
V
V
N
N
a
a
a
a
a
a
a
a
a
a
a
a
a
a
a
a
a
a
a
a
a
a
a
a
a
N
V
V
N
a
a
a
a
a
a
a
L
L
L
L
L
"}
(16,1,1) = {"
L
L
L
L
L
L
L
L
L
L
L
L
L
L
L
L
L
L
L
L
L
L
L
L
L
L
L
L
L
L
L
L
L
L
L
L
L
L
L
L
L
L
L
L
L
L
L
L
L
L
L
L
L
L
L
L
L
L
L
a
a
a
a
a
a
a
a
a
a
a
a
a
N
V
V
V
V
N
a
a
a
a
a
a
a
a
a
a
a
a
a
a
a
a
a
a
a
a
a
a
a
a
a
a
a
a
N
V
V
N
a
a
a
a
a
a
L
L
L
L
L
"}
(17,1,1) = {"
L
L
L
L
L
L
L
L
L
L
L
L
L
L
L
L
L
L
L
L
L
L
L
L
L
L
L
L
L
L
L
L
L
L
L
L
L
L
L
L
L
L
L
L
L
L
L
L
L
L
L
L
L
L
L
L
L
L
a
a
a
a
a
a
a
a
a
a
a
a
a
N
V
V
V
V
N
a
a
a
a
a
a
a
a
a
a
a
a
a
a
a
a
a
a
a
a
a
a
a
a
a
a
a
a
a
a
N
V
N
a
a
a
a
a
a
a
L
L
L
L
"}
(18,1,1) = {"
L
L
L
L
L
L
L
L
L
L
L
L
L
L
L
L
L
L
L
L
L
L
L
L
L
L
L
L
L
L
L
L
L
L
L
L
L
L
L
L
L
L
L
L
L
L
L
L
L
L
L
L
L
L
L
L
L
a
a
a
a
a
a
a
a
a
a
a
a
a
a
N
V
V
V
V
N
a
a
a
a
a
a
a
a
a
a
a
a
a
a
a
a
a
a
a
a
a
a
a
a
a
a
a
a
a
a
a
N
a
a
a
a
a
a
a
a
L
L
L
L
"}
(19,1,1) = {"
L
L
L
L
L
L
L
L
L
L
L
L
L
L
L
L
L
L
L
L
L
L
L
L
L
L
L
L
L
L
L
L
L
L
L
L
L
L
L
L
L
L
L
L
L
L
L
L
L
L
L
L
L
L
L
L
a
a
a
a
a
a
a
a
a
a
a
a
a
a
a
N
V
V
V
N
a
a
a
a
a
a
a
a
a
a
a
a
a
a
a
a
a
a
a
a
a
a
a
a
a
a
a
a
a
a
a
a
a
a
a
a
a
a
a
a
a
L
L
L
L
"}
(20,1,1) = {"
L
L
L
L
L
L
L
L
L
L
L
L
L
L
L
L
L
L
L
L
L
L
L
L
L
L
L
L
L
L
L
L
L
L
L
L
L
L
L
L
L
L
L
L
L
L
L
L
L
L
L
L
L
L
L
a
a
a
a
a
a
a
a
a
a
a
a
a
a
a
a
N
V
V
V
N
a
a
a
a
a
a
a
a
a
a
a
a
a
a
a
a
a
a
a
a
a
a
a
a
a
a
a
a
a
a
a
a
a
a
a
a
a
a
a
a
a
L
L
L
L
"}
(21,1,1) = {"
L
L
L
L
L
L
L
L
L
L
L
L
L
L
L
L
L
L
L
L
L
L
L
L
L
L
L
L
L
L
L
L
L
L
L
L
L
L
L
L
L
L
L
L
L
L
L
L
L
L
L
L
L
L
L
a
a
a
a
a
a
a
a
a
a
a
a
a
a
a
a
N
V
V
N
a
a
a
a
a
a
a
a
a
a
a
a
a
a
a
a
a
a
a
a
a
a
a
a
a
a
a
a
a
a
a
a
a
a
a
a
a
a
a
a
a
a
a
L
L
L
"}
(22,1,1) = {"
L
L
L
L
L
L
L
L
L
L
L
L
L
L
L
L
L
L
L
L
L
L
L
L
L
L
L
L
L
L
L
L
L
L
L
L
L
L
L
L
L
L
L
L
L
L
L
L
L
L
L
L
L
L
L
a
a
a
a
a
v
a
a
a
a
a
a
a
a
a
a
N
V
N
a
a
a
a
a
a
a
a
a
a
a
a
a
a
a
a
a
a
a
a
a
a
a
a
a
a
a
a
a
a
a
a
a
a
a
a
a
a
a
a
a
a
a
a
a
L
L
"}
(23,1,1) = {"
L
L
L
L
L
L
L
L
L
L
L
L
L
L
L
L
L
L
L
L
L
L
L
L
L
L
L
L
L
L
L
L
L
L
L
L
L
L
L
L
L
L
L
L
L
L
L
L
L
L
L
L
L
L
L
a
a
a
a
v
a
a
a
a
a
a
a
a
a
a
N
V
V
N
a
a
a
a
a
a
a
a
a
a
a
a
a
a
a
a
a
a
a
a
a
a
a
a
a
a
a
a
a
a
a
a
a
a
a
a
a
a
a
a
a
a
a
a
a
L
L
"}
(24,1,1) = {"
L
L
L
L
L
L
L
L
L
L
L
L
L
L
L
L
L
L
L
L
L
L
L
L
L
L
L
L
L
L
L
L
L
L
L
L
L
L
L
L
L
L
L
L
L
L
L
L
L
L
L
L
q
L
L
a
a
a
v
v
a
a
a
a
a
a
a
a
a
a
N
V
N
a
a
a
a
a
a
a
a
a
a
a
a
a
a
a
a
a
a
a
a
a
a
a
a
a
a
a
a
a
a
a
a
a
a
a
a
a
a
a
a
a
a
a
a
a
a
a
L
"}
(25,1,1) = {"
L
L
L
L
L
L
L
L
L
L
L
L
L
L
L
L
L
L
L
L
L
L
L
L
L
L
L
L
L
L
L
L
L
L
L
L
L
L
L
L
L
L
L
L
L
L
L
L
L
L
L
L
q
L
L
L
a
a
v
a
a
a
a
a
a
a
a
a
a
a
a
N
a
a
a
a
a
a
a
a
a
a
a
a
a
a
a
a
a
a
a
a
a
a
a
a
a
a
a
a
a
a
a
a
a
a
a
a
a
a
a
a
a
a
a
a
a
a
a
a
L
"}
(26,1,1) = {"
L
L
L
L
L
L
L
L
L
L
L
L
L
L
L
L
L
L
L
L
L
L
L
L
L
L
L
L
L
L
L
L
L
L
L
L
L
L
L
L
L
L
L
L
L
L
L
L
L
L
L
L
L
L
L
L
L
v
v
a
a
a
a
a
a
a
a
a
a
a
a
a
a
a
a
a
a
a
a
a
a
a
a
a
a
a
a
a
a
a
a
a
a
a
a
a
a
a
a
a
a
a
a
a
a
a
a
a
a
a
a
a
a
a
a
a
a
a
a
a
L
"}
(27,1,1) = {"
L
L
L
L
L
L
L
L
L
L
L
L
L
L
L
L
L
L
L
L
L
L
L
L
L
L
L
L
L
L
L
L
L
L
L
L
L
L
L
L
L
L
L
L
L
L
L
L
L
L
L
L
L
L
L
L
L
v
a
a
a
a
a
a
a
a
a
a
a
a
a
a
a
a
a
a
a
a
a
a
a
a
a
a
a
a
a
a
a
a
a
a
a
a
a
a
a
a
a
a
a
a
a
a
a
a
a
a
a
a
a
a
a
a
a
a
a
a
a
a
L
"}
(28,1,1) = {"
L
L
L
L
L
L
L
L
L
L
L
L
L
L
L
L
L
L
L
L
L
L
L
L
L
L
L
L
L
L
L
L
L
L
L
L
L
L
L
L
L
L
L
L
L
L
L
L
L
L
L
L
L
L
L
L
L
v
a
a
a
a
a
a
a
a
a
a
a
a
a
a
a
a
a
a
a
a
a
a
a
a
a
a
a
a
a
a
a
a
a
a
a
a
a
a
a
a
a
a
a
a
a
a
a
a
a
a
a
a
a
a
a
a
a
a
a
a
a
a
L
"}
(29,1,1) = {"
L
L
L
L
L
L
L
L
L
L
L
L
L
L
L
L
L
L
L
L
L
L
L
L
L
L
L
L
L
L
L
L
L
L
L
L
L
L
L
L
L
L
L
L
L
L
L
L
L
L
L
L
L
L
L
L
L
a
a
a
a
a
a
a
a
a
a
a
a
a
a
a
a
a
a
a
a
a
a
a
a
a
a
a
a
a
a
a
a
a
a
a
a
a
a
a
a
a
a
a
a
a
a
a
a
a
a
a
a
a
a
a
a
a
a
a
a
a
a
a
L
"}
(30,1,1) = {"
L
L
L
L
L
L
L
L
L
L
L
L
L
L
L
L
L
L
L
L
L
L
L
L
L
L
L
L
L
L
L
L
L
L
L
L
L
L
L
L
L
L
L
L
L
L
L
L
L
L
L
v
v
v
L
L
L
a
a
a
a
a
a
a
a
a
a
a
a
a
a
a
a
a
a
a
a
a
a
a
a
a
a
a
a
a
a
a
a
a
a
a
a
a
a
a
a
a
a
a
a
a
a
a
a
a
a
a
a
a
a
a
a
a
a
a
a
a
a
a
L
"}
(31,1,1) = {"
L
L
L
L
L
L
L
L
L
L
L
L
L
L
L
L
L
L
L
L
L
L
L
L
L
L
L
L
L
L
L
L
L
L
L
L
L
L
L
L
L
L
L
L
L
L
L
L
L
L
v
v
v
v
L
L
L
a
a
a
a
a
a
a
a
a
a
a
a
a
a
a
a
a
a
a
a
a
a
a
a
a
a
a
a
a
a
a
a
a
a
a
a
a
a
a
a
a
a
a
a
a
a
a
a
a
a
a
a
a
a
a
a
a
a
a
a
a
a
a
L
"}
(32,1,1) = {"
L
L
L
L
L
L
L
L
L
L
L
L
L
L
L
L
L
L
L
L
L
L
L
L
L
L
L
L
L
L
L
L
L
L
L
L
L
L
L
L
L
L
L
L
L
L
L
L
L
L
v
v
v
v
L
L
L
a
a
a
a
a
a
a
a
a
a
a
a
a
a
a
a
a
a
a
a
a
a
a
a
a
a
a
a
a
a
a
a
a
a
a
a
a
a
a
a
a
a
a
a
a
a
a
a
a
a
a
a
a
a
a
a
a
a
a
a
a
a
a
L
"}
(33,1,1) = {"
L
L
L
L
L
L
L
L
L
L
L
L
L
L
L
L
L
L
L
L
L
L
L
L
L
L
L
L
L
L
L
L
L
L
L
L
L
L
L
L
L
L
L
L
L
L
L
L
L
L
v
v
v
v
L
L
L
a
a
a
a
a
a
a
a
a
a
a
a
a
a
a
a
a
a
a
a
a
a
a
a
a
a
a
a
a
a
a
a
a
a
a
a
a
a
a
a
a
a
a
a
a
a
a
a
a
a
a
a
a
a
a
a
a
a
a
a
a
a
a
L
"}
(34,1,1) = {"
L
L
L
L
L
L
L
L
L
L
L
L
L
L
L
L
L
L
L
L
L
L
L
L
L
L
L
L
L
L
L
L
L
L
L
L
L
L
L
L
L
L
L
L
L
L
L
L
L
L
v
v
v
v
v
L
L
a
a
a
a
a
a
a
a
a
a
a
a
a
a
a
a
a
a
a
a
a
a
a
a
a
a
a
a
a
a
a
a
a
a
a
a
a
a
a
a
a
a
a
a
a
a
a
a
a
a
a
a
a
a
a
a
a
a
a
a
a
a
a
L
"}
(35,1,1) = {"
L
L
L
L
L
L
L
L
L
L
L
L
L
L
L
L
L
L
L
L
L
L
L
L
L
L
L
L
L
L
L
L
L
L
L
L
L
L
L
L
L
L
L
L
L
L
L
L
L
L
v
v
v
v
v
L
L
a
a
a
a
a
a
a
a
a
a
a
a
a
a
a
a
a
a
a
a
a
a
a
a
v
a
a
a
a
a
a
a
a
a
a
a
a
a
a
a
a
a
a
a
a
a
a
a
a
a
a
a
a
a
a
a
a
a
a
a
a
a
a
L
"}
(36,1,1) = {"
L
L
L
L
L
L
L
L
L
L
L
L
L
L
L
L
L
L
L
L
L
L
L
L
L
L
L
L
L
L
L
L
L
L
L
L
L
L
L
L
L
L
L
L
L
L
L
L
L
L
v
v
v
v
v
L
L
a
a
a
a
a
a
a
a
a
a
a
a
a
a
a
a
a
a
a
a
a
a
a
a
v
a
a
a
a
a
a
a
a
a
a
a
a
a
a
a
a
a
a
a
a
a
a
a
a
a
a
a
a
a
a
a
a
a
a
a
a
a
a
L
"}
(37,1,1) = {"
L
L
L
L
L
L
L
L
L
L
L
L
L
L
L
L
L
L
L
L
L
L
L
L
L
L
L
L
L
L
L
L
L
L
L
L
L
L
L
L
L
L
L
L
L
L
L
L
L
L
v
v
v
v
v
L
L
a
a
a
a
a
a
a
a
a
a
a
a
a
a
a
a
a
a
a
a
a
a
a
v
v
a
a
a
a
a
a
a
a
a
a
a
a
a
a
a
a
a
a
a
a
a
a
a
a
a
a
a
a
a
a
a
a
a
a
a
a
a
a
a
"}
(38,1,1) = {"
L
L
L
L
L
L
L
L
L
L
L
L
L
L
L
L
L
L
L
L
L
L
L
L
L
L
L
L
L
L
L
L
L
L
L
L
L
L
L
L
L
L
L
L
L
L
L
L
L
L
v
v
v
v
v
L
L
a
a
a
a
a
a
a
a
a
a
a
a
a
a
a
a
a
a
a
a
a
a
v
v
a
a
a
a
a
a
a
a
a
a
a
a
a
a
a
a
a
a
a
a
a
a
a
a
a
a
a
a
a
a
a
a
a
a
a
a
a
a
a
a
"}
(39,1,1) = {"
L
L
L
L
L
L
L
L
L
L
L
L
L
L
L
L
L
L
L
L
L
L
L
L
L
L
L
L
L
L
L
L
L
L
L
L
L
L
L
L
L
L
L
L
L
L
L
L
L
L
v
v
v
v
v
L
L
a
a
a
a
a
a
a
a
a
a
a
a
a
a
a
a
a
a
a
a
a
v
v
v
a
a
a
a
a
a
a
a
a
a
a
a
a
a
a
a
a
a
a
a
a
a
a
a
a
a
a
a
a
a
a
a
a
a
a
a
a
a
a
a
"}
(40,1,1) = {"
L
L
L
L
L
L
L
L
L
L
L
L
L
L
L
L
L
L
L
L
L
L
L
L
L
L
L
L
L
L
L
L
L
L
L
L
L
L
L
L
L
L
L
L
L
L
L
L
L
L
v
v
v
v
v
L
L
a
a
a
a
a
a
a
a
a
a
a
a
a
a
a
a
a
a
a
v
v
v
v
a
a
a
a
a
a
a
a
a
a
a
a
a
a
a
a
a
a
a
a
a
a
a
a
a
a
a
a
a
a
a
a
a
a
a
a
a
a
a
a
a
"}
(41,1,1) = {"
L
L
L
L
L
L
L
L
L
L
L
L
L
L
L
L
L
L
L
L
L
L
L
L
L
L
L
L
L
L
L
L
L
L
L
L
L
L
L
L
L
L
L
L
L
L
L
L
L
L
v
v
v
v
v
L
L
a
a
a
a
a
a
v
v
a
a
a
a
a
a
a
a
a
a
L
L
L
L
v
v
a
a
a
a
a
a
a
a
a
a
a
a
a
a
a
a
a
a
a
a
a
a
a
a
a
a
a
a
a
a
a
a
a
a
a
a
a
a
a
a
"}
(42,1,1) = {"
L
L
L
L
L
L
L
L
L
L
L
L
L
L
L
L
L
L
L
L
L
L
L
L
L
L
L
L
L
L
L
L
L
L
L
L
L
L
L
L
L
L
L
L
L
L
L
L
L
L
v
v
v
v
v
L
L
a
a
a
a
a
v
v
a
a
a
a
a
a
a
a
a
a
L
L
L
L
L
L
v
a
a
a
a
a
a
a
a
a
a
a
a
a
a
a
a
a
a
a
a
a
a
a
a
a
a
a
a
a
a
a
a
a
a
a
a
a
a
a
a
"}
(43,1,1) = {"
L
L
L
L
L
L
L
L
L
L
L
L
L
L
L
L
L
L
L
L
L
L
L
L
L
L
L
L
L
L
L
L
L
L
L
L
L
L
L
L
L
L
L
L
L
L
L
q
L
L
v
v
v
v
v
L
L
L
a
a
a
a
v
a
a
a
a
a
a
a
a
a
a
L
L
L
L
L
L
L
L
a
a
a
a
a
a
a
a
a
a
a
a
a
a
a
a
a
a
a
a
a
a
a
a
a
a
a
a
a
a
a
a
a
a
a
a
a
a
a
a
"}
(44,1,1) = {"
L
L
L
L
L
L
L
L
L
L
L
L
L
L
L
L
L
L
L
L
L
L
L
L
L
L
L
L
L
L
L
L
L
L
L
L
L
L
L
L
L
L
L
L
L
L
L
L
L
L
v
v
v
v
v
L
L
L
L
a
a
v
v
a
a
a
a
a
a
a
a
a
L
L
L
v
v
v
L
L
a
a
a
a
a
a
a
v
a
a
a
a
a
a
a
a
a
a
a
a
a
a
a
a
a
a
a
a
a
a
a
a
a
a
a
a
a
v
a
a
a
"}
(45,1,1) = {"
L
L
L
L
L
L
L
L
L
L
L
L
L
L
L
L
L
L
L
L
L
L
L
L
L
L
L
L
L
L
L
L
L
L
L
L
L
L
L
L
L
L
L
L
L
L
L
L
L
L
q
v
v
v
v
L
L
L
L
a
a
v
v
a
a
a
a
a
a
a
a
L
L
L
v
v
v
v
L
L
a
a
a
a
a
a
a
v
a
a
a
a
a
a
a
a
a
a
a
a
a
a
a
a
a
a
a
a
a
a
a
a
a
a
a
a
a
v
a
a
a
"}
(46,1,1) = {"
L
L
L
L
L
L
L
L
L
L
L
L
L
L
L
L
L
L
L
L
L
L
L
L
L
L
L
L
L
L
L
L
L
L
L
L
L
L
L
L
L
L
L
L
L
L
L
L
L
L
L
v
v
v
v
L
L
L
L
L
a
v
v
a
a
a
a
a
a
L
L
L
L
v
v
v
v
v
L
L
a
a
a
L
a
v
v
v
a
a
a
a
a
a
a
a
a
a
a
a
a
a
a
a
a
a
a
a
a
a
a
a
a
a
a
a
a
v
v
a
a
"}
(47,1,1) = {"
L
L
L
L
L
L
L
L
L
L
L
L
L
L
L
L
L
L
L
L
L
L
L
L
L
L
L
L
L
L
L
L
L
L
L
L
L
L
L
L
L
L
L
L
L
L
L
L
L
L
L
L
L
L
L
L
L
L
L
L
L
L
v
a
a
a
a
a
L
L
L
L
L
v
v
v
v
v
L
L
L
L
L
L
L
v
v
v
a
a
a
a
a
a
a
a
a
a
a
a
a
a
a
a
a
a
a
a
a
a
a
a
a
a
a
a
a
a
L
a
L
"}
(48,1,1) = {"
L
L
L
L
L
L
L
L
L
L
L
L
L
L
L
L
L
L
L
L
L
L
L
L
L
L
L
L
L
L
L
L
L
L
L
L
L
L
L
L
L
L
L
L
L
L
L
L
L
L
v
L
L
L
L
L
L
L
L
L
L
L
v
a
a
a
a
L
L
L
L
L
L
v
v
v
v
v
L
L
L
L
L
L
L
L
L
L
L
a
a
a
a
a
a
a
a
a
v
a
a
a
a
a
a
a
a
a
a
a
v
a
a
a
a
a
a
a
L
L
L
"}
(49,1,1) = {"
L
L
L
L
L
L
L
L
L
L
L
L
L
L
L
L
L
L
L
L
L
L
L
L
L
L
L
L
L
L
L
L
L
L
L
L
L
L
L
L
L
L
L
L
L
L
L
L
L
v
v
v
L
L
L
L
L
L
L
L
L
L
L
a
a
a
a
L
L
L
v
v
L
L
v
v
v
v
L
L
L
L
L
v
v
v
L
L
L
L
a
a
a
a
a
a
a
a
a
v
a
a
a
a
a
a
a
a
a
a
v
a
a
a
a
a
L
L
L
L
L
"}
(50,1,1) = {"
L
L
L
L
L
L
L
L
L
L
L
L
L
L
L
L
L
L
L
L
L
L
L
L
L
L
L
L
L
L
L
L
L
L
L
L
L
L
L
L
L
L
L
L
L
L
L
L
L
v
v
v
v
L
L
L
L
L
L
L
L
L
L
L
L
L
L
L
L
v
v
v
v
L
v
v
v
v
L
L
L
L
v
v
v
v
v
L
L
L
a
a
a
a
a
a
a
a
a
v
a
a
a
a
a
a
a
a
a
a
v
a
a
a
a
L
L
L
L
L
L
"}
(51,1,1) = {"
L
L
L
L
L
L
L
L
L
L
L
L
L
L
L
L
L
L
L
L
L
L
L
L
L
L
L
L
L
L
L
L
L
L
L
L
L
L
L
L
L
L
L
L
L
L
L
L
L
L
v
v
v
L
L
L
v
v
v
L
L
L
L
L
L
L
L
L
v
v
v
v
v
L
L
L
L
L
L
L
L
L
v
v
v
v
v
v
L
L
L
a
a
a
a
a
a
a
a
v
a
a
a
a
a
a
a
a
a
a
v
v
a
a
L
L
L
L
L
L
L
"}
(52,1,1) = {"
L
L
L
L
L
L
L
L
L
L
L
L
L
L
L
L
L
L
L
L
L
L
L
L
L
L
L
L
L
L
L
L
L
L
L
L
L
L
L
L
L
L
L
L
L
L
L
L
L
L
L
v
L
L
L
v
v
v
v
v
L
L
L
L
L
L
L
L
v
v
v
v
v
L
L
L
L
L
L
L
L
L
v
v
v
v
v
v
v
L
L
L
a
a
a
a
a
a
a
v
a
a
a
a
a
a
a
a
a
a
v
v
a
L
L
L
L
L
L
L
L
"}
(53,1,1) = {"
L
L
L
L
L
L
L
L
L
L
L
L
L
L
L
L
L
L
L
L
L
L
L
L
L
L
L
L
L
L
L
L
L
L
L
L
L
L
L
L
L
L
L
L
L
L
L
L
L
L
L
L
L
L
L
v
v
v
v
v
L
L
L
L
L
L
L
v
v
v
v
v
v
L
L
L
L
L
v
v
v
L
L
v
v
v
v
v
v
v
L
L
a
a
a
a
a
a
a
v
v
a
a
a
a
a
a
a
a
a
L
L
L
L
L
v
v
v
v
v
L
"}
(54,1,1) = {"
L
L
L
L
L
L
L
L
L
L
L
L
L
L
L
L
L
L
L
L
L
L
L
L
L
L
L
L
L
L
L
L
L
L
L
L
L
L
L
L
L
L
L
L
L
L
L
v
v
L
L
L
q
q
L
v
v
v
v
v
v
L
L
L
L
v
v
v
v
v
v
v
v
v
L
L
L
v
v
v
v
v
L
L
v
v
v
v
v
v
L
L
a
a
a
a
a
a
a
v
v
a
a
a
a
a
a
a
a
a
L
L
L
L
v
v
v
v
v
v
v
"}
(55,1,1) = {"
L
L
L
L
L
L
L
L
L
L
L
L
L
L
L
L
L
L
L
L
L
L
L
L
L
L
L
L
L
L
L
L
L
L
L
L
L
L
L
L
L
L
L
L
L
L
v
v
v
L
L
q
q
q
L
v
v
v
v
v
v
L
L
L
L
v
v
v
v
v
v
v
v
v
L
L
L
v
v
v
v
v
L
L
L
v
v
v
v
v
L
L
a
a
a
a
a
a
a
v
v
a
a
a
a
a
a
a
a
a
L
L
L
L
v
v
v
v
v
v
v
"}
(56,1,1) = {"
L
L
L
L
L
L
L
L
L
L
L
L
L
L
L
L
L
L
L
L
L
L
L
L
L
L
L
L
L
L
L
L
L
L
L
L
L
L
L
L
L
L
L
L
L
L
v
v
v
v
L
L
q
L
L
v
v
v
v
v
v
L
L
L
L
L
v
v
v
v
v
v
v
v
L
L
L
v
v
v
v
v
v
L
L
L
L
L
L
L
L
L
L
L
L
L
L
L
v
v
a
a
a
a
a
a
a
a
a
a
L
L
L
v
v
v
v
v
v
v
L
"}
(57,1,1) = {"
L
L
L
L
L
L
L
L
L
L
L
L
L
L
L
L
L
L
L
L
L
L
L
L
L
L
L
L
L
L
L
L
L
L
L
L
L
L
L
L
L
L
L
L
L
v
v
v
v
v
L
L
L
L
L
v
v
v
v
v
v
L
L
L
L
L
L
v
v
v
v
v
v
v
L
L
L
v
v
v
v
v
v
v
L
L
L
L
L
L
L
L
L
v
v
v
L
L
L
L
a
a
a
a
L
L
a
a
a
L
L
L
L
L
v
v
v
v
v
v
L
"}
(58,1,1) = {"
L
L
L
L
L
L
L
L
L
L
L
L
L
L
L
L
L
L
L
L
L
L
L
L
L
L
L
L
L
L
L
L
L
L
L
L
L
L
L
L
L
L
L
L
L
v
v
v
v
v
L
L
L
L
L
v
v
v
v
v
v
L
L
L
L
L
L
L
v
v
v
v
v
v
L
L
L
v
v
v
v
v
v
v
v
v
L
L
v
v
v
L
L
v
v
v
v
v
v
L
L
L
L
L
L
L
a
a
L
L
v
L
L
L
v
v
v
v
v
v
L
"}
(59,1,1) = {"
L
L
L
L
L
L
L
L
L
L
L
L
L
L
L
L
L
L
L
L
L
L
L
L
L
L
L
L
L
L
L
L
L
L
L
L
L
L
L
L
L
L
L
L
L
v
v
v
v
v
L
L
L
L
L
v
v
v
v
v
v
L
L
L
L
L
L
L
L
v
v
v
v
L
L
L
L
L
v
v
v
v
v
v
v
v
L
v
v
v
v
L
L
v
v
v
v
v
v
L
L
v
v
v
L
L
a
a
L
L
v
v
L
L
L
v
v
v
v
L
L
"}
(60,1,1) = {"
L
L
L
L
L
L
L
L
L
L
L
L
L
L
L
L
L
L
L
L
L
L
L
L
L
L
L
L
L
L
L
L
L
L
L
L
L
L
L
L
L
L
L
L
L
v
v
v
v
v
L
L
L
L
L
v
v
v
v
v
v
L
L
L
L
L
L
L
L
L
L
L
L
L
L
L
L
L
v
v
v
v
v
v
v
L
L
v
v
v
v
L
L
v
v
v
v
v
v
L
v
v
v
v
L
L
L
L
L
L
v
v
L
L
L
L
L
L
L
L
L
"}
(61,1,1) = {"
L
L
L
L
L
L
L
L
L
L
L
L
L
L
L
L
L
L
L
L
L
L
L
L
L
L
L
L
L
L
L
L
L
L
L
L
L
L
L
L
L
L
L
L
L
q
v
v
v
v
L
L
L
L
L
L
v
v
v
v
v
L
L
L
L
L
L
L
L
L
L
L
L
L
L
L
L
L
L
v
v
v
v
v
v
L
L
L
v
v
L
L
L
L
L
L
L
L
L
L
v
v
v
L
L
L
L
L
L
L
L
L
L
L
L
L
L
L
L
L
L
"}
(62,1,1) = {"
L
L
L
L
L
L
L
L
L
L
L
L
L
L
L
L
L
L
L
L
L
L
L
L
L
L
L
L
L
L
L
L
L
L
L
L
L
L
L
L
L
L
L
L
L
q
v
v
v
v
L
L
L
L
L
L
v
v
v
v
v
L
L
L
v
v
v
v
L
L
L
L
L
L
L
L
L
L
L
L
L
L
L
L
L
L
L
L
L
L
L
L
L
L
L
L
L
L
L
L
v
v
L
L
v
v
L
L
L
L
L
L
L
L
L
L
L
L
L
L
L
"}
(63,1,1) = {"
t
L
L
L
L
L
L
L
L
L
L
L
L
L
L
L
L
L
L
L
L
L
L
L
L
L
L
L
L
L
L
L
L
L
L
L
L
L
L
L
L
L
L
L
L
q
v
v
v
v
L
L
L
L
L
L
L
L
L
L
L
L
L
L
L
v
v
v
v
L
L
L
L
L
L
L
L
L
L
L
L
L
L
L
L
L
L
L
L
v
v
v
v
v
v
v
v
L
L
L
L
L
L
L
L
v
v
v
v
L
L
L
L
q
q
L
L
L
L
L
L
"}
(64,1,1) = {"
L
L
L
L
L
L
L
L
L
L
L
L
L
L
L
L
L
L
L
L
L
L
L
L
L
L
L
L
L
L
L
L
L
L
L
L
L
L
L
L
L
L
L
L
L
q
v
v
v
v
L
L
L
L
L
L
L
L
L
L
L
L
L
L
L
v
v
v
v
L
L
L
L
L
v
v
v
v
v
L
L
L
L
L
L
L
L
L
v
v
v
v
v
v
v
v
v
v
v
L
L
v
L
L
L
L
v
v
v
v
L
L
L
L
L
L
L
L
L
L
L
"}
(65,1,1) = {"
L
L
L
L
L
L
L
L
L
L
L
L
L
L
L
L
L
L
L
L
L
L
L
L
L
L
L
L
L
L
L
L
L
L
L
L
L
L
L
L
L
L
L
L
L
q
v
v
v
v
L
L
L
L
L
L
L
L
L
L
L
L
L
L
L
v
v
v
v
v
L
L
L
v
v
v
v
v
v
v
v
L
L
L
v
v
L
L
v
v
v
v
v
v
v
v
v
v
v
L
v
v
v
L
L
v
v
v
v
v
L
L
L
L
L
L
L
L
L
L
L
"}
(66,1,1) = {"
L
L
L
L
L
L
L
L
L
L
L
L
L
L
L
L
L
L
L
L
L
L
L
L
L
L
L
L
L
L
L
L
L
L
L
L
L
L
L
L
L
L
L
L
L
L
L
L
L
L
L
L
L
L
L
q
q
q
L
L
L
L
L
L
L
v
v
v
v
v
L
L
L
v
v
v
v
v
v
v
v
L
L
L
v
v
L
L
v
v
v
v
v
v
v
v
v
v
v
L
v
v
L
L
v
v
v
v
v
v
L
L
L
L
L
L
L
L
L
L
L
"}
(67,1,1) = {"
L
L
L
L
L
L
L
L
L
L
L
L
L
L
L
L
L
L
L
L
L
L
L
L
L
L
L
L
L
L
L
L
L
L
L
L
L
L
L
L
L
L
L
L
L
L
L
L
L
L
L
L
L
L
L
q
q
q
L
L
L
L
L
L
v
v
v
v
v
v
L
L
L
L
v
v
v
v
v
v
v
v
L
L
v
v
L
L
v
v
v
v
v
v
v
v
v
v
L
L
L
L
L
v
v
v
v
v
v
v
L
L
L
L
L
L
L
L
L
L
L
"}
(68,1,1) = {"
L
L
L
L
L
L
L
L
L
L
L
L
L
L
L
L
L
L
L
L
L
L
L
L
L
L
L
L
L
L
L
L
L
L
L
L
L
L
L
L
L
L
L
L
L
L
L
L
L
L
L
L
L
L
L
L
L
L
L
L
L
L
L
L
v
v
v
v
v
v
L
L
L
L
v
v
v
v
v
v
v
v
L
L
L
L
L
L
L
v
v
v
v
v
v
v
v
L
L
L
L
L
v
v
v
v
v
v
v
L
L
L
L
L
L
L
L
L
L
L
L
"}
(69,1,1) = {"
L
L
L
L
L
L
L
L
L
L
L
L
L
L
L
L
L
L
L
L
L
L
L
L
L
L
L
L
L
L
L
L
L
L
L
L
L
L
L
L
L
L
L
L
L
L
L
L
L
L
L
L
L
L
L
L
L
L
L
v
v
L
L
L
v
v
v
v
v
v
L
L
L
L
L
v
v
v
v
v
v
v
L
L
L
L
L
L
L
L
L
L
L
L
L
L
L
L
L
L
L
v
v
v
v
v
v
v
v
L
L
L
L
L
L
L
L
L
L
L
L
"}
(70,1,1) = {"
L
L
L
L
L
L
L
L
L
L
L
L
L
L
L
L
L
L
L
L
L
L
L
L
L
L
L
L
L
L
L
L
L
L
L
L
L
L
L
L
L
L
L
L
L
L
L
L
L
L
L
L
L
L
L
L
L
L
v
v
v
L
L
L
v
v
v
v
v
L
L
L
L
L
L
v
v
v
v
v
v
v
L
L
L
L
L
L
L
L
L
L
L
L
L
L
L
L
q
L
L
v
v
v
v
v
v
v
L
L
L
L
L
L
L
L
L
L
L
L
L
"}
(71,1,1) = {"
L
L
L
L
L
L
L
L
L
L
L
L
L
L
L
L
L
L
L
L
L
L
L
L
L
L
L
L
L
L
L
L
L
L
L
L
L
L
L
L
L
L
L
L
L
L
L
L
L
L
L
L
L
L
L
L
L
L
v
v
L
L
L
L
L
v
v
v
v
L
L
L
L
L
L
L
v
v
v
v
v
L
L
L
L
L
v
v
L
L
L
L
L
L
L
v
v
L
q
q
L
v
v
v
v
v
v
L
L
L
L
L
L
L
L
L
L
L
L
L
L
"}
(72,1,1) = {"
L
L
L
L
L
L
L
L
L
L
L
L
L
L
L
L
L
L
L
L
L
L
L
L
L
L
L
L
L
L
L
L
L
L
L
L
L
L
L
L
L
L
L
L
L
L
L
L
q
q
L
L
L
L
L
L
L
L
L
L
L
L
L
L
L
L
v
v
L
L
L
L
L
L
L
L
L
L
L
L
L
L
L
L
L
L
v
v
v
v
v
v
v
v
v
v
L
L
q
q
L
L
v
v
v
q
L
L
L
L
L
L
L
L
L
L
L
L
L
L
L
"}
(73,1,1) = {"
L
L
L
L
L
L
L
L
L
L
L
L
L
L
L
L
L
L
L
L
L
L
L
L
L
L
L
L
L
L
L
L
L
L
L
L
L
L
L
L
L
L
L
L
L
L
L
q
q
q
L
L
L
L
L
L
L
L
L
L
L
L
L
L
L
L
L
L
L
L
L
L
L
L
L
L
L
L
L
L
L
L
L
L
L
L
v
v
v
v
v
v
v
v
v
L
L
L
L
L
L
L
L
L
L
L
L
L
L
L
L
L
L
L
L
L
L
L
L
L
L
"}
(74,1,1) = {"
L
L
L
L
L
L
L
L
L
L
L
L
L
L
L
L
L
L
L
L
L
L
L
L
L
L
L
L
L
L
L
L
L
L
L
L
L
L
L
L
L
L
L
L
L
L
L
L
L
L
L
L
L
L
L
L
L
L
L
L
L
L
L
L
L
L
L
L
L
L
L
L
L
L
L
L
L
L
L
L
L
L
q
q
L
L
v
v
v
v
v
v
v
v
v
L
L
L
L
L
L
L
L
L
L
L
L
L
L
L
L
L
L
L
L
L
L
L
L
L
L
"}
(75,1,1) = {"
L
L
L
L
L
L
L
L
L
L
L
L
L
L
L
L
L
L
L
L
L
L
L
L
L
L
L
L
L
L
L
L
L
L
L
L
L
L
L
L
L
L
L
L
L
L
L
L
L
L
L
L
L
L
L
L
L
L
L
L
L
L
L
L
L
L
L
L
L
L
L
L
v
v
v
v
L
L
L
L
L
L
q
q
L
L
v
v
v
v
v
v
v
v
v
L
L
L
L
L
L
L
L
L
L
L
L
L
L
L
L
L
L
L
L
L
L
L
L
L
L
"}
(76,1,1) = {"
L
L
L
L
L
L
L
L
L
L
L
L
L
L
L
L
L
L
L
L
L
L
L
L
L
L
L
L
L
L
L
L
L
L
L
L
L
L
L
L
L
L
L
L
L
L
L
L
L
L
L
L
L
L
L
L
L
L
L
L
L
L
L
L
L
L
L
L
L
L
L
L
v
v
v
v
v
L
L
L
L
L
L
L
L
L
v
v
v
v
v
v
v
v
v
L
L
L
L
L
L
L
L
L
L
L
L
L
L
L
L
L
L
L
L
L
L
L
L
L
L
"}
(77,1,1) = {"
L
L
L
L
L
L
L
L
L
L
L
L
L
L
L
L
L
L
L
L
L
L
L
L
L
L
L
L
L
L
L
L
L
L
L
L
L
L
L
q
q
L
L
L
L
L
L
L
L
L
L
L
L
L
L
v
v
v
v
L
L
L
L
L
L
L
L
L
L
L
L
L
v
v
v
v
v
L
L
L
L
L
L
L
L
L
L
v
v
v
v
v
v
v
q
L
L
L
L
L
L
L
L
L
L
L
L
L
L
L
L
L
L
L
L
L
L
L
L
L
L
"}
(78,1,1) = {"
L
L
L
L
L
L
L
L
L
L
L
L
L
L
L
L
L
L
L
L
L
L
L
L
L
L
L
L
L
L
L
L
L
L
L
L
L
L
L
q
q
L
L
L
L
L
L
L
L
L
L
L
L
L
L
v
v
v
v
v
L
L
L
L
L
L
L
q
q
L
L
L
v
v
v
v
v
L
L
L
L
L
L
L
L
L
L
L
v
v
v
v
v
q
L
L
L
L
L
L
L
L
L
L
L
L
L
L
L
L
L
L
L
L
L
L
L
L
L
L
L
"}
(79,1,1) = {"
L
L
L
L
L
L
L
L
L
L
L
L
L
L
L
L
L
L
L
L
L
L
L
L
L
L
L
L
L
L
L
L
L
L
L
L
L
L
q
q
L
L
L
L
L
L
v
v
v
L
L
L
L
L
L
v
v
v
v
v
L
L
L
L
L
L
L
q
q
L
L
L
v
v
v
v
v
L
L
L
L
L
L
L
L
L
L
L
L
L
L
L
L
L
L
L
L
L
L
L
L
L
L
L
L
L
L
L
L
L
L
L
L
L
L
L
L
L
L
L
L
"}
(80,1,1) = {"
L
L
L
L
L
L
L
L
L
L
L
L
L
L
L
L
L
L
L
L
L
L
L
L
L
L
L
L
L
L
L
L
L
L
L
L
L
L
L
q
L
L
L
L
L
L
v
v
v
L
L
L
L
L
L
v
v
v
v
v
L
L
L
L
L
L
L
q
L
L
L
L
q
v
v
v
v
L
L
L
L
L
L
L
L
L
L
L
L
L
L
L
L
L
L
L
L
L
L
L
L
L
L
L
L
L
L
L
L
L
L
L
L
L
L
L
L
L
L
L
L
"}
(81,1,1) = {"
L
L
L
L
L
L
L
L
L
L
L
L
L
L
L
L
L
L
L
L
L
L
L
L
L
L
L
L
L
L
L
L
L
L
L
L
L
L
L
L
L
L
L
L
L
q
v
v
v
L
L
L
L
L
L
v
v
v
v
v
L
L
L
L
L
L
L
L
L
L
L
L
L
q
v
v
v
L
L
L
L
L
L
L
L
L
L
L
L
L
L
L
L
L
L
L
L
L
L
L
L
L
L
L
L
L
L
L
L
L
L
L
L
L
L
L
L
L
L
L
L
"}
(82,1,1) = {"
L
L
L
L
L
L
L
L
L
L
L
L
L
L
L
L
L
L
L
L
L
L
L
L
L
L
L
L
L
L
L
L
L
L
L
L
L
L
L
L
L
L
L
L
L
q
q
q
v
L
L
L
L
L
L
q
v
v
v
v
L
L
L
L
L
L
L
L
L
L
L
L
L
L
q
q
v
L
L
L
L
L
L
L
L
L
L
L
L
L
L
L
L
L
L
L
L
L
L
L
L
L
L
L
L
L
L
L
L
L
L
L
L
L
L
L
L
L
L
L
L
"}
(83,1,1) = {"
L
L
L
L
L
L
L
L
L
L
L
L
L
L
L
L
L
L
L
L
L
L
L
L
L
L
L
L
L
L
L
L
L
L
L
L
L
L
L
L
L
L
L
L
L
L
L
L
L
L
L
L
L
L
L
L
q
q
v
L
L
L
L
L
L
L
L
L
L
L
L
L
L
L
L
L
L
L
L
L
L
L
L
L
L
L
L
L
L
L
L
L
L
L
L
L
L
L
L
L
L
L
L
L
L
L
L
L
L
L
L
L
L
L
L
L
L
L
L
L
L
"}
(84,1,1) = {"
L
L
L
L
L
L
L
L
L
L
L
L
L
L
L
L
L
L
L
L
L
L
L
L
L
L
L
L
L
L
L
L
L
L
L
L
L
L
L
L
L
L
L
L
L
L
L
L
L
L
L
L
L
L
L
L
L
L
L
L
L
L
L
L
L
L
L
L
L
L
L
L
L
L
L
L
L
L
L
L
L
L
L
L
L
L
L
L
L
L
L
L
L
L
L
L
L
L
L
L
L
L
L
L
L
L
L
L
L
L
L
L
L
L
L
L
L
L
L
L
L
"}
(85,1,1) = {"
L
L
L
L
L
L
L
L
L
L
L
L
L
L
L
L
L
L
L
L
L
L
L
L
L
q
q
L
L
L
L
L
L
L
q
q
q
q
L
L
L
q
q
L
L
L
L
L
L
L
L
L
L
L
L
L
L
L
L
L
L
L
L
L
L
L
L
L
L
L
L
L
L
L
L
L
L
L
L
L
L
L
L
L
L
L
L
L
L
L
L
L
L
L
L
L
L
L
L
L
L
L
L
L
L
L
L
L
L
L
L
L
L
L
L
L
L
L
L
L
L
"}
(86,1,1) = {"
L
L
L
L
L
L
L
L
L
L
L
L
L
L
L
L
L
L
L
L
L
L
L
L
L
q
q
L
L
L
L
L
L
q
q
q
q
q
q
L
q
q
q
q
L
L
L
L
L
L
L
L
L
L
L
L
L
L
L
L
L
L
L
L
L
L
L
L
L
L
L
L
L
L
L
L
L
L
L
L
L
L
L
L
L
L
L
L
L
L
L
L
L
L
L
L
L
L
L
L
L
L
L
L
L
L
L
L
L
L
L
L
L
L
L
L
L
L
L
L
L
"}
(87,1,1) = {"
L
L
L
L
L
L
L
L
L
L
L
L
L
L
L
L
L
L
L
L
L
L
L
L
q
q
L
L
L
L
L
L
q
q
q
q
q
q
q
L
L
q
q
L
L
L
L
L
L
L
L
L
L
L
L
L
L
L
L
L
L
L
L
L
L
L
L
L
L
L
L
L
L
L
L
L
L
L
L
L
L
L
L
L
L
L
L
L
L
L
L
L
L
L
L
L
L
L
L
L
L
L
L
L
L
L
L
L
L
L
L
L
L
L
L
L
L
L
L
L
L
"}
(88,1,1) = {"
L
L
L
L
L
L
L
L
L
L
L
L
L
L
L
L
L
L
L
L
L
L
L
L
L
q
L
L
L
L
L
L
L
q
q
q
q
q
L
L
L
L
L
L
L
L
L
L
L
L
L
L
L
L
L
L
L
L
L
L
L
L
L
L
L
L
L
L
L
L
L
L
L
L
L
L
L
L
L
L
L
L
L
L
L
L
L
L
L
L
L
L
L
L
L
L
L
L
L
L
L
L
L
L
L
L
L
L
L
L
L
L
L
L
L
L
L
L
L
L
L
"}
(89,1,1) = {"
L
L
L
L
L
L
L
L
L
L
L
L
L
L
L
L
L
L
L
L
L
L
L
L
L
L
L
L
L
L
L
L
L
L
L
L
L
L
L
L
L
L
L
L
L
L
L
L
L
L
L
L
L
L
L
L
L
L
L
L
L
L
L
L
L
L
L
L
L
L
L
L
L
L
L
L
L
L
L
L
L
L
L
L
L
L
L
L
L
L
L
L
L
L
L
L
L
L
L
L
L
L
L
L
L
L
L
L
L
L
L
L
L
L
L
L
L
L
L
L
L
"}
(90,1,1) = {"
L
L
L
L
L
L
L
L
L
L
L
L
L
L
L
L
L
L
L
L
L
L
L
L
L
L
L
L
L
L
L
L
L
L
L
L
L
L
L
L
L
L
L
L
L
L
L
L
L
L
L
L
L
L
L
L
L
L
L
L
L
L
L
L
L
L
L
L
L
L
L
L
L
L
L
L
L
L
L
L
L
L
L
L
L
L
L
L
L
L
L
L
L
L
L
L
L
L
L
L
L
L
L
L
L
L
L
L
L
L
L
L
L
L
L
L
L
L
L
L
L
"}
(91,1,1) = {"
L
L
L
L
L
L
L
L
L
L
L
L
L
L
L
L
L
L
L
L
L
L
L
L
L
L
L
L
L
q
L
L
L
L
L
L
L
L
L
L
L
L
L
L
L
L
L
L
L
L
L
L
L
L
L
L
L
L
L
L
L
L
L
L
L
L
L
L
L
L
L
L
L
L
L
L
L
L
L
L
L
L
L
L
L
L
L
L
L
L
L
L
L
L
L
L
L
L
L
L
L
L
L
L
L
L
L
L
L
L
L
L
L
L
L
L
L
L
L
L
L
"}
(92,1,1) = {"
L
L
L
L
L
L
L
L
L
L
L
L
L
L
L
L
L
L
L
L
L
L
L
L
L
L
L
L
q
q
L
L
L
q
q
L
L
L
L
L
L
L
L
L
L
L
L
L
L
L
L
L
L
L
L
L
L
L
L
L
L
L
L
L
L
L
L
L
L
L
L
L
L
L
L
L
L
L
L
L
L
L
L
L
L
L
L
L
L
L
L
L
L
L
L
L
L
L
L
L
L
L
L
L
L
L
L
L
L
L
L
L
L
L
L
L
L
L
L
L
L
"}
(93,1,1) = {"
L
L
L
L
L
L
L
L
L
L
L
L
L
L
L
L
L
L
L
L
L
L
q
L
L
L
L
q
q
q
L
L
L
q
q
L
L
L
L
L
L
L
L
L
L
L
L
L
L
L
L
L
L
L
L
L
L
L
L
L
L
L
L
L
L
L
L
L
L
L
L
L
L
L
L
L
L
L
L
L
L
L
L
L
L
L
L
L
L
L
L
L
L
L
L
L
L
L
L
L
L
L
L
L
L
L
L
L
L
L
L
L
L
L
L
L
L
L
L
L
L
"}
(94,1,1) = {"
L
L
L
L
L
L
L
L
L
L
L
L
L
L
L
L
L
L
L
L
L
L
q
q
L
L
L
L
L
L
L
L
L
L
L
L
L
L
L
L
L
L
L
L
L
L
L
L
L
L
L
L
L
L
L
L
L
L
L
L
L
L
L
L
L
L
L
L
L
L
L
L
L
L
L
L
L
L
L
L
L
L
L
L
L
L
L
L
L
L
L
L
L
L
L
L
L
L
L
L
L
L
L
L
L
L
L
L
L
L
L
L
L
L
L
L
L
L
L
L
L
"}
(95,1,1) = {"
L
L
L
L
L
L
L
L
L
L
L
L
L
L
L
L
L
L
L
L
q
q
q
q
L
L
L
L
L
L
L
L
L
L
L
L
L
L
L
L
L
L
L
L
L
L
L
L
L
L
L
L
L
L
L
L
L
L
L
L
L
L
L
L
L
L
L
L
L
L
L
L
L
L
L
L
L
L
L
L
L
L
L
L
L
L
L
L
L
L
L
L
L
L
L
L
L
L
L
L
L
L
L
L
L
L
L
L
L
L
L
L
L
L
L
L
L
L
L
L
L
"}
(96,1,1) = {"
L
L
L
L
L
L
L
L
L
L
L
L
L
L
L
L
L
L
q
q
q
q
q
L
L
L
L
L
L
L
L
L
L
L
L
L
L
L
L
L
L
L
L
L
L
L
L
L
L
L
L
L
L
L
L
L
L
L
L
L
L
L
L
L
L
L
L
L
L
L
L
L
L
L
L
L
L
L
L
L
L
L
L
L
L
L
L
L
L
L
L
L
L
L
L
L
L
L
L
L
L
L
L
L
L
L
L
L
L
L
L
L
L
L
L
L
L
L
L
L
L
"}
(97,1,1) = {"
L
L
L
L
L
L
L
L
L
L
L
L
L
L
L
L
L
L
L
L
L
L
L
L
L
L
q
q
L
L
L
L
L
L
L
L
L
L
L
L
L
L
L
L
L
L
L
L
L
L
L
L
L
L
L
L
L
L
L
L
L
L
L
L
L
L
L
L
L
L
L
L
L
L
L
L
L
L
L
L
L
L
L
L
L
L
L
L
L
L
L
L
L
L
L
L
L
L
L
L
L
L
L
L
L
L
L
L
L
L
L
L
L
L
L
L
L
L
L
L
L
"}
(98,1,1) = {"
L
L
L
L
L
L
L
L
L
L
L
L
L
L
L
L
L
L
L
L
L
L
L
L
L
q
q
q
q
L
L
L
L
L
L
L
L
L
L
L
L
L
L
L
L
L
L
L
L
L
L
L
L
L
L
L
L
L
L
L
L
L
L
L
L
L
L
L
L
L
L
L
L
L
L
L
L
L
L
L
L
L
L
L
L
L
L
L
L
L
L
L
L
L
L
L
L
L
L
L
L
L
L
L
L
L
L
L
L
L
L
L
L
L
L
L
L
L
L
L
L
"}
(99,1,1) = {"
L
L
L
L
L
L
L
L
L
L
L
L
L
L
L
L
L
L
L
L
L
L
L
L
L
L
q
q
L
L
L
L
L
L
L
L
L
L
L
L
L
L
L
L
L
L
L
L
L
L
L
L
L
L
L
L
L
L
L
L
L
L
L
L
L
L
L
L
L
L
L
L
L
L
L
L
L
L
L
L
L
L
L
L
L
L
L
L
L
L
L
L
L
L
L
L
L
L
L
L
L
L
L
L
L
L
L
L
L
L
L
L
L
L
L
L
L
L
L
L
L
"}
