//MAP CONVERTED BY dmm2tgm.py THIS HEADER COMMENT PREVENTS RECONVERSION, DO NOT REMOVE
"ka" = (
/obj/structure/lattice,
/turf/space,
/area)
"kc" = (
/obj/effect/landmark/spacepod/random,
/turf/space,
/area)
"lX" = (
/obj/structure/grille,
/turf/space,
/area)
"tZ" = (
/obj/effect/landmark/map_element/djsat_notail,
/turf/space,
/area)
"Rq" = (
/turf/space,
/area)

(1,1,1) = {"
Rq
Rq
Rq
Rq
Rq
Rq
Rq
tZ
Rq
Rq
Rq
Rq
Rq
Rq
"}
(2,1,1) = {"
Rq
Rq
Rq
Rq
Rq
Rq
Rq
Rq
Rq
Rq
Rq
Rq
Rq
Rq
"}
(3,1,1) = {"
Rq
Rq
Rq
Rq
Rq
Rq
Rq
Rq
Rq
Rq
Rq
Rq
Rq
Rq
"}
(4,1,1) = {"
Rq
Rq
Rq
Rq
Rq
Rq
Rq
Rq
Rq
Rq
Rq
Rq
Rq
Rq
"}
(5,1,1) = {"
Rq
Rq
Rq
Rq
Rq
Rq
Rq
Rq
Rq
Rq
Rq
Rq
Rq
Rq
"}
(6,1,1) = {"
Rq
Rq
Rq
Rq
Rq
Rq
Rq
Rq
Rq
Rq
Rq
Rq
Rq
Rq
"}
(7,1,1) = {"
Rq
Rq
Rq
Rq
Rq
Rq
Rq
Rq
Rq
Rq
Rq
Rq
Rq
Rq
"}
(8,1,1) = {"
Rq
Rq
Rq
Rq
Rq
Rq
Rq
Rq
Rq
Rq
Rq
Rq
Rq
Rq
"}
(9,1,1) = {"
Rq
Rq
Rq
Rq
Rq
Rq
Rq
Rq
Rq
Rq
Rq
Rq
Rq
Rq
"}
(10,1,1) = {"
Rq
Rq
Rq
Rq
Rq
Rq
Rq
Rq
Rq
Rq
Rq
Rq
Rq
Rq
"}
(11,1,1) = {"
Rq
Rq
Rq
Rq
Rq
Rq
Rq
Rq
Rq
Rq
Rq
Rq
Rq
Rq
"}
(12,1,1) = {"
Rq
Rq
Rq
Rq
Rq
Rq
Rq
Rq
Rq
Rq
Rq
Rq
Rq
Rq
"}
(13,1,1) = {"
Rq
Rq
Rq
Rq
Rq
Rq
Rq
Rq
Rq
Rq
Rq
Rq
Rq
Rq
"}
(14,1,1) = {"
Rq
Rq
Rq
Rq
Rq
Rq
Rq
Rq
Rq
Rq
Rq
Rq
Rq
Rq
"}
(15,1,1) = {"
Rq
Rq
Rq
ka
ka
ka
ka
ka
ka
Rq
Rq
Rq
Rq
Rq
"}
(16,1,1) = {"
Rq
Rq
Rq
ka
ka
ka
Rq
Rq
ka
Rq
Rq
Rq
Rq
Rq
"}
(17,1,1) = {"
Rq
Rq
Rq
Rq
ka
ka
ka
ka
ka
Rq
Rq
Rq
Rq
Rq
"}
(18,1,1) = {"
Rq
Rq
Rq
Rq
Rq
Rq
Rq
Rq
ka
ka
Rq
Rq
Rq
Rq
"}
(19,1,1) = {"
kc
Rq
Rq
Rq
Rq
Rq
Rq
Rq
Rq
ka
lX
lX
ka
Rq
"}
(20,1,1) = {"
Rq
Rq
Rq
Rq
Rq
Rq
Rq
Rq
Rq
ka
ka
lX
lX
ka
"}
(21,1,1) = {"
Rq
Rq
Rq
Rq
Rq
Rq
Rq
Rq
Rq
Rq
ka
ka
lX
lX
"}
(22,1,1) = {"
Rq
Rq
Rq
Rq
Rq
Rq
Rq
Rq
Rq
Rq
Rq
ka
ka
lX
"}
(23,1,1) = {"
Rq
Rq
Rq
Rq
Rq
Rq
Rq
Rq
Rq
Rq
Rq
Rq
ka
lX
"}
(24,1,1) = {"
Rq
Rq
Rq
Rq
Rq
Rq
Rq
Rq
Rq
Rq
Rq
Rq
Rq
lX
"}
(25,1,1) = {"
Rq
Rq
Rq
Rq
Rq
Rq
Rq
Rq
Rq
Rq
Rq
lX
lX
lX
"}
(26,1,1) = {"
Rq
Rq
Rq
Rq
Rq
Rq
Rq
Rq
Rq
Rq
lX
lX
Rq
Rq
"}
(27,1,1) = {"
Rq
Rq
Rq
Rq
Rq
Rq
Rq
Rq
Rq
Rq
lX
Rq
Rq
Rq
"}
