//MAP CONVERTED BY dmm2tgm.py THIS HEADER COMMENT PREVENTS RECONVERSION, DO NOT REMOVE
"am" = (
/obj/structure/table,
/obj/effect/decal/cleanable/dirt,
/obj/item/device/radio,
/turf/simulated/floor/carpet,
/area/shuttle/salvage/start)
"aE" = (
/obj/structure/shuttle/diag_wall/black{
	dir = 1
	},
/turf/space,
/area/shuttle/salvage/start)
"aN" = (
/obj/effect/decal/cleanable/dirt,
/obj/structure/rack,
/obj/item/stack/sheet/metal{
	amount = 50
	},
/obj/item/tool/weldingtool,
/obj/effect/decal/warning_stripes{
	icon_state = "bot"
	},
/turf/simulated/floor/engine,
/area/shuttle/salvage/start)
"aU" = (
/obj/effect/decal/cleanable/dirt,
/obj/structure/closet/hydrant{
	pixel_y = 32
	},
/turf/simulated/floor/engine,
/area/shuttle/salvage/start)
"aW" = (
/obj/structure/bed/roller,
/obj/structure/sink{
	dir = 4;
	pixel_x = 11
	},
/obj/effect/decal/cleanable/dirt,
/obj/effect/decal/cleanable/cobweb2,
/turf/simulated/floor{
	icon_state = "white"
	},
/area/shuttle/salvage/start)
"bF" = (
/obj/machinery/door/poddoor{
	id_tag = "salvage_privacy";
	name = "Privacy Shutter"
	},
/obj/structure/grille/window_spawner/reinforced/full,
/turf/simulated/floor/plating,
/area/shuttle/salvage/start)
"bQ" = (
/obj/effect/decal/cleanable/dirt,
/obj/effect/decal/warning_stripes{
	icon_state = "warning";
	tag = "icon-warning"
	},
/turf/simulated/floor/engine,
/area/shuttle/salvage/start)
"cu" = (
/obj/structure/shuttle/engine/heater{
	dir = 4
	},
/obj/structure/window/reinforced{
	dir = 8
	},
/obj/effect/decal/warning_stripes{
	icon_state = "bot"
	},
/turf/simulated/floor/engine,
/area/shuttle/salvage/start)
"dS" = (
/obj/structure/shuttle/diag_wall/black{
	dir = 4
	},
/turf/space,
/area/shuttle/salvage/start)
"ek" = (
/obj/machinery/door/poddoor{
	density = 0;
	icon_state = "pdoor0";
	id_tag = "salvage_blast";
	name = "Bridge Blast Doors";
	opacity = 0
	},
/obj/structure/grille/window_spawner/reinforced/full,
/turf/simulated/floor/plating,
/area/shuttle/salvage/start)
"eG" = (
/obj/effect/decal/cleanable/dirt,
/obj/effect/decal/cleanable/cobweb2,
/turf/simulated/floor/engine,
/area/shuttle/salvage/start)
"gP" = (
/obj/effect/decal/cleanable/dirt,
/obj/machinery/light{
	dir = 8
	},
/turf/simulated/floor/engine,
/area/shuttle/salvage/start)
"gU" = (
/obj/structure/shuttle/engine/propulsion/left{
	dir = 4
	},
/turf/space,
/area/shuttle/salvage/start)
"ha" = (
/turf/simulated/wall/shuttle/unsmoothed/black,
/area/shuttle/salvage/start)
"hl" = (
/obj/effect/decal/cleanable/dirt,
/turf/simulated/floor/engine,
/area/shuttle/salvage/start)
"hv" = (
/obj/effect/decal/cleanable/dirt,
/obj/machinery/light/small{
	dir = 4
	},
/turf/simulated/floor/carpet,
/area/shuttle/salvage/start)
"kq" = (
/obj/structure/table,
/obj/effect/decal/cleanable/dirt,
/obj/item/weapon/storage/secure/briefcase,
/turf/simulated/floor/carpet,
/area/shuttle/salvage/start)
"kx" = (
/obj/structure/table,
/obj/effect/decal/cleanable/dirt,
/obj/item/clothing/suit/storage/hazardvest,
/obj/item/clothing/glasses/welding,
/turf/simulated/floor/engine,
/area/shuttle/salvage/start)
"lt" = (
/obj/machinery/portable_atmospherics/canister/oxygen,
/obj/effect/decal/cleanable/dirt,
/obj/effect/decal/warning_stripes{
	icon_state = "bot"
	},
/turf/simulated/floor/engine,
/area/shuttle/salvage/start)
"lF" = (
/obj/effect/decal/cleanable/dirt,
/obj/structure/closet/walllocker/emerglocker/north,
/turf/simulated/floor/engine,
/area/shuttle/salvage/start)
"mF" = (
/obj/structure/table,
/obj/effect/decal/cleanable/dirt,
/obj/item/weapon/folder/yellow,
/turf/simulated/floor/engine,
/area/shuttle/salvage/start)
"nd" = (
/obj/effect/decal/cleanable/dirt,
/obj/effect/decal/warning_stripes{
	icon_state = "warning";
	tag = "icon-warning"
	},
/obj/machinery/light/small{
	dir = 8;
	flickering = 1
	},
/turf/simulated/floor/engine,
/area/shuttle/salvage/start)
"ne" = (
/obj/effect/decal/cleanable/dirt,
/obj/structure/bed/chair/shuttle/red{
	dir = 8
	},
/turf/simulated/floor/engine,
/area/shuttle/salvage/start)
"nf" = (
/obj/machinery/vending/wallmed1{
	pixel_y = 28
	},
/obj/effect/decal/cleanable/dirt,
/obj/machinery/light/small{
	dir = 1
	},
/turf/simulated/floor{
	icon_state = "white"
	},
/area/shuttle/salvage/start)
"pe" = (
/obj/machinery/door/airlock/hatch,
/obj/effect/decal/cleanable/dirt,
/turf/simulated/floor/engine,
/area/shuttle/salvage/start)
"qs" = (
/obj/structure/table,
/obj/effect/decal/cleanable/dirt,
/obj/item/weapon/reagent_containers/food/drinks/bottle/vodka,
/turf/simulated/floor/carpet,
/area/shuttle/salvage/start)
"rB" = (
/obj/structure/fireaxecabinet{
	pixel_x = -32
	},
/obj/effect/decal/cleanable/dirt,
/obj/machinery/light{
	dir = 8
	},
/turf/simulated/floor/engine,
/area/shuttle/salvage/start)
"rC" = (
/obj/machinery/sleeper,
/obj/effect/decal/cleanable/dirt,
/turf/simulated/floor{
	icon_state = "white"
	},
/area/shuttle/salvage/start)
"sb" = (
/obj/effect/decal/cleanable/dirt,
/turf/simulated/floor/carpet,
/area/shuttle/salvage/start)
"sU" = (
/obj/structure/shuttle/diag_wall/black{
	dir = 8
	},
/turf/space,
/area/shuttle/salvage/start)
"tX" = (
/obj/machinery/door/airlock/hatch{
	name = "Captain's Cabin";
	req_access_txt = "65"
	},
/obj/effect/decal/cleanable/dirt,
/turf/simulated/floor/engine,
/area/shuttle/salvage/start)
"uf" = (
/obj/structure/table,
/obj/effect/decal/cleanable/dirt,
/obj/item/device/analyzer,
/turf/simulated/floor/engine,
/area/shuttle/salvage/start)
"uL" = (
/obj/structure/closet/crate,
/obj/effect/decal/cleanable/dirt,
/obj/item/weapon/card/id/salvage_captain,
/obj/item/weapon/storage/belt/utility/full,
/obj/effect/decal/warning_stripes{
	icon_state = "bot"
	},
/turf/simulated/floor/engine,
/area/shuttle/salvage/start)
"ve" = (
/obj/structure/table,
/obj/effect/decal/cleanable/dirt,
/obj/item/device/flashlight/flare{
	pixel_x = 3;
	pixel_y = 2
	},
/obj/item/device/flashlight/flare,
/obj/item/device/flashlight/flare{
	pixel_x = -3;
	pixel_y = -1
	},
/turf/simulated/floor/engine,
/area/shuttle/salvage/start)
"wd" = (
/obj/structure/bed,
/obj/item/weapon/bedsheet/brown,
/obj/effect/decal/cleanable/dirt,
/obj/effect/decal/cleanable/cobweb,
/turf/simulated/floor/carpet,
/area/shuttle/salvage/start)
"wF" = (
/obj/machinery/suit_storage_unit/standard_unit,
/obj/effect/decal/cleanable/dirt,
/turf/simulated/floor/engine,
/area/shuttle/salvage/start)
"wM" = (
/obj/structure/shuttle/engine/propulsion{
	dir = 4
	},
/turf/space,
/area/shuttle/salvage/start)
"xC" = (
/obj/structure/table,
/obj/effect/decal/cleanable/dirt,
/obj/item/weapon/soap,
/obj/item/weapon/storage/firstaid/regular{
	pixel_x = 2;
	pixel_y = 6
	},
/obj/item/weapon/storage/firstaid/toxin{
	pixel_x = -2;
	pixel_y = 4
	},
/turf/simulated/floor{
	icon_state = "white"
	},
/area/shuttle/salvage/start)
"xP" = (
/obj/effect/decal/cleanable/dirt,
/turf/simulated/floor{
	icon_state = "white"
	},
/area/shuttle/salvage/start)
"xU" = (
/obj/structure/table,
/obj/effect/decal/cleanable/dirt,
/obj/effect/decal/cleanable/cobweb,
/obj/item/weapon/paper_bin{
	pixel_x = 1;
	pixel_y = 9
	},
/obj/item/weapon/pen,
/turf/simulated/floor/carpet,
/area/shuttle/salvage/start)
"xZ" = (
/obj/docking_port/destination/salvage/start{
	dir = 2
	},
/turf/space,
/area)
"AG" = (
/obj/effect/decal/cleanable/dirt,
/obj/structure/closet/crate,
/obj/item/device/flashlight/lantern,
/obj/item/clothing/glasses/scanner/meson,
/obj/effect/decal/warning_stripes{
	icon_state = "bot"
	},
/turf/simulated/floor/engine,
/area/shuttle/salvage/start)
"AT" = (
/obj/structure/bed,
/obj/item/weapon/bedsheet/brown,
/obj/effect/decal/cleanable/dirt,
/turf/simulated/floor/carpet,
/area/shuttle/salvage/start)
"CB" = (
/obj/structure/bed,
/obj/item/weapon/bedsheet/brown,
/obj/effect/decal/cleanable/dirt,
/obj/item/weapon/spacecash/c1000,
/turf/simulated/floor/carpet,
/area/shuttle/salvage/start)
"Fs" = (
/obj/structure/shuttle/diag_wall/black,
/turf/space,
/area/shuttle/salvage/start)
"Ge" = (
/obj/structure/closet/cabinet,
/obj/item/weapon/storage/backpack/satchel,
/obj/item/clothing/shoes/jackboots,
/obj/item/clothing/under/captain_fly{
	name = "Captain's uniform"
	},
/obj/item/clothing/suit/hgpirate,
/obj/item/clothing/head/hgpiratecap,
/obj/item/clothing/glasses/eyepatch,
/obj/item/weapon/gun/energy/bison,
/obj/effect/decal/cleanable/dirt,
/turf/simulated/floor/carpet,
/area/shuttle/salvage/start)
"Gn" = (
/obj/structure/shuttle/engine/heater{
	dir = 4
	},
/obj/effect/decal/warning_stripes{
	icon_state = "bot"
	},
/obj/structure/window/reinforced{
	dir = 8
	},
/turf/simulated/floor/engine,
/area/shuttle/salvage/start)
"Ja" = (
/obj/effect/decal/cleanable/dirt,
/obj/structure/computerframe,
/obj/item/stack/cable_coil/random,
/turf/simulated/floor/carpet,
/area/shuttle/salvage/start)
"Ki" = (
/obj/structure/table,
/obj/effect/decal/cleanable/dirt,
/turf/simulated/floor/engine,
/area/shuttle/salvage/start)
"KL" = (
/obj/effect/decal/cleanable/dirt,
/obj/machinery/light/small,
/turf/simulated/floor/carpet,
/area/shuttle/salvage/start)
"KO" = (
/obj/structure/table/woodentable,
/obj/item/weapon/storage/fancy/matchbox,
/obj/item/clothing/mask/cigarette/cigar,
/obj/item/weapon/reagent_containers/food/drinks/flask{
	pixel_x = 8
	},
/obj/item/clothing/accessory/medal/gold/captain,
/obj/effect/decal/cleanable/dirt,
/turf/simulated/floor/carpet,
/area/shuttle/salvage/start)
"Lb" = (
/obj/effect/decal/cleanable/dirt,
/obj/effect/decal/warning_stripes{
	dir = 1;
	icon_state = "warning";
	tag = "icon-warning (NORTH)"
	},
/turf/simulated/floor/engine,
/area/shuttle/salvage/start)
"Li" = (
/obj/machinery/computer/shuttle_control/salvage,
/turf/simulated/floor/carpet,
/area/shuttle/salvage/start)
"Lz" = (
/obj/structure/shuttle/engine/propulsion/right{
	dir = 4
	},
/turf/space,
/area/shuttle/salvage/start)
"NG" = (
/obj/effect/decal/cleanable/dirt,
/obj/machinery/door/airlock/multi_tile/glass{
	id_tag = "salvage_external"
	},
/turf/simulated/floor/engine,
/area/shuttle/salvage/start)
"NL" = (
/obj/structure/rack,
/obj/effect/decal/cleanable/dirt,
/obj/item/clothing/mask/gas,
/obj/item/clothing/mask/gas{
	pixel_x = 4;
	pixel_y = 2
	},
/obj/effect/decal/warning_stripes{
	icon_state = "bot"
	},
/turf/simulated/floor/engine,
/area/shuttle/salvage/start)
"Ok" = (
/obj/effect/decal/cleanable/dirt,
/obj/machinery/door/airlock/multi_tile/glass{
	id_tag = "salvage_external";
	locked = 1
	},
/turf/simulated/floor/plating,
/area/shuttle/salvage/start)
"Or" = (
/obj/item/weapon/rack_parts,
/obj/effect/decal/cleanable/dirt,
/obj/effect/decal/warning_stripes{
	icon_state = "bot"
	},
/obj/machinery/light/small{
	dir = 1
	},
/turf/simulated/floor/engine,
/area/shuttle/salvage/start)
"OD" = (
/obj/structure/bed,
/obj/item/weapon/bedsheet/rd,
/obj/effect/decal/cleanable/dirt,
/obj/machinery/door_control{
	id_tag = "salvage_privacy";
	name = "Privacy Shutters";
	pixel_y = -25
	},
/turf/simulated/floor/carpet,
/area/shuttle/salvage/start)
"OR" = (
/obj/structure/table,
/obj/effect/decal/cleanable/dirt,
/obj/machinery/door_control{
	id_tag = "salvage_blast";
	name = "Blast Doors";
	pixel_y = 25;
	req_one_access_txt = "65"
	},
/obj/item/device/multitool,
/turf/simulated/floor/carpet,
/area/shuttle/salvage/start)
"PT" = (
/turf/space,
/area)
"Sj" = (
/obj/structure/bed,
/obj/item/weapon/bedsheet/brown,
/obj/effect/decal/cleanable/dirt,
/obj/effect/decal/cleanable/cobweb2,
/turf/simulated/floor/carpet,
/area/shuttle/salvage/start)
"Sw" = (
/obj/effect/decal/cleanable/dirt,
/obj/structure/bed/chair/shuttle/red,
/turf/simulated/floor/engine,
/area/shuttle/salvage/start)
"Sy" = (
/obj/effect/decal/cleanable/dirt,
/obj/docking_port/shuttle,
/obj/machinery/door/airlock/multi_tile/glass{
	id_tag = "salvage_external";
	locked = 1
	},
/turf/simulated/floor/plating,
/area/shuttle/salvage/start)
"SB" = (
/obj/item/weapon/pickaxe{
	pixel_x = 5
	},
/obj/item/weapon/pickaxe/shovel{
	pixel_x = -5
	},
/obj/effect/decal/cleanable/dirt,
/obj/effect/decal/cleanable/cobweb,
/obj/effect/decal/warning_stripes{
	icon_state = "bot"
	},
/turf/simulated/floor/engine,
/area/shuttle/salvage/start)
"Ul" = (
/obj/effect/decal/cleanable/dirt,
/obj/effect/decal/warning_stripes{
	dir = 1;
	icon_state = "warning";
	tag = "icon-warning (NORTH)"
	},
/obj/machinery/light/small{
	dir = 8;
	flickering = 1
	},
/turf/simulated/floor/engine,
/area/shuttle/salvage/start)
"UN" = (
/obj/structure/table,
/obj/effect/decal/cleanable/dirt,
/obj/item/weapon/lighter/zippo,
/obj/item/weapon/storage/fancy/cigarettes,
/turf/simulated/floor/engine,
/area/shuttle/salvage/start)
"Vm" = (
/obj/effect/decal/cleanable/dirt,
/obj/structure/bed/chair/shuttle/red{
	dir = 1
	},
/turf/simulated/floor/engine,
/area/shuttle/salvage/start)
"VW" = (
/obj/machinery/door/airlock/multi_tile/glass{
	id_tag = "salvage_external"
	},
/obj/effect/decal/cleanable/dirt,
/turf/simulated/floor/engine,
/area/shuttle/salvage/start)
"WE" = (
/obj/effect/decal/cleanable/dirt,
/obj/structure/bed/chair/shuttle/red{
	dir = 8
	},
/turf/simulated/floor/carpet,
/area/shuttle/salvage/start)
"XO" = (
/obj/structure/table,
/obj/effect/decal/cleanable/dirt,
/obj/item/weapon/storage/fancy/donut_box,
/turf/simulated/floor/carpet,
/area/shuttle/salvage/start)
"Yr" = (
/obj/effect/decal/cleanable/dirt,
/obj/structure/computerframe,
/turf/simulated/floor/carpet,
/area/shuttle/salvage/start)
"YO" = (
/obj/effect/decal/cleanable/dirt,
/turf/simulated/floor/plating,
/area/shuttle/salvage/start)

(1,1,1) = {"
PT
PT
PT
PT
sU
ek
ek
ek
ek
ek
Fs
PT
PT
PT
PT
"}
(2,1,1) = {"
PT
PT
PT
PT
ha
xU
XO
Li
kq
am
ha
PT
PT
PT
PT
"}
(3,1,1) = {"
PT
PT
PT
PT
ha
OR
sb
WE
sb
qs
ha
PT
PT
PT
PT
"}
(4,1,1) = {"
PT
PT
PT
PT
ha
Yr
hv
sb
hv
Ja
ha
PT
PT
PT
PT
"}
(5,1,1) = {"
PT
PT
sU
ha
ha
ha
ha
pe
ha
ha
ha
ha
Fs
PT
PT
"}
(6,1,1) = {"
sU
ha
ha
ha
wF
wF
gP
hl
gP
wF
wF
ha
ha
ha
Fs
"}
(7,1,1) = {"
bF
KO
sb
tX
hl
hl
hl
hl
hl
hl
hl
pe
xP
rC
ha
"}
(8,1,1) = {"
bF
sb
KL
ha
ha
ha
ha
hl
ha
ha
ha
ha
nf
xP
ha
"}
(9,1,1) = {"
bF
Ge
OD
ha
wd
sb
pe
hl
ha
SB
lt
ha
aW
xC
ha
"}
(10,1,1) = {"
aE
ha
ha
ha
AT
KL
ha
hl
ha
Or
uL
ha
ha
ha
dS
"}
(11,1,1) = {"
PT
PT
PT
ha
CB
sb
ha
hl
pe
hl
NL
ha
PT
PT
PT
"}
(12,1,1) = {"
PT
PT
PT
ha
Sj
sb
ha
hl
ha
AG
aN
ha
PT
PT
PT
"}
(13,1,1) = {"
PT
sU
ha
ha
ha
ha
ha
hl
ha
ha
ha
ha
ha
Fs
PT
"}
(14,1,1) = {"
xZ
Sy
Ul
NG
Lb
hl
rB
hl
gP
hl
bQ
VW
nd
Ok
PT
"}
(15,1,1) = {"
PT
YO
Lb
hl
Lb
hl
hl
hl
hl
hl
bQ
hl
bQ
YO
PT
"}
(16,1,1) = {"
PT
aE
cu
ha
lF
Sw
kx
Ki
UN
Vm
hl
ha
Gn
dS
PT
"}
(17,1,1) = {"
PT
PT
Lz
ha
aU
Sw
ve
mF
uf
Vm
hl
ha
gU
PT
PT
"}
(18,1,1) = {"
PT
PT
PT
ha
eG
hl
hl
ne
hl
hl
hl
ha
PT
PT
PT
"}
(19,1,1) = {"
PT
PT
PT
ha
cu
cu
cu
cu
cu
cu
cu
ha
PT
PT
PT
"}
(20,1,1) = {"
PT
PT
PT
aE
wM
wM
wM
wM
wM
wM
wM
dS
PT
PT
PT
"}
