//MAP CONVERTED BY dmm2tgm.py THIS HEADER COMMENT PREVENTS RECONVERSION, DO NOT REMOVE
"a" = (
/turf/space,
/area)
"c" = (
/obj/effect/landmark/map_element/salvage_shuttle,
/turf/space,
/area)
"B" = (
/mob/living/simple_animal/hostile/bear/polarbear,
/turf/space,
/area)
"S" = (
/mob/living/simple_animal/hostile/bear,
/turf/space,
/area)

(1,1,1) = {"
a
a
a
a
a
a
a
a
a
a
c
"}
(2,1,1) = {"
a
a
a
a
a
a
a
a
a
a
a
"}
(3,1,1) = {"
a
a
a
B
a
a
a
a
a
a
a
"}
(4,1,1) = {"
a
a
a
a
a
a
a
a
a
a
a
"}
(5,1,1) = {"
a
a
a
a
a
a
a
a
a
a
a
"}
(6,1,1) = {"
a
a
a
a
a
a
a
a
a
a
a
"}
(7,1,1) = {"
a
S
a
a
a
a
a
a
a
a
a
"}
(8,1,1) = {"
a
a
a
a
a
a
a
a
S
a
a
"}
(9,1,1) = {"
a
a
a
a
a
a
a
a
a
a
a
"}
(10,1,1) = {"
a
a
a
a
a
a
a
a
a
a
a
"}
(11,1,1) = {"
a
S
a
a
a
S
a
a
a
a
a
"}
(12,1,1) = {"
a
a
a
a
a
a
a
a
a
a
a
"}
(13,1,1) = {"
a
a
a
a
a
a
a
a
a
a
a
"}
(14,1,1) = {"
a
a
a
a
a
a
a
a
a
a
a
"}
(15,1,1) = {"
a
a
a
a
a
a
a
a
a
a
a
"}
(16,1,1) = {"
S
a
a
a
a
a
a
a
a
a
a
"}
(17,1,1) = {"
a
a
a
a
a
a
a
a
a
a
a
"}
(18,1,1) = {"
a
a
a
a
a
a
S
a
a
a
a
"}
