//MAP CONVERTED BY dmm2tgm.py THIS HEADER COMMENT PREVENTS RECONVERSION, DO NOT REMOVE
"a" = (
/mob/living/simple_animal/hostile/bigroach,
/turf/space,
/area)
"w" = (
/obj/effect/landmark/map_element/salvage_shuttle,
/turf/space,
/area)
"H" = (
/turf/space,
/area)

(1,1,1) = {"
H
H
H
H
H
H
H
H
H
H
H
H
w
"}
(2,1,1) = {"
H
H
H
H
H
H
H
H
H
H
H
H
H
"}
(3,1,1) = {"
H
H
H
H
H
H
H
H
H
H
H
H
H
"}
(4,1,1) = {"
H
H
H
H
H
a
H
H
H
H
H
H
H
"}
(5,1,1) = {"
H
H
H
H
H
H
H
H
H
H
H
H
H
"}
(6,1,1) = {"
H
H
H
H
H
H
H
H
H
H
H
H
H
"}
(7,1,1) = {"
a
H
H
H
H
H
a
H
H
H
a
H
H
"}
(8,1,1) = {"
H
H
H
H
H
H
H
H
H
H
H
a
H
"}
(9,1,1) = {"
H
H
H
H
H
H
H
H
H
H
H
H
H
"}
(10,1,1) = {"
H
H
H
H
H
H
H
H
H
H
H
H
H
"}
(11,1,1) = {"
H
H
H
a
H
H
H
a
H
H
H
H
H
"}
