//MAP CONVERTED BY dmm2tgm.py THIS HEADER COMMENT PREVENTS RECONVERSION, DO NOT REMOVE
"a" = (
/turf/space,
/area)
"e" = (
/mob/living/simple_animal/hostile/mimic/crate,
/turf/space,
/area)
"k" = (
/obj/effect/landmark/map_element/salvage_shuttle,
/turf/space,
/area)
"N" = (
/mob/living/simple_animal/hostile/monster/skrite,
/turf/space,
/area)

(1,1,1) = {"
a
a
a
a
a
a
a
a
a
k
"}
(2,1,1) = {"
a
a
a
a
a
a
a
a
a
a
"}
(3,1,1) = {"
a
a
N
a
a
a
a
a
a
a
"}
(4,1,1) = {"
a
a
a
a
a
a
a
a
a
a
"}
(5,1,1) = {"
a
a
a
a
a
a
a
a
a
a
"}
(6,1,1) = {"
a
a
a
a
a
a
a
a
a
a
"}
(7,1,1) = {"
a
a
a
a
a
a
a
a
a
a
"}
(8,1,1) = {"
a
a
a
a
a
a
a
N
a
a
"}
(9,1,1) = {"
a
a
a
a
e
a
a
a
a
a
"}
(10,1,1) = {"
a
a
a
a
a
a
a
a
a
a
"}
(11,1,1) = {"
N
a
a
a
a
a
a
a
a
a
"}
(12,1,1) = {"
a
a
a
a
a
a
a
a
a
a
"}
(13,1,1) = {"
a
a
a
a
a
a
a
a
a
a
"}
(14,1,1) = {"
a
a
a
a
a
a
a
a
a
a
"}
(15,1,1) = {"
a
a
a
a
a
a
a
a
a
a
"}
(16,1,1) = {"
a
a
a
a
a
a
a
a
a
a
"}
(17,1,1) = {"
a
a
a
a
a
a
a
a
a
a
"}
(18,1,1) = {"
a
a
a
a
a
N
a
a
a
a
"}
